අක්කරපත්තුව	አክከረፓትቱወ
අකුරැස්ස	አኩረስሰ
අගලගම	አገለገመ
අනුරාධපුර	አኑራ፞ደፑረ
අනුරාධපුර නව නගරය	አኑራ፞ደፑረ ናወ ናገረየ
අනුරාධපුර පෞරාණික නගරය	አኑራ፞ደፑረ ፓውራ፞ኒከ ናገረየ
අම්පාර නගරය	አምፓ፞ረ ናገረየ
අම්බලන්ගොඩ	አምበላንጎደ
අඹන්පොල	አምባንፖለ
අඹේපුස්ස	አምቤ፞ፑስሰ
අරියාලේ	አሪያ፞ሌ፞
අලුත්කඩේ	አሉትከዴ፞
අලුත්ගම	አሉትገመ
අවිස්සාවේල්ල	አዊስሳ፞ዌ፞ልለ
අහංගම	አሃንገመ
ආණමඩුව	አ፞ነመዱወ
ඇඹිලිපිටිය	ኧምቢሊፒቲየ
ඇරැව්වල	ኧረውወለ
ඇල්පිටිය	ኧልፒቲየ
ඉංගිරිය	ኢንጊሪየ
උකුවෙල	ኡኩዌለ
උණවටුන	ኡነወቱነ
එරාවුර්	ኤራ፞ውር
ඓතිහාසික මිගමුව	አይቲሃ፞ሲከ ሚገሙወ
ඕකන්දයාය	ኦ፞ካንደያ፞የ
කටුගස්තොට	ካቱጋስቶተ
කටුපොත	ካቱፖተ
කඩදාසි නගරය	ካደዳ፞ሲ ናገረየ
කඩුගන්නාව	ካዱጋንና፞ወ
කතරගම	ካተረገመ
කදුරුවෙල	ካዱሩዌለ
කන්කසන්තුරේ	ካንከሳንቱሬ፞
කන්තලේ	ካንተሌ፞
කප්පාගොඩ	ካፕፓ፞ጎደ
කරණ්දෙනිය	ከራንዴኒየ
කරවිට	ከረዊተ
කල්මුනේ	ካልሙኔ፞
කළුතර	ካሉተረ
කාත්තන්කුඩි	ካ፞ትታንኩዲ
කැකිරාව	ከኪራ፞ወ
කැලණිය	ከለኒየ
කැස්බෑව	ከስበ፞ወ
කෑගල්ල	ከ፞ጋልለ
කිතුල්ගල	ኪቱልገለ
කින්නියා	ኪንኒያ፞
කිරිදිවැල	ኪሪዲወለ
කිරුළපන	ኪሩለፐነ
කිලිනොච්චිය	ኪሊኖችቺየ
කුච්චවේලි	ኩችቸዌ፞ሊ
කුරුණෑගල නගරය	ኩሩነ፞ገለ ናገረየ
කුලියාපිටිය	ኩሊያ፞ፒቲየ
කොග්ගල	ኮግገለ
කොටහේන	ኮተሄ፞ነ
කොටිකාවත්ත	ኮቲካ፞ዋትተ
කොලොන්නාව	ኮሎንና፞ወ
කොස්ගම	ኮስገመ
කොළඹ වරාය නගරය	ኮለምበ ዋራ፞የ ናገረየ
ගණේමුල්ල	ጋኔ፞ሙልለ
ගම්පහ	ጋምፐሃ
ගම්පොල	ጋምፖለ
ගලේවෙල	ጋሌ፞ዌለ
ගාමිණී හෝල්	ጋ፞ሚኒ፞ ሆ፞ል
ගාල්ල	ጋ፞ልለ
ගාල්ල අවට පිහිටි විශේෂ ස්ථාන	ጋ፞ልለ አወተ ፒሂቲ ዊሼ፞ሸ ስታ፞ነ
ගිනිගත්හේන	ጊኒጋትሄ፞ነ
ගොඩාමුණ	ጎዳ፞ሙነ
ගෝඩුන්න	ጎ፞ዱንነ
චාවකච්චේරි	ቻ፞ወካችቼ፞ሪ
චෙන්කලඩි	ቼንከለዲ
ජා ඇළ	ጃ፞ ኧለ
තංගල්ල	ታንጋልለ
තන්තිරිමලේ	ታንቲሪመሌ፞
තලවාකැලේ	ታለዋ፞ከሌ፞
තිස්සමහාරාමය	ቲስሰመሃ፞ራ፞መየ
තිහගොඩ	ቲሀጎደ
තිහාරිය	ቲሃ፞ሪየ
තෙල්ලඹුර	ቴልለምቡረ
දඹුල්ල	ዳምቡልለ
දර්ගා නගරය	ዳርጋ፞ ናገረየ
දළුගම	ዳሉገመ
දැදිගම කොටවෙහෙර	ደዲገመ ኮተዌሄረ
දෙණියාය	ዴኒያ፞የ
දෙමටගොඩ	ዴመተጎደ
දෙහිඅත්තකණ්ඩිය	ዴሂያትተካንዲየ
දේදුගල	ዴ፞ዱገለ
නාඋල	ና፞ኡለ
නාරම්මල	ና፞ራምመለ
නාරාහේන්පිට	ና፞ራ፞ሄ፞ንፒተ
නිකවැරටිය	ኒከወረቲየ
නිට්ටඹුව	ኒትተምቡወ
නිරිපොල	ኒሪፖለ
නුගේගොඩ	ኑጌ፞ጎደ
නුවරඑළිය	ኑወረኤሊየ
නුවරගල	ኑወረገለ
නෙළුව	ኔሉወ
පන්නිපිටිය	ፓንኒፒቲየ
පරන්තන්	ፓራንታን
පල්ලේපොල	ፓልሌ፞ፖለ
පාදුක්ක	ፓ፞ዱክከ
පාදෙණිය	ፓ፞ዴኒየ
පානදුර	ፓ፞ነዱረ
පාමංකඩ	ፓ፞ማንግከደ
පැල්මඩුල්ල	ፐልመዱልለ
පෑලියගොඩ	ፐ፞ሊየጎደ
පිටකොටුව	ፒተኮቱወ
පිළියන්දල	ፒሊያንደለ
පුස්සැල්ලාව	ፑስሰልላ፞ወ
පූඬලුඔය	ፑ፞ንደሉኦየ
පේදුරු තුඩුව	ፔ፞ዱሩ ቱዱወ
පොතුවිල්	ፖቱዊል
පොල්ගස්ඕවිට	ፖልገሶ፞ዊተ
බටගොඩ	ባተጎደ
බතලේගල	ባተሌ፞ገለ
බදුල්ල	ባዱልለ
බම්බලපිටිය	ባምበለፒቲየ
බලංගොඩ	ባላንጎደ
බ්ලූමැන්ඩල්	ብሉ፞መንዳል
බිබිලේ	ቢቢሌ፞
බුත්තල	ቡትተለ
බෙන්තොට	ቤንቶተ
බෙරගල	ቤረገለ
බේරුවල	ቤ፞ሩወለ
බොරලන්ද	ቦረላንደ
බොරලැස්ගමුව	ቦረለስገሙወ
මට්ටක්කුලිය	ማትታክኩሊየ
මඩකලපුව නගරය	ማደከለፑወ ናገረየ
මඩහපොල	ማደሃፖለ
මතුගම	ማቱገመ
මරදාන	ማረዳ፞ነ
මස්කෙළිය	ማስኬሊየ
මහනුවර	ማሃኑወረ
මහර	ማሃረ
මහරගම	ማሃረገመ
මාතලේ	ማ፞ተሌ፞
මාදම්පිටිය	ማ፞ዳምፒቲየ
මාදම්පේ	ማ፞ዳምፔ፞
මාන්කුලම්	ማ፞ንኩላም
මාරවිල	ማ፞ረዊለ
මාරුද්දන	ማ፞ሩድደነ
මාලබේ	ማ፞ለቤ፞
මාවනැල්ල	ማ፞ወነልለ
මාවීදළුපොත	ማ፞ዊ፞ደሉፖተ
මැදිරිගිරිය	መዲሪጊሪየ
මිංහෙට්ටිය	ሚንግሄትቲየ
මිද්දෙනිය	ሚድዴኒየ
මිනුවන්ගොඩ	ሚኑዋንጎደ
මීගමුව	ሚ፞ገሙወ
මීතොටමුල්ල	ሚ፞ቶተሙልለ
මීරිගම	ሚ፞ሪገመ
මුස්නව	ሙስነወ
මොනරාගල	ሞነራ፞ገለ
මොරටුව	ሞረቱወ
මොරවක	ሞረወከ
මෝදර	ሞ፞ደረ
යක්කල	ያክከለ
යක්කලමුල්ල	ያክከለሙልለ
යටවත්ත	ያተዋትተ
යටියන්තොට	ያቲያንቶተ
යාපහුව	ያ፞ፐሁወ
යාපහුව බලකොටුව	ያ፞ፐሁወ ባለኮቱወ
රජගලතැන්න	ራጀገለተንነ
රත්ගම	ራትገመ
රත්තොට	ራትቶተ
රත්නපුර	ራትነፑረ
රත්මලාන	ራትመላ፞ነ
රතුපස්වල	ራቱፓስወለ
රම්බොඩ	ራምቦደ
ලබුදූව	ላቡዱ፞ወ
ලුණුගල	ሉኑገለ
ලුනාව	ሉና፞ወ
ලූල්බද්දුව	ሉ፞ልባድዱወ
වඩකච්චි	ዋደካችቺ
වඩකන්ඩල්	ዋደካንዳል
වඩුක්කොඩෙයි	ዋዱክኮዴይ
වඩුක්කොඩෙයි නැගෙනහිර	ዋዱክኮዴይ ነጌነሂረ
වඩුවාකල්ලු	ዋዱዋ፞ካልሉ
වඳුරාදෙනිය	ዋንዱራ፞ዴኒየ
වාද්දුව	ዋ፞ድዱወ
වාරියපොල	ዋ፞ሪየፖለ
වාරියපොල නගරය	ዋ፞ሪየፖለ ናገረየ
වැල්ලවත්ත	ወልለዋትተ
වැල්ලවාය	ወልለዋ፞የ
වැල්වැටිතුරෙයි	ወልወቲቱሬይ
වැලිකඩ	ወሊከደ
වැලිමඩ	ወሊመደ
වැලිවේරිය	ወሊዌ፞ሪየ
වීරකැටිය	ዊ፞ረከቲየ
ශ්‍රී ජයවර්ධනපුර කෝට්ටේ	ሽሪ፞ ጃየዋርደነፑረ ኮ፞ትቴ፞
ශ්‍රී ලංකාවේ පුරවර	ሽሪ፞ ላንግካ፞ዌ፞ ፑረወረ
සමන්තුරේ	ሳማንቱሬ፞
හංවැල්ල	ሃንጐልለ
හක්මන	ሃክመነ
හඳගිරිය	ሃንደጊሪየ
හපුතලේ	ሃፑተሌ፞
හබරණ	ሃበረነ
හම්බන්තොට	ሃምባንቶተ
