abanilla	أبانييا
abrucena	أبروسينا
acebo	أسيبو
acedera	أسيذيرا
acehuche	أسيأتْشي
aceuchal	أسيوتْشال
adamuz	أذاموس
ademuz	أذيموس
adzaneta	أذسانيتا
agoncillo	أغونسييو
aguadulce	أغواذولسي
agullana	أغويانا
ahillones	أإِيونيس
aiguamurcia	أيغوامورسيا
aizpun	أيسبون
alamedilla	ألاميذييا
alamillo	ألامييو
alarilla	ألارييا
alatoz	ألاتوس
albacete	ألباسيتي
albalatillo	ألبالاتييو
albanchez	ألبانتْشيس
albarracin	ألباراسين
albocacer	ألبوكاسير
alcadozo	ألكاذوسو
alcanices	ألكانيسيس
alcaniz	ألكانيس
alcantarilla	ألكانتارييا
alcaracejos	ألكاراسيخوس
alcaraz	ألكاراس
alcaucin	ألكاوسين
alcazaren	ألكاسارين
alceda	ألسيذا
alcira	ألسيرا
alcocebre	ألكوسيبري
alcocer	ألكوسير
alcollarin	ألكويارين
alcubillas	ألكوبيياس
alcuneza	ألكونيسا
aldeacentenera	ألدياسينتينيرا
aldealpozo	ألديالبوسو
alfaiz	ألفايس
alfaraz	ألفاراس
alfoz	ألفوس
algatocin	ألغاتوسين
algeciras	ألخيسيراس
alguazas	ألغواساس
aljucen	ألخوسين
allariz	أياريس
allepuz	أيبوس
aller	أير
alles	أيس
allo	أيو
alloza	أيوسا
almacellas	ألماسيياس
almaciles	ألماسيليس
almaluez	ألمالويس
almanza	ألمانسا
almaraz	ألماراس
almazan	ألماسان
almazora	ألماسورا
almazul	ألماسول
almedinilla	ألميذينييا
alocen	ألوسين
alozaina	ألوساينا
alperiz	ألبيريس
alquezar	ألكيسار
alzola	ألسولا
amezaga	أميساغا
ancin	أنسين
andalucia	أندالوسيا
andilla	أندييا
andosilla	أندوسييا
anzanigo	أنسانيغو
anzuola	أنسوولا
anzur	أنسور
apellaniz	أبييانيس
aracena	أراسينا
aragoncillo	أراغونسييو
aranaz	أراناس
arandillo	أراندييو
aranjuez	أرانخويس
aranzazu	أرانساسو
aranzuegue	أرانسويغي
arceniega	أرسينيغا
archilla	أرتْشييا
arevalillo	أريبالييو
arganza	أرغانسا
arguellite	أرغييتي
ariñez	أرينيس
ariza	أريسا
arizala	أريسالا
arjonilla	أرخونييا
arlanzon	أرلانسون
arnedillo	أرنيذييو
aroizu	أرويسو
arquillos	أركييوس
arrancacepas	أرانكاسيباس
arrazola	أراسولا
arrecife	أريسيفي
arroniz	أرونيس
artazu	أرتاسو
arzúa	أرسوا
asomadilla	أسوماذييا
astillero	أستييرو
astudillo	أستوذييو
atienza	أتينسا
avellanes	أبييانيس
ayllon	أييون
azagra	أساغرا
azaila	أسايلا
azañón	أسانون
azanuy	أسانوي
azcoitia	أسكويتيا
aznalcazar	أسنالكاسار
aznalcollar	أسنالكويار
azpeitia	أسبييتيا
azuaga	أسواغا
azuara	أسوارا
azuelo	أسويلو
badajoz	باذاخوس
baeza	بايسا
bahillo	باإِيو
baillo	باييو
balazote	بالاسوتي
balces	بالسيس
ballerias	بايرياس
ballestar	بايستار
ballesteros	بايستيروس
ballobar	بايوبار
bañobarez	بانوباريس
baralla	بارايا
barbadillo	بارباذييو
barcena	بارسينا
barcience	بارسينسي
barzana	بارسانا
basella	باسييا
baza	باسا
beariz	باريس
beceite	بسييتي
bello	بيو
belltall	بيتاي
bellver	بيبير
bellvey	بيبيي
bellvis	بيبيس
belmez	بلميس
benacazon	بناكاسون
benaguacil	بناغواسيل
benaocaz	بناوكاس
benejuzar	بنيخوسار
benifallet	بنيفايت
benifallim	بنيفايم
benilloba	بنييوبا
benitachell	بنيتاتْشيي
benizalon	بنيسالون
benuza	بنوسا
benzu	بنسو
berantevilla	برانتيبييا
bercedo	برسيذو
bercero	برسيرو
berducedo	برذوسيذو
berriz	بريس
berzocana	برسوكانا
betanzos	بتانسوس
bezes	بسيس
biguezal	بيغيسال
binaced	بيناسيذ
bizberri	بيسبيري
blanquilla	بلانكييا
blazques	بلاسكيس
boadilla	بواذييا
bobadilla	بوباذييا
boceguillas	بوسيغيياس
bocigas	بوسيغاس
boecillo	بويسييو
bonanza	بونانسا
bonilla	بونييا
brozas	بروساس
buciegas	بوسيغاس
bujalance	بوخالانسي
bujaraloz	بوخارالوس
bullas	بوياس
burguillos	بورغييوس
cabanillas	كابانيياس
cabezamesada	كابيساميساذا
cabezarados	كابيساراذوس
cabezo	كابيسو
cabrillanes	كابرييانيس
cabrillas	كابريياس
caceres	كاسيريس
cachilla	كاتْشييا
cachorrilla	كاتْشورييا
cacin	كاسين
calaceite	كالاسييتي
calafell	كالافيي
calatanazor	كالاتاناسور
callejas	كايخاس
calzadilla	كالساذييا
camallera	كامايرا
camarillas	كاماريياس
campanillas	كامبانيياس
campello	كامبييو
campillo	كامبييو
campillos	كامبييوس
camporrells	كامبورييس
cancienes	كانسينيس
canillas	كانيياس
canizal	كانيسال
canizares	كانيساريس
canizo	كانيسو
cantillana	كانتييانا
canyellas	كانيياس
capdella	كابذييا
capellades	كابيياذيس
capilla	كابييا
carcastillo	كاركاستييو
carcelen	كارسيلين
carracedelo	كاراسيذيلو
carranza	كارانسا
carrizal	كاريسال
carrizo	كاريسو
carrizosa	كاريسوسا
carrocera	كاروسيرا
cartelle	كارتيي
carucedo	كاروسيذو
castalla	كاستايا
castellanos	كاستييانوس
castelldans	كاستييدانس
castelldefels	كاستييديفيلس
castellote	كاستييوتي
castells	كاستييس
castelltallat	كاستييتايات
castellvell	كاستييبيي
castilla	كاستييا
castillejar	كاستييخار
castrillon	كاسترييون
castrodeza	كاستروذيسا
castrogeriz	كاستروخيريس
castrogonzalo	كاستروغونسالو
catllal	كاتيال
cavezon	كابيسون
cazalegas	كاساليغاس
cea	سا
ceadea	ساذيا
ceanuri	سانوري
cebanico	سبانيكو
cebolla	سبويا
cebollar	سبويار
cebollera	سبويرا
cebreros	سبريروس
cebron	سبرون
ceclavin	سكلابين
cecos	سكوس
cedeira	سذييرا
cedillo	سذييو
cedrillas	سذريياس
cee	سي
cehegin	سإِخين
ceinos	سينوس
cejo	سخو
celadas	سلاذاس
celanova	سلانوبا
cella	سيا
celtiberia	سلتيبيريا
cenia	سنيا
cenicero	سنيسيرو
cenicientos	سنيسينتوس
cenizate	سنيساتي
cenlle	سني
centellas	سنتيياس
centenillo	سنتينييو
centro	سنترو
cepeda	سبيذا
cerceda	سرسيذا
cercedilla	سرسيذييا
cerda	سرذا
cerdedo	سرذيذو
cerdido	سرذيذو
cerezo	سريسو
cernegula	سرنيغولا
cerollera	سرويرا
cerralbo	سرالبو
cervera	سربيرا
cespedossa	سسبيذوسا
cestona	سستونا
cesuras	سسوراس
cetina	ستينا
ceuti	سوتي
chella	تْشيا
chilizarrias	تْشيليسارياس
chillon	تْشييون
chulilla	تْشولييا
chullo	تْشويو
ciadoncha	سياذونتْشا
cibea	سيبيا
cidad	سيذاذ
cidones	سيذونيس
ciempozuelos	سيمبوسويلوس
cieza	سيسا
cifuentes	سيفوينتيس
cigales	سيغاليس
cigüenza	سيغوينسا
cillamayor	سييامايور
cillas	سيياس
cilleros	سييروس
cimballa	سيمبايا
cinctorres	سينكتوريس
cintruenigo	سينتروينيغو
cional	سيونال
ciordia	سيورذيا
ciperez	سيبيريس
cirat	سيرات
cirauqui	سيراوكي
ciria	سيريا
ciriza	سيريسا
ciruelos	سيرويلوس
cirugeda	سيروخيذا
cisla	سيسلا
cisneros	سيسنيروس
cistierna	سيستيرنا
ciudadela	سيوذاذيلا
ciutadilla	سيوتاذييا
cobatillas	كوباتيياس
cocentaina	كوسينتاينا
cogollos	كوغويوس
cogolludo	كوغويوذو
colgadizos	كولغاذيسوس
collados	كوياذوس
collanzo	كويانسو
colliga	كويغا
comillas	كوميياس
corbelle	كوربيي
corella	كورييا
cortelazor	كورتيلاسور
corullon	كورويون
cotiella	كوتييا
cotillas	كوتيياس
cotillo	كوتييو
cozar	كوسار
creciente	كريسينتي
crevillente	كريبيينتي
cruce	كروسي
cubells	كوبييس
cudillero	كوذييرو
cuellar	كوييار
culla	كويا
cullera	كويرا
culleredo	كويريذو
delicias	دليسياس
deza	دسا
dicastillo	ديكاستييو
diezma	ديسما
dozon	دوسون
ecija	أسيخا
elizondo	أليسوندو
encinas	أنسيناس
encinasola	أنسيناسولا
encinedo	أنسينيذو
encinillas	أنسينيياس
enciso	أنسيسو
erice	أريسي
erillas	أريياس
errazu	أراسو
escalonilla	أسكالونييا
escamilla	أسكامييا
escarroz	أسكاروس
escoriaza	أسكورياسا
escullar	أسكويار
escuzar	أسكوسار
espadilla	أسباذييا
espinilla	أسبينييا
espolla	أسبويا
estadilla	أستاذييا
estallo	أستايو
estella	أستييا
estivella	أستيبييا
ezcaray	أسكاراي
ezcurra	أسكورا
facinas	فاسيناس
falces	فالسيس
fariza	فاريسا
fatarella	فاتارييا
fermoselle	فرموسيي
fernancaballero	فرنانكابايرو
fonollosa	فونويوسا
fontellas	فونتيياس
fontllonga	فونتيونْغا
fonz	فونس
foz	فوس
frechilla	فريتْشييا
fresnedilla	فريسنيذييا
fuencemillan	فوينسيمييان
fuenllana	فوينيانا
fuentealbilla	فوينتيالبييا
fuentecen	فوينتيسين
fuentelcesped	فوينتيلسيسبيذ
fuentelsaz	فوينتيلساس
fuentenovilla	فوينتينوبييا
fuentepinilla	فوينتيبينييا
fuenterrebollo	فوينتيريبويو
galaroza	غالاروسا
galicia	غاليسيا
gallegos	غايغوس
gallinal	غاينال
gallur	غايور
galvez	غالبيس
garaballa	غارابايا
garcillan	غارسييان
gargallo	غارغايو
garoiez	غارويس
garrovillas	غاروبيياس
gaucin	غاوسين
genalguacil	خنالغواسيل
genevilla	خنيبييا
gimenells	خيمينييس
gironella	خيرونييا
godall	غوذاي
godelleta	غوذييتا
goiriz	غويريس
goizueta	غويسويتا
gomecello	غوميسييو
gormaz	غورماس
gozon	غوسون
granadella	غراناذييا
granadilla	غراناذييا
granollers	غرانويرس
grazalema	غراساليما
guadajoz	غواذاخوس
guadalcazar	غواذالكاسار
guillarey	غيياريي
guillena	غيينا
guillerias	غييرياس
guitiriz	غيتيريس
guriezo	غوريسو
hacinas	أسيناس
hellin	أين
herencia	أرينسيا
herramelluri	أرامييوري
hontalbilla	أنتالبييا
hontecillos	أنتيسييوس
huermeces	أيرميسيس
humilladero	أميياذيرو
husillos	أسييوس
idocin	إِذوسين
illana	إِيانا
illano	إِيانو
illas	إِياس
illescas	إِيسكاس
illora	إِيورا
illueca	إِيويكا
incinillas	إِنسينيياس
incio	إِنسيو
instincion	إِنستينسيون
irurozqui	إِروروسكي
izalzu	إِسالسو
izarra	إِسارا
iznájar	إِسناخار
iznalloz	إِسنايوس
iznatoraf	إِسناتوراف
jalance	خالانسي
jaraicejo	خارايسيخو
jarandilla	خاراندييا
jumilla	خومييا
labacolla	لاباكويا
laborcillas	لابورسيياس
lagunilla	لاغونييا
lanciego	لانسيغو
languilla	لانْغييا
lantadilla	لانتاذييا
lanz	لانس
lanza	لانسا
lapeza	لابيسا
larrainzar	لاراينسار
laza	لاسا
lecera	ليسيرا
leciñena	ليسينينا
leiza	لييسا
lences	لينسيس
leza	ليسا
lezama	ليساما
lezuza	ليسوسا
librilla	ليبرييا
lillol	لييول
lizarraga	ليساراغا
llado	ياذو
llafranc	يافرانك
llagostera	ياغوستيرا
llanes	يانيس
llansa	يانسا
llauri	ياوري
llera	يرا
llerena	يرينا
llers	يرس
lles	يس
llivia	يبيا
llobregales	يوبريغاليس
llodio	يوذيو
llombay	يومباي
lloseta	يوسيتا
llovera	يوبيرا
llubi	يوبي
lluchmayor	يوتْشمايور
lorenzana	لورينسانا
losacino	لوساسينو
lozoya	لوسويا
lozoyuela	لوسويويلا
lucena	لوسينا
luceni	لوسيني
lucillo	لوسييو
luezas	لويساس
luzaga	لوساغا
luzon	لوسون
maceda	ماسيذا
maella	ماييا
maello	ماييو
magacela	ماغاسيلا
magallon	ماغايون
magaz	ماغاس
maguilla	ماغييا
malaguilla	مالاغييا
malanquilla	مالانكييا
malcocinado	مالكوسيناذو
mallen	ماين
manlleu	مانيو
mansilla	مانسييا
manzanares	مانساناريس
manzaneda	مانسانيذا
manzanedo	مانسانيذو
manzaneque	مانسانيكي
manzanera	مانسانيرا
maracena	ماراسينا
marazoleja	ماراسوليخا
marbella	ماربييا
marcilla	مارسييا
marganell	مارغانيي
martorell	مارتوريي
masamagrell	ماساماغريي
matagalls	ماتاغايس
matallana	ماتايانا
matanza	ماتانسا
matapozuelos	ماتابوسويلوس
matienzo	ماتينسو
mazarete	ماساريتي
mazaricos	ماساريكوس
mazarron	ماسارون
mazarulleque	ماسارويكي
mazateron	ماساتيرون
mazuecos	ماسويكوس
medinaceli	مذيناسيلي
mellid	ميذ
membrilla	ممبرييا
membrillar	ممبرييار
membrillera	ممبرييرا
mequinenza	مكينينسا
mestanza	مستانسا
mieza	ميسا
millana	مييانا
millares	ميياريس
millena	ميينا
minglanilla	مينْغلانييا
mirandilla	ميراندييا
miravalles	ميرابايس
mocejon	موسيخون
molledo	مويذو
mollerusa	مويروسا
mollet	مويت
mollina	موينا
mollo	مويو
molvizar	مولبيسار
mondariz	مونداريس
monegrillo	مونيغرييو
montanchez	مونتانتْشيس
montellano	مونتييانو
montilla	مونتييا
montillana	مونتييانا
montizon	مونتيسون
monzon	مونسون
moratalla	موراتايا
morcillo	مورسييو
morell	موريي
morella	مورييا
morillejo	مورييخو
motilla	موتييا
motilleja	موتييخا
mozoncillo	موسونسييو
mucientes	موسينتيس
munilla	مونييا
murcia	مورسيا
nacimiento	ناسيمينتو
navacerrada	ناباسيراذا
navaconcejo	ناباكونسيخو
navahondilla	ناباأندييا
navalacruz	نابالاكروس
navalagamella	نابالاغامييا
navalcaballo	نابالكابايو
navalilla	نابالييا
navalmanzano	نابالمانسانو
navalonguilla	نابالونْغييا
navalsauz	نابالساوس
noceda	نوسيذا
noez	نويس
novallas	نوباياس
novillas	نوبيياس
nulles	نويس
numancia	نومانسيا
ocejon	أسيخون
ocentejo	أسينتيخو
olalla	ألايا
olazagutia	ألاساغوتيا
olivella	أليبييا
olivenza	أليبينسا
olleria	أيريا
ollo	أيو
olmedillas	ألميذيياس
olmillos	ألمييوس
olza	ألسا
onzonilla	أنسونييا
oquillas	أكيياس
orce	أرسي
orcera	أرسيرا
orgaz	أرغاس
orozco	أروسكو
ostiz	أستيس
oteiza	أتييسا
oyarzun	أيارسون
ozaeta	أسايتا
pajaroncillo	باخارونسييو
palafrugell	بالافروخيي
palencia	بالينسيا
palenciana	بالينسيانا
palenzuela	بالينسويلا
pallares	باياريس
pallars	بايارس
palleja	بايخا
pallerols	بايرولس
paniza	بانيسا
paracuellos	باراكوييوس
parcent	بارسينت
pardilla	بارذييا
parrillas	باريياس
parzan	بارسان
pastoriza	باستوريسا
pedrouzos	بذرووسوس
peleagonzalo	بلياغونسالو
peñacerrada	بناسيراذا
peracense	براسينسي
peraltilla	برالتييا
peranzanes	برانسانيس
peratallada	براتاياذا
perello	برييو
pescueza	بسكويسا
pinillos	بينييوس
pitillas	بيتيياس
pizarra	بيسارا
pizarral	بيسارال
plasencia	بلاسينسيا
plasenzuela	بلاسينسويلا
plencia	بلينسيا
pollensa	بوينسا
pollos	بويوس
ponzano	بونسانو
porzuna	بورسونا
posadilla	بوساذييا
povedilla	بوبيذييا
pozaldez	بوسالديس
pozoantiguo	بوسوانتيغوو
pozohondo	بوسوأندو
pozondon	بوسوندون
pozorrubio	بوسوروبيو
pozoseco	بوسوسيكو
pozuelo	بوسويلو
pradillo	براذييو
proaza	برواسا
purullena	بوروينا
puzol	بوسول
quintanapalla	كينتانابايا
quintanilla	كينتانييا
quisicedo	كيسيسيذو
rajadell	راخاذيي
ramallosa	رامايوسا
rebollera	ربويرا
rebollo	ربويو
reillo	رييو
relleu	ريو
rellinas	ريناس
reocin	روسين
respaldiza	رسبالديسا
restiello	رستييو
revillarruz	ربيياروس
riaza	رياسا
ribadesella	ريباذيسييا
riello	رييو
rilla	رييا
ripoll	ريبوي
ripollet	ريبويت
robledollano	روبليذويانو
rocallaura	روكاياورا
rociana	روسيانا
rodellar	روذييار
rodiezmo	روذيسمو
rollan	رويان
roncesvalles	رونسيسبايس
rosell	روسيي
rudilla	روذييا
ruguilla	روغييا
sabadell	ساباذيي
sacedon	ساسيذون
sacedoncillo	ساسيذونسييو
saceruela	ساسيرويلا
saelices	سايليسيس
salce	سالسي
salcedo	سالسيذو
sallent	ساينت
salsadella	سالساذييا
sancedo	سانسيذو
santaella	سانتاييا
santibañez	سانتيبانيس
santillana	سانتييانا
santiz	سانتيس
santurce	سانتورسي
sanzoles	سانسوليس
sarratella	ساراتييا
saucedilla	ساوسيذييا
saucelle	ساوسيي
sedella	سذييا
segurilla	سغورييا
sella	سيا
sellano	سيانو
semillas	سميياس
serradilla	سراذييا
serranillos	سرانييوس
sevilla	سبييا
seville	سبيي
sigüenza	سيغوينسا
silla	سييا
silleda	سييذا
sobradillo	سوبراذييو
socuellamos	سوكويياموس
solivella	سوليبييا
sollana	سويانا
soller	سوير
somozas	سوموساس
soncillo	سونسييو
sorzano	سورسانو
sotiello	سوتييو
sotopalacios	سوتوبالاسيوس
suances	سوانسيس
sucina	سوسينا
sudanell	سوذانيي
sumbilla	سومبييا
tafalla	تافايا
talladell	تاياذيي
tallante	تايانتي
taracena	تاراسينا
taradell	تاراذيي
taravilla	تارابييا
tarazona	تاراسونا
tazones	تاسونيس
tejadillos	تخاذييوس
tendilla	تندييا
tierzo	تيرسو
tiñosillos	تينوسييوس
tocina	توسينا
todellego	توذييغو
todolella	توذولييا
tolocirio	تولوسيريو
tomelloso	تومييوسو
torello	تورييو
torrecaballeros	توريكابايروس
torrecilla	توريسييا
torrejoncillo	توريخونسييو
torrellano	تورييانو
torrellas	توريياس
torremanzanas	توريمانساناس
torreorgaz	توريورغاس
torrequebradilla	توريكيبراذييا
torrevelilla	توريبيلييا
tortella	تورتييا
trabazos	تراباسوس
tragacete	تراغاسيتي
tramacastilla	تراماكاستييا
trazo	تراسو
trevelez	تريبيليس
trillo	ترييو
triollo	تريويو
troncedo	ترونسيذو
truchillas	تروتْشيياس
trujillanos	تروخييانوس
trujillo	تروخييو
trujillos	تروخييوس
turcia	تورسيا
turrillas	توريياس
uceda	أسيذا
ucero	أسيرو
ulldecona	أيديكونا
ulldemolins	أيديمولينس
uncastillo	أنكاستييو
unzue	أنسوي
urroz	أروس
utrillas	أتريياس
uztarroz	أستاروس
vadollano	باذويانو
valcavadillo	بالكاباذييو
valdaracete	بالداراسيتي
valdecaballeros	بالديكابايروس
valdecebollas	بالديسيبوياس
valdecebro	بالديسيبرو
valdemorillo	بالديمورييو
valdenoceda	بالدينوسيذا
valdesaz	بالديساس
valdestillas	بالديستيياس
valdezarza	بالديسارسا
valdunquillo	بالدونكييو
valencia	بالينسيا
valenzuela	بالينسويلا
vallada	باياذا
valladolises	باياذوليسيس
vallanca	بايانكا
vallbona	بايبونا
valldemosa	بايديموسا
valle	باي
vallecas	بايكاس
vallelado	بايلاذو
vallfogona	بايفوغونا
vallibona	بايبونا
vallirana	بايرانا
vallmoll	بايموي
vallromanas	بايروماناس
valls	بايس
valronquillo	بالرونكييو
valsequillo	بالسيكييو
vandellos	باندييوس
vecinos	بسينوس
veganzones	بغانسونيس
vegarienza	بغارينسا
velilla	بلييا
vellisca	بيسكا
vendrell	بندريي
ventillas	بنتيياس
vezdemarban	بسذيماربان
vicien	بيسين
vicolozano	بيكولوسانو
vidangoz	بيذانْغوس
viella	بييا
vilabella	بيلابييا
vilaller	بيلاير
villabona	بييابونا
villacañas	بيياكاناس
villacarriedo	بيياكاريذو
villacarrillo	بيياكارييو
villacastin	بيياكاستين
villaconejos	بيياكونيخوس
villada	بيياذا
villadecanes	بيياذيكانيس
villadepera	بيياذيبيرا
villadiego	بيياذيغو
villaescusa	بييايسكوسا
villafames	بييافاميس
villaflores	بييافلوريس
villafranca	بييافرانكا
villafranqueza	بييافرانكيسا
villafrechos	بييافريتْشوس
villafruela	بييافرويلا
villagaton	بيياغاتون
villager	بيياخير
villagonzalo	بيياغونسالو
villahermosa	بيياإِرموسا
villahoz	بيياأس
villajoyosa	بيياخويوسا
villalba	بييالبا
villalengua	بييالينْغوا
villalmanzo	بييالمانسو
villalonga	بييالونْغا
villalpando	بييالباندو
villalube	بييالوبي
villaluenga	بييالوينْغا
villalumbroso	بييالومبروسو
villalvaro	بييالبارو
villamalea	بيياماليا
villamalur	بييامالور
villamañan	بييامانان
villamandos	بيياماندوس
villamanrique	بييامانريكي
villamanta	بييامانتا
villamantilla	بييامانتييا
villamarin	بييامارين
villamartin	بييامارتين
villamayor	بييامايور
villamea	بيياميا
villamediana	بيياميذيانا
villamejil	بيياميخيل
villamesias	بيياميسياس
villamizar	بيياميسار
villamol	بييامول
villamuelas	بييامويلاس
villanúa	بييانوا
villanubla	بييانوبلا
villanueva	بييانويبا
villaobispo	بيياوبيسبو
villapalacios	بييابالاسيوس
villaquejida	بيياكيخيذا
villaquilambre	بيياكيلامبري
villaralbo	بييارالبو
villaralto	بييارالتو
villarejo	بيياريخو
villarente	بييارينتي
villaricos	بيياريكوس
villarino	بييارينو
villarrabe	بييارابي
villarramiel	بيياراميل
villarrasa	بيياراسا
villarreal	بيياريال
villarrobledo	بيياروبليذو
villarrodrigo	بيياروذريغو
villarroya	بييارويا
villarrubia	بيياروبيا
villarrubio	بيياروبيو
villasabariego	بيياساباريغو
villasandino	بيياساندينو
villasante	بيياسانتي
villasarracino	بيياساراسينو
villasayas	بيياساياس
villaseca	بيياسيكا
villaselan	بيياسيلان
villasilos	بيياسيلوس
villasrubias	بيياسروبياس
villastar	بيياستار
villatobas	بيياتوباس
villatoro	بيياتورو
villatoya	بيياتويا
villaturiel	بيياتوريل
villava	بييابا
villavaquerin	بيياباكيرين
villavendimio	بييابينديميو
villaviciosa	بييابيسيوسا
villaviudas	بييابيوذاس
villayon	بييايون
villaza	بيياسا
villegas	بييغاس
villel	بييل
villena	بيينا
villerias	بييرياس
villodrigo	بييوذريغو
villoldo	بييولدو
villora	بييورا
villores	بييوريس
villoria	بييوريا
vimianzo	بيميانسو
vinaceite	بيناسييتي
vinaroz	بيناروس
vizcaínos	بيسكاينوس
vizmanos	بيسمانوس
zafarraya	سافارايا
zagra	ساغرا
zahara	ساأرا
zahinos	ساإِنوس
zaidin	سايذين
zalla	سايا
zamarramala	سامارامالا
zamayon	سامايون
zambra	سامبرا
zambrana	سامبرانا
zamora	سامورا
zaorejas	ساوريخاس
zaragoza	ساراغوسا
zaratan	ساراتان
zarauz	ساراوس
zarra	سارا
zarzalejo	سارساليخو
zas	ساس
zizur	سيسور
zorita	سوريتا
zubia	سوبيا
zubieta	سوبيتا
zubiri	سوبيري
zucaina	سوكاينا
zudaire	سوذايري
zuera	سويرا
zuheros	سوإِروس
zujar	سوخار
zumarraga	سوماراغا
zumaya	سومايا
zuniga	سونيغا
zurgena	سورخينا
zurzarren	سورسارين
