ሃረሪ	ᎭᎸᎵ
ሆሣዕና	ᎰᏌᎯᎾ
ላሊበላ	ᎳᎵᏋᎳ
ሐረር	ᎭᎸᎵ
መቀሌ	ᏵᎩᏋᎴ
ማይጨው	ᎹᏱᏢᏫ
ምሁር	ᎻᎱᎵ
ሞጆ	ᎼᏦ
ሮቤ	ᎶᏇ
ሰመራ	ᏒᏵᎳ
ሶማሌ	ᏐᎹᎴ
ሶዶ	ᏐᏙ
ሻሸመኔ	ᏌᏒᏵᏁ
ቢሾፍቱ	ᏈᏐᏫᏚ
ትግራይ	ᏘᎩᎳᏱ
ትግራይ ክልል	ᏘᎩᎳᏱ ᎩᎵᎵ
ነቀምት	ᏅᎩᏋᎻᏘ
አላማጣ	ᎲᎳᎹᏘᏆ
አማራ	ᎲᎹᎳ
አምበር	ᎲᎻᏋᎵ
አምቦ	ᎲᎻᏉ
አረቅጥ	ᎲᎸᎩᏈᏘᏈ
አርሲ ነገሌ	ᎲᎵᏏ ᏅᎬᎴ
አርባ ምንጭ	ᎲᎵᏆ ᎻᏂᏟ
አሶሳ	ᎲᏐᏌ
አክሱም	ᎲᎩᏑᎻ
አዋሳ	ᎲᏩᏌ
አዲስ አበባ	ᎲᏗᏏ ᎲᏋᏆ
አዲግራት	ᎲᏗᎩᎳᏘ
አዳማ	ᎲᏓᎹ
አድዋ	ᎲᏗᏩ
አጋሮ	ᎲᎦᎶ
አፋር	ᎲᏩᎵ
እምድብር	ᎯᎻᏗᏈᎵ
እንዳስላሴ	ᎯᏂᏓᏏᎳᏎ
እዣ	ᎯᏌ
ኦሮሚያ	ᎰᎶᎻᏯ
ኪስታኒ	ᎩᏏᏔᏂ
ኮምቦልቻ	ᎪᎻᏉᎵᏝ
ወልቂጤ	ᏮᎵᎩᏈᏘᏇ
ወልዲያ	ᏮᎵᏗᏯ
ይርጋለም	ᏱᎵᎦᎸᎻ
ደሴ	ᏛᏎ
ደብረ ማርቆስ	ᏛᏈᎸ ᎹᎵᎩᏉᏏ
ደብረ ብርሃን	ᏛᏈᎸ ᏈᎵᎭᏂ
ደገሃቡር	ᏛᎬᎭᏊᎵ
ዲላአገና	ᏗᎳᎲᎬᎾ
ጅማ	ᏥᎹ
ጅጅጋ	ᏥᏥᎦ
ጉመር ቡታጂራ	ᎫᏵᎵ ᏊᏔᏥᎳ
ጋምቤላ	ᎦᎻᏇᎳ
ጎንደር	ᎪᏂᏛᎵ
ፍንፍኔ	ᏫᏂᏫᏁ
