ababuj	ᎠᏩᏭᎯ
abades	ᎠᏩᏕᏍ
abadia	ᎠᏩᏗᏯ
abadiano	ᎠᏩᏗᏯᏃ
abadin	ᎠᏩᏗᏂ
abanades	ᎠᏩᎾᏕᏍ
abanilla	ᎠᏩᏂᎵᏯ
abaran	ᎠᏩᎳᏂ
abegondo	ᎠᏪᎪᏂᏙ
abejar	ᎠᏪᎭᎵ
abejuela	ᎠᏪᎯᏪᎳ
abengibra	ᎠᏪᏂᎯᏫᎳ
abenojar	ᎠᏪᏃᎭᎵ
abiego	ᎠᏫᏰᎪ
abla	ᎠᏫᎳ
ablitas	ᎠᏫᎵᏔᏍ
abrera	ᎠᏫᎴᎳ
abrucena	ᎠᏫᎷᏎᎾ
acebo	ᎠᏎᏬ
acedera	ᎠᏎᏕᎳ
acehuche	ᎠᏎᎤᏞ
aceuchal	ᎠᏎᎤᏝᎵ
acrijos	ᎠᎩᎵᎰᏍ
adahuesca	ᎠᏓᏪᏍᎧ
adamuz	ᎠᏓᎽᏍ
adanero	ᎠᏓᏁᎶ
aday	ᎠᏓᎢ
adeje	ᎠᏕᎮ
ademuz	ᎠᏕᎽᏍ
ador	ᎠᏙᎵ
adra	ᎠᏗᎳ
adradas	ᎠᏗᎳᏓᏍ
adrados	ᎠᏗᎳᏙᏍ
adzaneta	ᎠᏗᏌᏁᏔ
agaete	ᎠᎦᎡᏖ
ager	ᎠᎮᎵ
agoncillo	ᎠᎪᏂᏏᎵᏲ
agost	ᎠᎪᏍᏘ
agramon	ᎠᎩᎳᎼᏂ
agramunt	ᎠᎩᎳᎽᏂᏘ
agreda	ᎠᎩᎴᏓ
agres	ᎠᎩᎴᏍ
agron	ᎠᎩᎶᏂ
aguadulce	ᎠᏆᏚᎵᏎ
aguamansa	ᎠᏆᎹᏂᏌ
aguaron	ᎠᏆᎶᏂ
aguas	ᎠᏆᏍ
aguaviva	ᎠᏆᏫᏩ
agudo	ᎠᎫᏙ
agüera	ᎠᏇᎳ
agüero	ᎠᏇᎶ
aguila	ᎠᎩᎳ
aguilafuente	ᎠᎩᎳᏫᏪᏂᏖ
aguilas	ᎠᎩᎳᏍ
agüimes	ᎠᏈᎺᏍ
agullana	ᎠᎫᎵᏯᎾ
agulo	ᎠᎫᎶ
ahigal	ᎠᎢᎦᎵ
ahillones	ᎠᎢᎵᏲᏁᏍ
aianis	ᎠᏯᏂᏍ
aibar	ᎠᎢᏩᎵ
aiguamurcia	ᎠᎢᏆᎽᎵᏍᏯ
ainsa	ᎠᎢᏂᏌ
aizpun	ᎠᎢᏍᏊᏂ
ajamil	ᎠᎭᎻᎵ
alaejos	ᎠᎳᎡᎰᏍ
alagon	ᎠᎳᎪᏂ
alajar	ᎠᎳᎭᎵ
alajero	ᎠᎳᎮᎶ
alameda	ᎠᎳᎺᏓ
alamedilla	ᎠᎳᎺᏗᎵᏯ
alamillo	ᎠᎳᎻᎵᏲ
alaminos	ᎠᎳᎻᏃᏍ
alange	ᎠᎳᏂᎮ
alarcon	ᎠᎳᎵᎪᏂ
alarilla	ᎠᎳᎵᎵᏯ
alaro	ᎠᎳᎶ
alatoz	ᎠᎳᏙᏍ
alayor	ᎠᎳᏲᎵ
alba	ᎠᎵᏩ
albacete	ᎠᎵᏩᏎᏖ
albages	ᎠᎵᏩᎮᏍ
albaladejo	ᎠᎵᏩᎳᏕᎰ
albalatillo	ᎠᎵᏩᎳᏘᎵᏲ
albana	ᎠᎵᏩᎾ
albanchez	ᎠᎵᏩᏂᏞᏍ
albares	ᎠᎵᏩᎴᏍ
albarracin	ᎠᎵᏩᎳᏏᏂ
albatana	ᎠᎵᏩᏔᎾ
albatera	ᎠᎵᏩᏖᎳ
albendea	ᎠᎵᏪᏂᏕᎠ
albendin	ᎠᎵᏪᏂᏗᏂ
albentosa	ᎠᎵᏪᏂᏙᏌ
alberique	ᎠᎵᏪᎵᎨ
alberite	ᎠᎵᏪᎵᏖ
albesa	ᎠᎵᏪᏌ
albinana	ᎠᎵᏫᎾᎾ
albocacer	ᎠᎵᏬᎧᏎᎵ
alboloduy	ᎠᎵᏬᎶᏚᎢ
albolote	ᎠᎵᏬᎶᏖ
albondon	ᎠᎵᏬᏂᏙᏂ
alboraya	ᎠᎵᏬᎳᏯ
alborea	ᎠᎵᏬᎴᎠ
albox	ᎠᎵᏬᎩᏍ
albudeite	ᎠᎵᏭᏕᎢᏖ
albujon	ᎠᎵᏭᎰᏂ
albuñol	ᎠᎵᏭᏃᎵ
albuñuelas	ᎠᎵᏭᏂᏪᎳᏍ
alcadozo	ᎠᎵᎧᏙᏐ
alcaine	ᎠᎵᎧᎢᏁ
alcampel	ᎠᎵᎧᎻᏇᎵ
alcanadre	ᎠᎵᎧᎾᏗᎴ
alcanar	ᎠᎵᎧᎾᎵ
alcanices	ᎠᎵᎧᏂᏎᏍ
alcaniz	ᎠᎵᎧᏂᏍ
alcantara	ᎠᎵᎧᏂᏔᎳ
alcantarilla	ᎠᎵᎧᏂᏔᎵᎵᏯ
alcantud	ᎠᎵᎧᏂᏚᏗ
alcaracejos	ᎠᎵᎧᎳᏎᎰᏍ
alcaraz	ᎠᎵᎧᎳᏍ
alcarras	ᎠᎵᎧᎳᏍ
alcaucin	ᎠᎵᎧᎤᏏᏂ
alcaudete	ᎠᎵᎧᎤᏕᏖ
alcazaren	ᎠᎵᎧᏌᎴᏂ
alceda	ᎠᎵᏎᏓ
alcira	ᎠᎵᏏᎳ
alcoba	ᎠᎵᎪᏩ
alcobendas	ᎠᎵᎪᏪᏂᏓᏍ
alcocebre	ᎠᎵᎪᏎᏫᎴ
alcocer	ᎠᎵᎪᏎᎵ
alcohujate	ᎠᎵᎪᎤᎭᏖ
alcolea	ᎠᎵᎪᎴᎠ
alcollarin	ᎠᎵᎪᎵᏯᎵᏂ
alconchel	ᎠᎵᎪᏂᏞᎵ
alconera	ᎠᎵᎪᏁᎳ
alcontar	ᎠᎵᎪᏂᏔᎵ
alcora	ᎠᎵᎪᎳ
alcorisa	ᎠᎵᎪᎵᏌ
alcoroches	ᎠᎵᎪᎶᏞᏍ
alcover	ᎠᎵᎪᏪᎵ
alcoy	ᎠᎵᎪᎢ
alcubierre	ᎠᎵᎫᏫᏰᎴ
alcubillas	ᎠᎵᎫᏫᎵᏯᏍ
alcublas	ᎠᎵᎫᏫᎳᏍ
alcudia	ᎠᎵᎫᏗᏯ
alcuescar	ᎠᎵᏇᏍᎧᎵ
alcuneza	ᎠᎵᎫᏁᏌ
aldaya	ᎠᎵᏓᏯ
aldea	ᎠᎵᏕᎠ
aldeacentenera	ᎠᎵᏕᎠᏎᏂᏖᏁᎳ
aldealpozo	ᎠᎵᏕᎠᎵᏉᏐ
aldeaquemada	ᎠᎵᏕᎠᎨᎹᏓ
aldearrodrigo	ᎠᎵᏕᎠᎶᏗᎵᎪ
aldeavieja	ᎠᎵᏕᎠᏫᏰᎭ
aldehuela	ᎠᎵᏕᏪᎳ
aldeire	ᎠᎵᏕᎢᎴ
aldover	ᎠᎵᏙᏪᎵ
aledo	ᎠᎴᏙ
alegria	ᎠᎴᎩᎵᏯ
alerre	ᎠᎴᎴ
aleson	ᎠᎴᏐᏂ
alfacar	ᎠᎵᏩᎧᎵ
alfaiz	ᎠᎵᏩᎢᏍ
alfajarin	ᎠᎵᏩᎭᎵᏂ
alfambra	ᎠᎵᏩᎻᏈᎳ
alfamen	ᎠᎵᏩᎺᏂ
alfara	ᎠᎵᏩᎳ
alfaraz	ᎠᎵᏩᎳᏍ
alfaro	ᎠᎵᏩᎶ
alfarras	ᎠᎵᏩᎳᏍ
alfoz	ᎠᎵᏬᏍ
algaida	ᎠᎵᎦᎢᏓ
algamitas	ᎠᎵᎦᎻᏔᏍ
algarinejo	ᎠᎵᎦᎵᏁᎰ
algarra	ᎠᎵᎦᎳ
algarrobo	ᎠᎵᎦᎶᏬ
algatocin	ᎠᎵᎦᏙᏏᏂ
algeciras	ᎠᎵᎮᏏᎳᏍ
algemesi	ᎠᎵᎮᎺᏏ
algete	ᎠᎵᎮᏖ
alginet	ᎠᎵᎯᏁᏘ
algodonales	ᎠᎵᎪᏙᎾᎴᏍ
algora	ᎠᎵᎪᎳ
algria	ᎠᎵᎩᎵᏯ
alguaire	ᎠᎵᏆᎢᎴ
alguazas	ᎠᎵᏆᏌᏍ
algueña	ᎠᎵᎨᎾ
alia	ᎠᎵᏯ
aliaga	ᎠᎵᏯᎦ
alicante	ᎠᎵᎧᏂᏖ
aliseda	ᎠᎵᏎᏓ
aljaraque	ᎠᎵᎭᎳᎨ
aljibe	ᎠᎵᎯᏪ
aljorra	ᎠᎵᎰᎳ
aljucen	ᎠᎵᎱᏎᏂ
allariz	ᎠᎵᏯᎵᏍ
allepuz	ᎠᎵᏰᏊᏍ
aller	ᎠᎵᏰᎵ
alles	ᎠᎵᏰᏍ
allo	ᎠᎵᏲ
alloza	ᎠᎵᏲᏌ
almacellas	ᎠᎵᎹᏎᎵᏯᏍ
almachar	ᎠᎵᎹᏝᎵ
almaciles	ᎠᎵᎹᏏᎴᏍ
almaden	ᎠᎵᎹᏕᏂ
almadenejos	ᎠᎵᎹᏕᏁᎰᏍ
almadrones	ᎠᎵᎹᏗᎶᏁᏍ
almagro	ᎠᎵᎹᎩᎶ
almajano	ᎠᎵᎹᎭᏃ
almaluez	ᎠᎵᎹᎵᏪᏍ
almansa	ᎠᎵᎹᏂᏌ
almanza	ᎠᎵᎹᏂᏌ
almaraz	ᎠᎵᎹᎳᏍ
almatret	ᎠᎵᎹᏘᎴᏘ
almazan	ᎠᎵᎹᏌᏂ
almazora	ᎠᎵᎹᏐᎳ
almazul	ᎠᎵᎹᏑᎵ
almedina	ᎠᎵᎺᏗᎾ
almedinilla	ᎠᎵᎺᏗᏂᎵᏯ
almegijar	ᎠᎵᎺᎯᎭᎵ
almeida	ᎠᎵᎺᎢᏓ
almenar	ᎠᎵᎺᎾᎵ
almenara	ᎠᎵᎺᎾᎳ
almendra	ᎠᎵᎺᏂᏗᎳ
almendral	ᎠᎵᎺᏂᏗᎳᎵ
almendralejo	ᎠᎵᎺᏂᏗᎳᎴᎰ
almendricos	ᎠᎵᎺᏂᏗᎵᎪᏍ
almendros	ᎠᎵᎺᏂᏗᎶᏍ
almeria	ᎠᎵᎺᎵᏯ
almogia	ᎠᎵᎼᎯᏯ
almoguera	ᎠᎵᎼᎨᎳ
almohaja	ᎠᎵᎼᎠᎭ
almoharin	ᎠᎵᎼᎠᎵᏂ
almonte	ᎠᎵᎼᏂᏖ
almoradi	ᎠᎵᎼᎳᏗ
almorox	ᎠᎵᎼᎶᎩᏍ
almudebar	ᎠᎵᎽᏕᏩᎵ
almuñécar	ᎠᎵᎽᏁᎧᎵ
almuniente	ᎠᎵᎽᏂᏰᏂᏖ
almuradiel	ᎠᎵᎽᎳᏗᏰᎵ
almusafes	ᎠᎵᎽᏌᏪᏍ
alobras	ᎠᎶᏫᎳᏍ
alocen	ᎠᎶᏎᏂ
alora	ᎠᎶᎳ
alos	ᎠᎶᏍ
alosno	ᎠᎶᏍᏃ
alovera	ᎠᎶᏪᎳ
alozaina	ᎠᎶᏌᎢᎾ
alp	ᎠᎵᏈ
alpandeire	ᎠᎵᏆᏂᏕᎢᎴ
alpanseque	ᎠᎵᏆᏂᏎᎨ
alpedroches	ᎠᎵᏇᏗᎶᏞᏍ
alpeñés	ᎠᎵᏇᏁᏍ
alpens	ᎠᎵᏇᏂᏍ
alpera	ᎠᎵᏇᎳ
alperiz	ᎠᎵᏇᎵᏍ
alpuente	ᎠᎵᏈᏪᏂᏖ
alquezar	ᎠᎵᎨᏌᎵ
alsasua	ᎠᎵᏌᏍᏩ
altable	ᎠᎵᏔᏫᎴ
altamira	ᎠᎵᏔᎻᎳ
altarejos	ᎠᎵᏔᎴᎰᏍ
altea	ᎠᎵᏖᎠ
altorricon	ᎠᎵᏙᎵᎪᏂ
altoteiro	ᎠᎵᏙᏖᎢᎶ
altura	ᎠᎵᏚᎳ
alustante	ᎠᎷᏍᏔᏂᏖ
alvires	ᎠᎵᏫᎴᏍ
alzola	ᎠᎵᏐᎳ
amaya	ᎠᎹᏯ
amer	ᎠᎺᎵ
ames	ᎠᎺᏍ
ameyugo	ᎠᎺᏳᎪ
amezaga	ᎠᎺᏌᎦ
amieva	ᎠᎻᏰᏩ
amoeiro	ᎠᎼᎡᎢᎶ
amorebieta	ᎠᎼᎴᏫᏰᏔ
amposta	ᎠᎻᏉᏍᏔ
ampudia	ᎠᎻᏊᏗᏯ
ampuero	ᎠᎻᏈᏪᎶ
ampurias	ᎠᎻᏊᎵᏯᏍ
amurrio	ᎠᎽᎵᏲ
amusco	ᎠᎽᏍᎪ
aña	ᎠᎾ
anchuras	ᎠᏂᏡᎳᏍ
ancin	ᎠᏂᏏᏂ
andalucia	ᎠᏂᏓᎷᏍᏯ
andavias	ᎠᏂᏓᏫᏯᏍ
andilla	ᎠᏂᏗᎵᏯ
andoain	ᎠᏂᏙᎠᎢᏂ
andorra	ᎠᏂᏙᎳ
andosilla	ᎠᏂᏙᏏᎵᏯ
andraitx	ᎠᏂᏗᎳᎢᏟ
andujar	ᎠᏂᏚᎭᎵ
angles	ᎠᏂᎩᎴᏍ
anglesola	ᎠᏂᎩᎴᏐᎳ
angüés	ᎠᏂᏇᏍ
anguiano	ᎠᏂᎩᏯᏃ
anguix	ᎠᏂᎩᎩᏍ
aniñón	ᎠᏂᏃᏂ
anleo	ᎠᏂᎴᎣ
añon	ᎠᏃᏂ
añora	ᎠᏃᎳ
anso	ᎠᏂᏐ
antas	ᎠᏂᏔᏍ
antequera	ᎠᏂᏖᎨᎳ
antigüedad	ᎠᏂᏘᏇᏓᏗ
antonaña	ᎠᏂᏙᎾᎾ
anzanigo	ᎠᏂᏌᏂᎪ
anzuola	ᎠᏂᏍᏬᎳ
anzur	ᎠᏂᏑᎵ
apatamonasterio	ᎠᏆᏔᎼᎾᏍᏖᎵᏲ
apellaniz	ᎠᏇᎵᏯᏂᏍ
aquilue	ᎠᎩᎵᏪ
aracena	ᎠᎳᏎᎾ
arafo	ᎠᎳᏬ
aragon	ᎠᎳᎪᏂ
aragoncillo	ᎠᎳᎪᏂᏏᎵᏲ
aranarache	ᎠᎳᎾᎳᏞ
aranaz	ᎠᎳᎾᏍ
arandillo	ᎠᎳᏂᏗᎵᏲ
aranjuez	ᎠᎳᏂᎯᏪᏍ
arano	ᎠᎳᏃ
aranzazu	ᎠᎳᏂᏌᏑ
aranzuegue	ᎠᎳᏂᏍᏪᎨ
arapiles	ᎠᎳᏈᎴᏍ
aras	ᎠᎳᏍ
aravaca	ᎠᎳᏩᎧ
araya	ᎠᎳᏯ
arbeca	ᎠᎵᏪᎧ
arbo	ᎠᎵᏬ
arbos	ᎠᎵᏬᏍ
arceniega	ᎠᎵᏎᏂᏰᎦ
archena	ᎠᎵᏞᎾ
archilla	ᎠᎵᏟᎵᏯ
arcos	ᎠᎵᎪᏍ
arcusa	ᎠᎵᎫᏌ
ardisa	ᎠᎵᏗᏌ
aren	ᎠᎴᏂ
arenas	ᎠᎴᎾᏍ
areo	ᎠᎴᎣ
ares	ᎠᎴᏍ
areta	ᎠᎴᏔ
arevalillo	ᎠᎴᏩᎵᎵᏲ
arevalo	ᎠᎴᏩᎶ
arganda	ᎠᎵᎦᏂᏓ
arganza	ᎠᎵᎦᏂᏌ
arguedas	ᎠᎵᎨᏓᏍ
arguellite	ᎠᎵᎨᎵᏱᏖ
arguineguin	ᎠᎵᎩᏁᎩᏂ
arguis	ᎠᎵᎩᏍ
arija	ᎠᎵᎭ
arinaga	ᎠᎵᎾᎦ
ariñez	ᎠᎵᏁᏍ
ariño	ᎠᎵᏃ
arive	ᎠᎵᏪ
ariza	ᎠᎵᏌ
arizala	ᎠᎵᏌᎳ
arjona	ᎠᎵᎰᎾ
arjonilla	ᎠᎵᎰᏂᎵᏯ
arlanzon	ᎠᎵᎳᏂᏐᏂ
armuna	ᎠᎵᎽᎾ
arnedillo	ᎠᎵᏁᏗᎵᏲ
arnedo	ᎠᎵᏁᏙ
arnes	ᎠᎵᏁᏍ
arnoya	ᎠᎵᏃᏯ
arnuero	ᎠᎵᏂᏪᎶ
aroche	ᎠᎶᏞ
aroizu	ᎠᎶᎢᏑ
arona	ᎠᎶᎾ
arquillos	ᎠᎵᎩᎵᏲᏍ
arrabalde	ᎠᎳᏩᎵᏕ
arrancacepas	ᎠᎳᏂᎧᏎᏆᏍ
arrazola	ᎠᎳᏐᎳ
arrecife	ᎠᎴᏏᏪ
arredondo	ᎠᎴᏙᏂᏙ
arriate	ᎠᎵᏯᏖ
arrieta	ᎠᎵᏰᏔ
arrigorriaga	ᎠᎵᎪᎵᏯᎦ
arriondas	ᎠᎵᏲᏂᏓᏍ
arroba	ᎠᎶᏩ
arroniz	ᎠᎶᏂᏍ
arroyal	ᎠᎶᏯᎵ
arroyos	ᎠᎶᏲᏍ
arta	ᎠᎵᏔ
artajona	ᎠᎵᏔᎰᎾ
artana	ᎠᎵᏔᎾ
artazu	ᎠᎵᏔᏑ
arteijo	ᎠᎵᏖᎢᎰ
artenara	ᎠᎵᏖᎾᎳ
artes	ᎠᎵᏖᏍ
artieda	ᎠᎵᏘᏰᏓ
arties	ᎠᎵᏘᏰᏍ
arucas	ᎠᎷᎧᏍ
arure	ᎠᎷᎴ
arzúa	ᎠᎵᏑᎠ
asco	ᎠᏍᎪ
asin	ᎠᏏᏂ
asomadilla	ᎠᏐᎹᏗᎵᏯ
ason	ᎠᏐᏂ
aspariegos	ᎠᏍᏆᎵᏰᎪᏍ
aspe	ᎠᏍᏇ
astillero	ᎠᏍᏘᎵᏰᎶ
astudillo	ᎠᏍᏚᏗᎵᏲ
asturianos	ᎠᏍᏚᎵᏯᏃᏍ
asturias	ᎠᏍᏚᎵᏯᏍ
atalaya	ᎠᏔᎳᏯ
atalayasa	ᎠᏔᎳᏯᏌ
ataquines	ᎠᏔᎩᏁᏍ
atarfe	ᎠᏔᎵᏪ
atauta	ᎠᏔᎤᏔ
atea	ᎠᏖᎠ
ateca	ᎠᏖᎧ
atienza	ᎠᏘᏰᏂᏌ
atocha	ᎠᏙᏝ
auñón	ᎠᎤᏃᏂ
ausejo	ᎠᎤᏎᎰ
autol	ᎠᎤᏙᎵ
autoria	ᎠᎤᏙᎵᏯ
aveinte	ᎠᏪᎢᏂᏖ
avellanes	ᎠᏪᎵᏯᏁᏍ
avila	ᎠᏫᎳ
aviles	ᎠᏫᎴᏍ
avinyo	ᎠᏫᏂᏲ
avinyonet	ᎠᏫᏂᏲᏁᏘ
avion	ᎠᏫᏲᏂ
ayamonte	ᎠᏯᎼᏂᏖ
ayedo	ᎠᏰᏙ
ayllon	ᎠᎢᎵᏲᏂ
ayna	ᎠᎢᎾ
ayora	ᎠᏲᎳ
aytona	ᎠᎢᏙᎾ
azagra	ᎠᏌᎩᎳ
azaila	ᎠᏌᎢᎳ
azañón	ᎠᏌᏃᏂ
azanuy	ᎠᏌᏄᎢ
azcoitia	ᎠᏍᎪᎢᏘᏯ
aznalcazar	ᎠᏍᎾᎵᎧᏌᎵ
aznalcollar	ᎠᏍᎾᎵᎪᎵᏯᎵ
azpeitia	ᎠᏍᏇᎢᏘᏯ
azuaga	ᎠᏍᏩᎦ
azuara	ᎠᏍᏩᎳ
azuelo	ᎠᏍᏪᎶ
babilafuente	ᏆᏫᎳᏫᏪᏂᏖ
bacares	ᏆᎧᎴᏍ
badajoz	ᏆᏓᎰᏍ
badalona	ᏆᏓᎶᎾ
badaran	ᏆᏓᎳᏂ
badenas	ᏆᏕᎾᏍ
badolatosa	ᏆᏙᎳᏙᏌ
badules	ᏆᏚᎴᏍ
baena	ᏆᎡᎾ
baeza	ᏆᎡᏌ
baga	ᏆᎦ
baguena	ᏆᎨᎾ
bagur	ᏆᎫᎵ
bahillo	ᏆᎢᎵᏲ
bailen	ᏆᎢᎴᏂ
baillo	ᏆᎢᎵᏲ
bajamar	ᏆᎭᎹᎵ
balaguer	ᏆᎳᎨᎵ
balazote	ᏆᎳᏐᏖ
balces	ᏆᎵᏎᏍ
balconete	ᏆᎵᎪᏁᏖ
baleira	ᏆᎴᎢᎳ
balerma	ᏆᎴᎵᎹ
balimbra	ᏆᎵᎻᏈᎳ
balira	ᏆᎵᎳ
ballerias	ᏆᎵᏰᎵᏯᏍ
ballestar	ᏆᎵᏰᏍᏔᎵ
ballesteros	ᏆᎵᏰᏍᏖᎶᏍ
ballobar	ᏆᎵᏲᏩᎵ
balsareny	ᏆᎵᏌᎴᏂ
balsicas	ᏆᎵᏏᎧᏍ
baltanas	ᏆᎵᏔᎾᏍ
baltar	ᏆᎵᏔᎵ
bañares	ᏆᎾᎴᏍ
bande	ᏆᏂᏕ
bañeras	ᏆᏁᎳᏍ
bañobarez	ᏆᏃᏩᎴᏍ
bañolas	ᏆᏃᎳᏍ
bañon	ᏆᏃᏂ
banyoles	ᏆᏂᏲᎴᏍ
banyos	ᏆᏂᏲᏍ
baracaldo	ᏆᎳᎧᎵᏙ
barahona	ᏆᎳᎣᎾ
barajas	ᏆᎳᎭᏍ
baralla	ᏆᎳᎵᏯ
barambio	ᏆᎳᎻᏈᏲ
barasoain	ᏆᎳᏐᎠᎢᏂ
barbadanes	ᏆᎵᏩᏓᏁᏍ
barbadillo	ᏆᎵᏩᏗᎵᏲ
barbalimpia	ᏆᎵᏩᎵᎻᏈᏯ
barbastro	ᏆᎵᏩᏍᏘᎶ
barca	ᏆᎵᎧ
barcarrota	ᏆᎵᎧᎶᏔ
barcena	ᏆᎵᏎᎾ
barcheta	ᏆᎵᏞᏔ
barcience	ᏆᎵᏍᏰᏂᏎ
barcones	ᏆᎵᎪᏁᏍ
bareyo	ᏆᎴᏲ
bargas	ᏆᎵᎦᏍ
barjos	ᏆᎵᎰᏍ
barqueros	ᏆᎵᎨᎶᏍ
barracas	ᏆᎳᎧᏍ
barrachina	ᏆᎳᏟᎾ
barraco	ᏆᎳᎪ
barrax	ᏆᎳᎩᏍ
barreiros	ᏆᎴᎢᎶᏍ
barriomartin	ᏆᎵᏲᎹᎵᏘᏂ
barro	ᏆᎶ
barruecopardo	ᏆᎵᏪᎪᏆᎵᏙ
barzana	ᏆᎵᏌᎾ
basauri	ᏆᏌᎤᎵ
bascara	ᏆᏍᎧᎳ
basella	ᏆᏎᎵᏯ
batea	ᏆᏖᎠ
baterno	ᏆᏖᎵᏃ
bayo	ᏆᏲ
bayona	ᏆᏲᎾ
baza	ᏆᏌ
beade	ᏇᎠᏕ
beariz	ᏇᎠᎵᏍ
beas	ᏇᎠᏍ
becarrea	ᏇᎧᎴᎠ
beceite	ᏇᏎᎢᏖ
bechi	ᏇᏟ
bedar	ᏇᏓᎵ
bedmar	ᏇᏗᎹᎵ
begijar	ᏇᎯᎭᎵ
begonte	ᏇᎪᏂᏖ
beire	ᏇᎢᎴ
beires	ᏇᎢᎴᏍ
bejar	ᏇᎭᎵ
bejis	ᏇᎯᏍ
belchite	ᏇᎵᏟᏖ
belianes	ᏇᎵᏯᏁᏍ
belinchón	ᏇᎵᏂᏠᏂ
bello	ᏇᎵᏲ
belltall	ᏇᎵᏱᏔᎵᏱ
bellver	ᏇᎵᏱᏪᎵ
bellvey	ᏇᎵᏱᏪᎢ
bellvis	ᏇᎵᏱᏫᏍ
belmez	ᏇᎵᎺᏍ
belmonte	ᏇᎵᎼᏂᏖ
belmontejo	ᏇᎵᎼᏂᏖᎰ
belorado	ᏇᎶᎳᏙ
belver	ᏇᎵᏪᎵ
bembibre	ᏇᎻᏈᏫᎴ
benabarre	ᏇᎾᏩᎴ
benacazon	ᏇᎾᎧᏐᏂ
benafigos	ᏇᎾᏫᎪᏍ
benagalbon	ᏇᎾᎦᎵᏬᏂ
benaguacil	ᏇᎾᏆᏏᎵ
benahadux	ᏇᎾᎠᏚᎩᏍ
benahavis	ᏇᎾᎠᏫᏍ
benajarafa	ᏇᏀᎠᎳᏩ
benalauria	ᏇᎾᎳᎤᎵᏯ
benamaurel	ᏇᎾᎹᎤᎴᎵ
benameji	ᏇᎾᎺᎯ
benamocarra	ᏇᎾᎼᎧᎳ
benaocaz	ᏇᎾᎣᎧᏍ
benaojan	ᏇᎾᎣᎭᏂ
benarraba	ᏇᎾᎳᏩ
benasal	ᏇᎾᏌᎵ
benasque	ᏇᎾᏍᎨ
benatae	ᏇᎾᏔᎡ
benavente	ᏇᎾᏪᏂᏖ
benavides	ᏇᎾᏫᏕᏍ
benavites	ᏇᎾᏫᏖᏍ
benegiles	ᏇᏁᎯᎴᏍ
benejama	ᏇᏁᎭᎹ
benejuzar	ᏇᏁᎱᏌᎵ
benferri	ᏇᏂᏪᎵ
beniarda	ᏇᏂᏯᎵᏓ
beniarres	ᏇᏂᏯᎴᏍ
benicasim	ᏇᏂᎧᏏᎻ
benichembla	ᏇᏂᏞᎻᏈᎳ
benifallet	ᏇᏂᏩᎵᏰᏘ
benifallim	ᏇᏂᏩᎵᏱᎻ
benifayo	ᏇᏂᏩᏲ
beniganim	ᏇᏂᎦᏂᎻ
benilloba	ᏇᏂᎵᏲᏩ
benimasot	ᏇᏂᎹᏐᏘ
beninar	ᏇᏂᎾᎵ
beniopa	ᏇᏂᏲᏆ
benisa	ᏇᏂᏌ
benisanet	ᏇᏂᏌᏁᏘ
beniseno	ᏇᏂᏎᏃ
benitachell	ᏇᏂᏔᏞᎵᏱ
benizalon	ᏇᏂᏌᎶᏂ
benuza	ᏇᏄᏌ
benzu	ᏇᏂᏑ
beranga	ᏇᎳᏂᎦ
berantevilla	ᏇᎳᏂᏖᏫᎵᏯ
bercedo	ᏇᎵᏎᏙ
bercero	ᏇᎵᏎᎶ
berducedo	ᏇᎵᏚᏎᏙ
berdun	ᏇᎵᏚᏂ
berga	ᏇᎵᎦ
bergasa	ᏇᎵᎦᏌ
bergondo	ᏇᎵᎪᏂᏙ
bergüenda	ᏇᎵᏇᏂᏓ
berja	ᏇᎵᎭ
berlanga	ᏇᎵᎳᏂᎦ
bermeo	ᏇᎵᎺᎣ
berriz	ᏇᎵᏍ
berrocal	ᏇᎶᎧᎵ
berzocana	ᏇᎵᏐᎧᎾ
besalu	ᏇᏌᎷ
besaya	ᏇᏌᏯ
bescane	ᏇᏍᎧᏁ
betancuria	ᏇᏔᏂᎫᎵᏯ
betanzos	ᏇᏔᏂᏐᏍ
betelu	ᏇᏖᎷ
betera	ᏇᏖᎳ
beteta	ᏇᏖᏔ
bezes	ᏇᏎᏍ
biar	ᏈᏯᎵ
bibey	ᏈᏪᎢ
biel	ᏈᏰᎵ
bielsa	ᏈᏰᎵᏌ
bienvenida	ᏈᏰᏂᏇᏂᏓ
biescas	ᏈᏰᏍᎧᏍ
bigastro	ᏈᎦᏍᏘᎶ
biguezal	ᏈᎨᏌᎵ
bimeda	ᏈᎺᏓ
bimenes	ᏈᎺᏁᏍ
binaced	ᏈᎾᏎᏗ
binefar	ᏈᏁᏩᎵ
binies	ᏈᏂᏰᏍ
binisalem	ᏈᏂᏌᎴᎻ
binue	ᏈᏂᏪ
biosca	ᏈᏲᏍᎧ
biota	ᏈᏲᏔ
biscarrues	ᏈᏍᎧᎵᏪᏍ
biurrun	ᏈᏳᎷᏂ
bizberri	ᏈᏍᏪᎵ
blanca	ᏈᎳᏂᎧ
blancas	ᏈᎳᏂᎧᏍ
blancos	ᏈᎳᏂᎪᏍ
blanes	ᏈᎳᏁᏍ
blanquilla	ᏈᎳᏂᎩᎵᏯ
blazques	ᏈᎳᏍᎨᏍ
blecua	ᏈᎴᏆ
blesa	ᏈᎴᏌ
boada	ᏉᎠᏓ
boadilla	ᏉᎠᏗᎵᏯ
boal	ᏉᎠᎵ
bobadilla	ᏉᏩᏗᎵᏯ
boboras	ᏉᏬᎳᏍ
bocairente	ᏉᎧᎢᎴᏂᏖ
boceguillas	ᏉᏎᎩᎵᏯᏍ
bocigas	ᏉᏏᎦᏍ
boecillo	ᏉᎡᏏᎵᏲ
bogarra	ᏉᎦᎳ
bogarre	ᏉᎦᎴ
bohoyo	ᏉᎣᏲ
boimorto	ᏉᎢᎼᎵᏙ
bojar	ᏉᎭᎵ
bolaños	ᏉᎳᏃᏍ
bolea	ᏉᎴᎠ
boltaña	ᏉᎵᏔᎾ
bonanza	ᏉᎾᏂᏌ
boñar	ᏉᎾᎵ
bonares	ᏉᎾᎴᏍ
boniches	ᏉᏂᏞᏍ
bonilla	ᏉᏂᎵᏯ
boqueijon	ᏉᎨᎢᎰᏂ
bordon	ᏉᎵᏙᏂ
borines	ᏉᎵᏁᏍ
borja	ᏉᎵᎭ
bornoba	ᏉᎵᏃᏩ
bornos	ᏉᎵᏃᏍ
borobia	ᏉᎶᏫᏯ
borox	ᏉᎶᎩᏍ
borres	ᏉᎴᏍ
borriol	ᏉᎵᏲᎵ
bosost	ᏉᏐᏍᏘ
bot	ᏉᏘ
botorrita	ᏉᏙᎵᏔ
boveda	ᏉᏪᏓ
brabatas	ᏈᎳᏩᏔᏍ
brañosera	ᏈᎳᏃᏎᎳ
braojos	ᏈᎳᎣᎰᏍ
brea	ᏈᎴᎠ
breda	ᏈᎴᏓ
brenes	ᏈᎴᏁᏍ
bretun	ᏈᎴᏚᏂ
brihuega	ᏈᎵᏪᎦ
briñas	ᏈᎵᎾᏍ
brion	ᏈᎵᏲᏂ
briones	ᏈᎵᏲᏁᏍ
briviesca	ᏈᎵᏫᏰᏍᎧ
bronchales	ᏈᎶᏂᏝᎴᏍ
broto	ᏈᎶᏙ
brozas	ᏈᎶᏌᏍ
brunete	ᏈᎷᏁᏖ
brunola	ᏈᎷᏃᎳ
buciegas	ᏊᏍᏰᎦᏍ
budia	ᏊᏗᏯ
buena	ᏈᏪᎾ
buenavista	ᏈᏪᎾᏫᏍᏔ
buendia	ᏈᏪᏂᏗᏯ
bueu	ᏈᏪᎤ
bufali	ᏊᏩᎵ
bugarra	ᏊᎦᎳ
buger	ᏊᎮᎵ
buitre	ᏈᏫᏘᎴ
bujalance	ᏊᎭᎳᏂᏎ
bujan	ᏊᎭᏂ
bujaraloz	ᏊᎭᎳᎶᏍ
bullas	ᏊᎵᏯᏍ
buñero	ᏊᏁᎶ
buniel	ᏊᏂᏰᎵ
buñol	ᏊᏃᎵ
buñola	ᏊᏃᎳ
buñuel	ᏊᏂᏪᎵ
burbaguena	ᏊᎵᏩᎨᎾ
bures	ᏊᎴᏍ
burgo	ᏊᎵᎪ
burgohondo	ᏊᎵᎪᎣᏂᏙ
burgos	ᏊᎵᎪᏍ
burguete	ᏊᎵᎨᏖ
burgui	ᏊᎵᎩ
burguillos	ᏊᎵᎩᎵᏲᏍ
buron	ᏊᎶᏂ
burriana	ᏊᎵᏯᎾ
burujon	ᏊᎷᎰᏂ
busot	ᏊᏐᏘ
busquistar	ᏊᏍᎩᏍᏔᎵ
cabana	ᎧᏩᎾ
cabañaquinta	ᎧᏩᎾᎩᏂᏔ
cabañas	ᎧᏩᎾᏍ
cabanes	ᎧᏩᏁᏍ
cabanillas	ᎧᏩᏂᎵᏯᏍ
cabe	ᎧᏪ
cabezamesada	ᎧᏪᏌᎺᏌᏓ
cabezarados	ᎧᏪᏌᎳᏙᏍ
cabezo	ᎧᏪᏐ
cabolafuente	ᎧᏬᎳᏫᏪᏂᏖ
cabra	ᎧᏫᎳ
cabrales	ᎧᏫᎳᎴᏍ
cabranes	ᎧᏫᎳᏁᏍ
cabreiros	ᎧᏫᎴᎢᎶᏍ
cabrillanes	ᎧᏫᎵᎵᏯᏁᏍ
cabrillas	ᎧᏫᎵᎵᏯᏍ
cacabelos	ᎧᎧᏪᎶᏍ
caceres	ᎧᏎᎴᏍ
cachilla	ᎧᏟᎵᏯ
cachorrilla	ᎧᏠᎵᎵᏯ
cacin	ᎧᏏᏂ
cadagua	ᎧᏓᏆ
cadaques	ᎧᏓᎨᏍ
cadavedo	ᎧᏓᏪᏙ
cadi	ᎧᏗ
cadiar	ᎧᏗᏯᎵ
cadreita	ᎧᏗᎴᎢᏔ
cadrete	ᎧᏗᎴᏖ
cala	ᎧᎳ
calaceite	ᎧᎳᏎᎢᏖ
calaf	ᎧᎳᏫ
calafell	ᎧᎳᏪᎵᏱ
calahorra	ᎧᎳᎣᎳ
calamocha	ᎧᎳᎼᏝ
calamonte	ᎧᎳᎼᏂᏖ
calañas	ᎧᎳᎾᏍ
calanda	ᎧᎳᏂᏓ
calasparra	ᎧᎳᏍᏆᎳ
calatanazor	ᎧᎳᏔᎾᏐᎵ
calatayud	ᎧᎳᏔᏳᏗ
calatorao	ᎧᎳᏙᎳᎣ
calaveruela	ᎧᎳᏪᎵᏪᎳ
caldas	ᎧᎵᏓᏍ
calderina	ᎧᎵᏕᎵᎾ
caleruega	ᎧᎴᎵᏪᎦ
caleta	ᎧᎴᏔ
calicasas	ᎧᎵᎧᏌᏍ
calig	ᎧᎵᎩ
callejas	ᎧᎵᏰᎭᏍ
calonge	ᎧᎶᏂᎮ
calpe	ᎧᎵᏇ
caltojar	ᎧᎵᏙᎭᎵ
calvia	ᎧᎵᏫᏯ
calzadilla	ᎧᎵᏌᏗᎵᏯ
camaleno	ᎧᎹᎴᏃ
camallera	ᎧᎹᎵᏰᎳ
camarao	ᎧᎹᎳᎣ
camarasa	ᎧᎹᎳᏌ
camarena	ᎧᎹᎴᎾ
camarillas	ᎧᎹᎵᎵᏯᏍ
camariñas	ᎧᎹᎵᎾᏍ
camas	ᎧᎹᏍ
cambados	ᎧᎻᏆᏙᏍ
cambil	ᎧᎻᏈᎵ
cambre	ᎧᎻᏈᎴ
cambrils	ᎧᎻᏈᎵᎵᏍ
caminomorisco	ᎧᎻᏃᎼᎵᏍᎪ
caminreal	ᎧᎻᏂᎴᎠᎵ
campanario	ᎧᎻᏆᎾᎵᏲ
campanet	ᎧᎻᏆᏁᏘ
campanillas	ᎧᎻᏆᏂᎵᏯᏍ
campano	ᎧᎻᏆᏃ
campaspero	ᎧᎻᏆᏍᏇᎶ
campdevanol	ᎧᎻᏈᏕᏩᏃᎵ
campello	ᎧᎻᏇᎵᏲ
campillo	ᎧᎻᏈᎵᏲ
campillos	ᎧᎻᏈᎵᏲᏍ
campisabalos	ᎧᎻᏈᏌᏩᎶᏍ
campomanes	ᎧᎻᏉᎹᏁᏍ
camporredondo	ᎧᎻᏉᎴᏙᏂᏙ
camporrells	ᎧᎻᏉᎴᎵᏱᏍ
camporrobles	ᎧᎻᏉᎶᏫᎴᏍ
campos	ᎧᎻᏉᏍ
campotejar	ᎧᎻᏉᏖᎭᎵ
camprodor	ᎧᎻᏈᎶᏙᎵ
camprovin	ᎧᎻᏈᎶᏫᏂ
camunas	ᎧᎽᎾᏍ
cañada	ᎧᎾᏓ
cañadajuncosa	ᎧᎾᏓᎱᏂᎪᏌ
canales	ᎧᎾᎴᏍ
canals	ᎧᎾᎵᏍ
cañamares	ᎧᎾᎹᎴᏍ
cañamero	ᎧᎾᎺᎶ
cañar	ᎧᎾᎵ
cañaveral	ᎧᎾᏪᎳᎵ
cañaveras	ᎧᎾᏪᎳᏍ
cancarix	ᎧᏂᎧᎵᎩᏍ
cancienes	ᎧᏂᏍᏰᏁᏍ
candas	ᎧᏂᏓᏍ
candasnos	ᎧᏂᏓᏍᏃᏍ
candelaria	ᎧᏂᏕᎳᎵᏯ
candelario	ᎧᏂᏕᎳᎵᏲ
candeleda	ᎧᏂᏕᎴᏓ
candilichera	ᎧᏂᏗᎵᏞᎳ
candin	ᎧᏂᏗᏂ
canedo	ᎧᏁᏙ
canena	ᎧᏁᎾ
canero	ᎧᏁᎶ
canfranc	ᎧᏂᏫᎳᏂᎩ
cangas	ᎧᏂᎦᏍ
caniles	ᎧᏂᎴᏍ
canillas	ᎧᏂᎵᏯᏍ
canizal	ᎧᏂᏌᎵ
canizares	ᎧᏂᏌᎴᏍ
canizo	ᎧᏂᏐ
canjayar	ᎧᏂᎭᏯᎵ
cantalapiedra	ᎧᏂᏔᎳᏈᏰᏗᎳ
cantalejo	ᎧᏂᏔᎴᎰ
cantalojas	ᎧᏂᏔᎶᎭᏍ
cantalpino	ᎧᏂᏔᎵᏈᏃ
cantareros	ᎧᏂᏔᎴᎶᏍ
cantavieja	ᎧᏂᏔᏫᏰᎭ
canteras	ᎧᏂᏖᎳᏍ
cantillana	ᎧᏂᏘᎵᏯᎾ
cantoral	ᎧᏂᏙᎳᎵ
cantoria	ᎧᏂᏙᎵᏯ
canyellas	ᎧᏂᏰᎵᏯᏍ
caparroso	ᎧᏆᎶᏐ
capdella	ᎧᏈᏕᎵᏯ
capdepera	ᎧᏈᏕᏇᎳ
capellades	ᎧᏇᎵᏯᏕᏍ
capilduy	ᎧᏈᎵᏚᎢ
capilla	ᎧᏈᎵᏯ
carabaña	ᎧᎳᏩᎾ
carabanchel	ᎧᎳᏩᏂᏞᎵ
caracuel	ᎧᎳᏇᎵ
caralps	ᎧᎳᎵᏈᏍ
caravaca	ᎧᎳᏩᎧ
carbajo	ᎧᎵᏩᎰ
carbia	ᎧᎵᏫᏯ
carcaboso	ᎧᎵᎧᏬᏐ
carcabuey	ᎧᎵᎧᏫᏪᎢ
carcagente	ᎧᎵᎧᎮᏂᏖ
carcar	ᎧᎵᎧᎵ
carcastillo	ᎧᎵᎧᏍᏘᎵᏲ
carcelen	ᎧᎵᏎᎴᏂ
carchel	ᎧᎵᏞᎵ
carchelejo	ᎧᎵᏞᎴᎰ
cardejon	ᎧᎵᏕᎰᏂ
cardona	ᎧᎵᏙᎾ
carenas	ᎧᎴᎾᏍ
cariñena	ᎧᎵᏁᎾ
cariño	ᎧᎵᏃ
carlet	ᎧᎵᎴᏘ
carmena	ᎧᎵᎺᎾ
carracedelo	ᎧᎳᏎᏕᎶ
carral	ᎧᎳᎵ
carranque	ᎧᎳᏂᎨ
carranza	ᎧᎳᏂᏌ
carrascalejo	ᎧᎳᏍᎧᎴᎰ
carrascosa	ᎧᎳᏍᎪᏌ
carratraca	ᎧᎳᏘᎳᎧ
carreña	ᎧᎴᎾ
carril	ᎧᎵᎵ
carrizal	ᎧᎵᏌᎵ
carrizo	ᎧᎵᏐ
carrizosa	ᎧᎵᏐᏌ
carrocera	ᎧᎶᏎᎳ
carroo	ᎧᎶᎣ
cartama	ᎧᎵᏔᎹ
cartaya	ᎧᎵᏔᏯ
cartelle	ᎧᎵᏖᎵᏰ
carucedo	ᎧᎷᏎᏙ
casalarreina	ᎧᏌᎳᎴᎢᎾ
casar	ᎧᏌᎵ
casarabonela	ᎧᏌᎳᏬᏁᎳ
casarejos	ᎧᏌᎴᎰᏍ
casares	ᎧᏌᎴᏍ
casariche	ᎧᏌᎵᏞ
casasimarro	ᎧᏌᏏᎹᎶ
casatejada	ᎧᏌᏖᎭᏓ
casavieja	ᎧᏌᏫᏰᎭ
cascante	ᎧᏍᎧᏂᏖ
caseda	ᎧᏎᏓ
caseras	ᎧᏎᎳᏍ
caserras	ᎧᏎᎳᏍ
casinos	ᎧᏏᏃᏍ
caso	ᎧᏐ
caspe	ᎧᏍᏇ
castala	ᎧᏍᏔᎳ
castalla	ᎧᏍᏔᎵᏯ
castanesa	ᎧᏍᏔᏁᏌ
castaño	ᎧᏍᏔᏃ
castaras	ᎧᏍᏔᎳᏍ
castejon	ᎧᏍᏖᎰᏂ
castelflorite	ᎧᏍᏖᎵᏫᎶᎵᏖ
castellanos	ᎧᏍᏖᎵᏯᏃᏍ
castelldans	ᎧᏍᏖᎵᏱᏓᏂᏍ
castelldefels	ᎧᏍᏖᎵᏱᏕᏪᎵᏍ
castellote	ᎧᏍᏖᎵᏲᏖ
castells	ᎧᏍᏖᎵᏱᏍ
castelltallat	ᎧᏍᏖᎵᏱᏔᎵᏯᏘ
castellvell	ᎧᏍᏖᎵᏱᏪᎵᏱ
castelseras	ᎧᏍᏖᎵᏎᎳᏍ
castelvispal	ᎧᏍᏖᎵᏫᏍᏆᎵ
castielfabib	ᎧᏍᏘᏰᎵᏩᏫᏫ
castildelgado	ᎧᏍᏘᎵᏕᎵᎦᏙ
castiliscar	ᎧᏍᏘᎵᏍᎧᎵ
castilla	ᎧᏍᏘᎵᏯ
castillejar	ᎧᏍᏘᎵᏰᎭᎵ
castilmimbre	ᎧᏍᏘᎵᎻᎻᏈᎴ
castilnuevo	ᎧᏍᏘᎵᏂᏪᏬ
castralvo	ᎧᏍᏘᎳᎵᏬ
castril	ᎧᏍᏘᎵᎵ
castrillon	ᎧᏍᏘᎵᎵᏲᏂ
castrocalion	ᎧᏍᏘᎶᎧᎵᏲᏂ
castrocontrigo	ᎧᏍᏘᎶᎪᏂᏘᎵᎪ
castrodeza	ᎧᏍᏘᎶᏕᏌ
castrogeriz	ᎧᏍᏘᎶᎮᎵᏍ
castrogonzalo	ᎧᏍᏘᎶᎪᏂᏌᎶ
castromocho	ᎧᏍᏘᎶᎼᏠ
castromonte	ᎧᏍᏘᎶᎼᏂᏖ
castromudarra	ᎧᏍᏘᎶᎽᏓᎳ
castronuevo	ᎧᏍᏘᎶᏂᏪᏬ
castronuño	ᎧᏍᏘᎶᏄᏃ
castropodame	ᎧᏍᏘᎶᏉᏓᎺ
castropol	ᎧᏍᏘᎶᏉᎵ
castuera	ᎧᏍᏘᏪᎳ
catadau	ᎧᏔᏓᎤ
catarroja	ᎧᏔᎶᎭ
cati	ᎧᏘ
catllal	ᎧᏘᎵᏯᎵ
catoira	ᎧᏙᎢᎳ
catoute	ᎧᏙᎤᏖ
catral	ᎧᏘᎳᎵ
caude	ᎧᎤᏕ
caudete	ᎧᎤᏕᏖ
caudiel	ᎧᎤᏗᏰᎵ
caurel	ᎧᎤᎴᎵ
cavezon	ᎧᏪᏐᏂ
cayon	ᎧᏲᏂ
cazalegas	ᎧᏌᎴᎦᏍ
cea	ᏎᎠ
ceadea	ᏎᎠᏕᎠ
ceanuri	ᏎᎠᏄᎵ
cebanico	ᏎᏩᏂᎪ
cebolla	ᏎᏬᎵᏯ
cebollar	ᏎᏬᎵᏯᎵ
cebollera	ᏎᏬᎵᏰᎳ
cebreros	ᏎᏫᎴᎶᏍ
cebron	ᏎᏫᎶᏂ
ceclavin	ᏎᎩᎳᏫᏂ
cecos	ᏎᎪᏍ
cedeira	ᏎᏕᎢᎳ
cedillo	ᏎᏗᎵᏲ
cedrillas	ᏎᏗᎵᎵᏯᏍ
cee	ᏎᎡ
cehegin	ᏎᎡᎯᏂ
ceinos	ᏎᎢᏃᏍ
cejo	ᏎᎰ
celadas	ᏎᎳᏓᏍ
celanova	ᏎᎳᏃᏩ
cella	ᏎᎵᏯ
celtiberia	ᏎᎵᏘᏪᎵᏯ
cenia	ᏎᏂᏯ
cenicero	ᏎᏂᏎᎶ
cenicientos	ᏎᏂᏍᏰᏂᏙᏍ
cenizate	ᏎᏂᏌᏖ
cenlle	ᏎᏂᎵᏰ
centellas	ᏎᏂᏖᎵᏯᏍ
centenillo	ᏎᏂᏖᏂᎵᏲ
centro	ᏎᏂᏘᎶ
cepeda	ᏎᏇᏓ
cerceda	ᏎᎵᏎᏓ
cercedilla	ᏎᎵᏎᏗᎵᏯ
cerda	ᏎᎵᏓ
cerdedo	ᏎᎵᏕᏙ
cerdido	ᏎᎵᏗᏙ
cerezo	ᏎᎴᏐ
cernegula	ᏎᎵᏁᎫᎳ
cerollera	ᏎᎶᎵᏰᎳ
cerralbo	ᏎᎳᎵᏬ
cervera	ᏎᎵᏪᎳ
cespedossa	ᏎᏍᏇᏙᏌ
cestona	ᏎᏍᏙᎾ
cesuras	ᏎᏑᎳᏍ
cetina	ᏎᏘᎾ
ceuti	ᏎᎤᏘ
chamartin	ᏝᎹᎵᏘᏂ
chamberi	ᏝᎻᏇᎵ
chantada	ᏝᏂᏔᏓ
chapineria	ᏝᏈᏁᎵᏯ
charches	ᏝᎵᏞᏍ
chauchina	ᏝᎤᏟᎾ
chavaler	ᏝᏩᎴᎵ
checa	ᏞᎧ
cheles	ᏞᎴᏍ
chella	ᏞᎵᏯ
chelva	ᏞᎵᏩ
chera	ᏞᎳ
chercos	ᏞᎵᎪᏍ
chert	ᏞᎵᏘ
cherta	ᏞᎵᏔ
cheste	ᏞᏍᏖ
chiclana	ᏟᎩᎳᎾ
chilches	ᏟᎵᏞᏍ
chilizarrias	ᏟᎵᏌᎵᏯᏍ
chillon	ᏟᎵᏲᏂ
chiloeches	ᏟᎶᎡᏞᏍ
chimerraes	ᏟᎺᎳᎡᏍ
chinchon	ᏟᏂᏠᏂ
chío	ᏟᎣ
chipiona	ᏟᏈᏲᎾ
chiprana	ᏟᏈᎳᎾ
chirivel	ᏟᎵᏪᎵ
chiva	ᏟᏩ
chodos	ᏠᏙᏍ
chovar	ᏠᏩᎵ
chueca	ᏟᏪᎧ
chulilla	ᏡᎵᎵᏯ
chullo	ᏡᎵᏲ
ciadoncha	ᏍᏯᏙᏂᏝ
cibea	ᏏᏪᎠ
cidad	ᏏᏓᏗ
cidones	ᏏᏙᏁᏍ
ciempozuelos	ᏍᏰᎻᏉᏍᏪᎶᏍ
cieza	ᏍᏰᏌ
cifuentes	ᏏᏫᏪᏂᏖᏍ
cigales	ᏏᎦᎴᏍ
cigüenza	ᏏᏇᏂᏌ
cillamayor	ᏏᎵᏯᎹᏲᎵ
cillas	ᏏᎵᏯᏍ
cilleros	ᏏᎵᏰᎶᏍ
cimballa	ᏏᎻᏆᎵᏯ
cinctorres	ᏏᏂᎩᏙᎴᏍ
cintruenigo	ᏏᏂᏘᎵᏪᏂᎪ
cional	ᏍᏲᎾᎵ
ciordia	ᏍᏲᎵᏗᏯ
ciperez	ᏏᏇᎴᏍ
cirat	ᏏᎳᏘ
cirauqui	ᏏᎳᎤᎩ
ciria	ᏏᎵᏯ
ciriza	ᏏᎵᏌ
ciruelos	ᏏᎵᏪᎶᏍ
cirugeda	ᏏᎷᎮᏓ
cisla	ᏏᏍᎳ
cisneros	ᏏᏍᏁᎶᏍ
cistierna	ᏏᏍᏘᏰᎵᎾ
ciudadela	ᏍᏳᏓᏕᎳ
ciutadilla	ᏍᏳᏔᏗᎵᏯ
clariana	ᎩᎳᎵᏯᎾ
coaña	ᎪᎠᎾ
cobatillas	ᎪᏩᏘᎵᏯᏍ
cobdar	ᎪᏫᏓᎵ
cobeta	ᎪᏪᏔ
cobreros	ᎪᏫᎴᎶᏍ
coca	ᎪᎧ
cocentaina	ᎪᏎᏂᏔᎢᎾ
codeseda	ᎪᏕᏎᏓ
codos	ᎪᏙᏍ
cofete	ᎪᏪᏖ
cogollos	ᎪᎪᎵᏲᏍ
cogolludo	ᎪᎪᎵᏳᏙ
coín	ᎪᎢᏂ
coiros	ᎪᎢᎶᏍ
coles	ᎪᎴᏍ
colgadizos	ᎪᎵᎦᏗᏐᏍ
colindres	ᎪᎵᏂᏗᎴᏍ
collados	ᎪᎵᏯᏙᏍ
collanzo	ᎪᎵᏯᏂᏐ
colliga	ᎪᎵᏱᎦ
colmenar	ᎪᎵᎺᎾᎵ
colmenarejo	ᎪᎵᎺᎾᎴᎰ
colomera	ᎪᎶᎺᎳ
colunga	ᎪᎷᏂᎦ
comares	ᎪᎹᎴᏍ
combarros	ᎪᎻᏆᎶᏍ
comillas	ᎪᎻᎵᏯᏍ
competa	ᎪᎻᏇᏔ
compostela	ᎪᎻᏉᏍᏖᎳ
concud	ᎪᏂᎫᏗ
conil	ᎪᏂᎵ
conjo	ᎪᏂᎰ
conques	ᎪᏂᎨᏍ
conquista	ᎪᏂᎩᏍᏔ
consuegra	ᎪᏂᏍᏪᎩᎳ
contes	ᎪᏂᏖᏍ
copons	ᎪᏉᏂᏍ
corbaton	ᎪᎵᏩᏙᏂ
corbelle	ᎪᎵᏪᎵᏰ
corbera	ᎪᎵᏪᎳ
corchuela	ᎪᎵᏟᏪᎳ
corconte	ᎪᎵᎪᏂᏖ
corcubion	ᎪᎵᎫᏫᏲᏂ
cordoba	ᎪᎵᏙᏩ
cordova	ᎪᎵᏙᏩ
cordovin	ᎪᎵᏙᏫᏂ
corella	ᎪᎴᎵᏯ
coreses	ᎪᎴᏎᏍ
corgo	ᎪᎵᎪ
coria	ᎪᎵᏯ
coripe	ᎪᎵᏇ
coristanco	ᎪᎵᏍᏔᏂᎪ
corme	ᎪᎵᎺ
cornago	ᎪᎵᎾᎪ
corpa	ᎪᎵᏆ
corralejo	ᎪᎳᎴᎰ
corrales	ᎪᎳᎴᏍ
corredoiras	ᎪᎴᏙᎢᎳᏍ
corrubedo	ᎪᎷᏪᏙ
cortegada	ᎪᎵᏖᎦᏓ
cortegana	ᎪᎵᏖᎦᎾ
cortelazor	ᎪᎵᏖᎳᏐᎵ
cortes	ᎪᎵᏖᏍ
corullon	ᎪᎷᎵᏲᏂ
corvera	ᎪᎵᏪᎳ
cosa	ᎪᏌ
coscurita	ᎪᏍᎫᎵᏔ
coslada	ᎪᏍᎳᏓ
cospeito	ᎪᏍᏇᎢᏙ
costitx	ᎪᏍᏘᏟ
cosvenda	ᎪᏍᏪᏂᏓ
cotiella	ᎪᏘᏰᎵᏯ
cotillas	ᎪᏘᎵᏯᏍ
cotillo	ᎪᏘᎵᏲ
cotobad	ᎪᏙᏩᏗ
cousa	ᎪᎤᏌ
covadonga	ᎪᏩᏙᏂᎦ
covarrubias	ᎪᏩᎷᏫᏯᏍ
covas	ᎪᏩᏍ
covelo	ᎪᏪᎶ
cox	ᎪᎩᏍ
cozar	ᎪᏌᎵ
creciente	ᎩᎴᏍᏰᏂᏖ
cremenes	ᎩᎴᎺᏁᏍ
crespos	ᎩᎴᏍᏉᏍ
cretas	ᎩᎴᏔᏍ
crevillente	ᎩᎴᏫᎵᏰᏂᏖ
cripan	ᎩᎵᏆᏂ
cristobal	ᎩᎵᏍᏙᏩᎵ
cruce	ᎩᎷᏎ
cuadros	ᏆᏗᎶᏍ
cualedro	ᏆᎴᏗᎶ
cuatretonda	ᏆᏘᎴᏙᏂᏓ
cubells	ᎫᏪᎵᏱᏍ
cubla	ᎫᏫᎳ
cucutas	ᎫᎫᏔᏍ
cudillero	ᎫᏗᎵᏰᎶ
cuellar	ᏇᎵᏯᎵ
cuenca	ᏇᏂᎧ
culla	ᎫᎵᏯ
cullera	ᎫᎵᏰᎳ
culleredo	ᎫᎵᏰᎴᏙ
cuntis	ᎫᏂᏘᏍ
curueña	ᎫᎵᏪᎾ
daimiel	ᏓᎢᎻᏰᎵ
dalias	ᏓᎵᏯᏍ
dancharinea	ᏓᏂᏝᎵᏁᎠ
darnius	ᏓᎵᏂᏳᏍ
daroca	ᏓᎶᎧ
darrical	ᏓᎵᎧᎵ
darro	ᏓᎶ
degaña	ᏕᎦᎾ
deifontes	ᏕᎢᏬᏂᏖᏍ
deleitosa	ᏕᎴᎢᏙᏌ
delicias	ᏕᎵᏍᏯᏍ
denia	ᏕᏂᏯ
destriana	ᏕᏍᏘᎵᏯᎾ
deusto	ᏕᎤᏍᏙ
deva	ᏕᏩ
deya	ᏕᏯ
deza	ᏕᏌ
dicastillo	ᏗᎧᏍᏘᎵᏲ
diezma	ᏗᏰᏍᎹ
dilar	ᏗᎳᎵ
dima	ᏗᎹ
diustes	ᏗᏳᏍᏖᏍ
dobro	ᏙᏫᎶ
dodro	ᏙᏗᎶ
dolar	ᏙᎳᎵ
dolores	ᏙᎶᎴᏍ
domeno	ᏙᎺᏃ
domingo	ᏙᎻᏂᎪ
donado	ᏙᎾᏙ
dosbarrios	ᏙᏍᏩᎵᏲᏍ
dozon	ᏙᏐᏂ
driebes	ᏗᎵᏰᏪᏍ
dueñas	ᏗᏪᎾᏍ
dumbria	ᏚᎻᏈᎵᏯ
durango	ᏚᎳᏂᎪ
duraton	ᏚᎳᏙᏂ
durcal	ᏚᎵᎧᎵ
ea	ᎡᎠ
echalar	ᎡᏝᎳᎵ
echalecu	ᎡᏝᎴᎫ
echano	ᎡᏝᏃ
echarri	ᎡᏝᎵ
ecija	ᎡᏏᎭ
egues	ᎡᎨᏍ
eibar	ᎡᎢᏩᎵ
ejulve	ᎡᎱᎵᏪ
elanchove	ᎡᎳᏂᏠᏪ
elche	ᎡᎵᏞ
elda	ᎡᎵᏓ
elgoibar	ᎡᎵᎪᎢᏩᎵ
elizondo	ᎡᎵᏐᏂᏙ
eljas	ᎡᎵᎭᏍ
elorrio	ᎡᎶᎵᏲ
embid	ᎡᎻᏈᏗ
embun	ᎡᎻᏊᏂ
empanadas	ᎡᎻᏆᎾᏓᏍ
encinas	ᎡᏂᏏᎾᏍ
encinasola	ᎡᏂᏏᎾᏐᎳ
encinedo	ᎡᏂᏏᏁᏙ
encinillas	ᎡᏂᏏᏂᎵᏯᏍ
enciso	ᎡᏂᏏᏐ
endrinal	ᎡᏂᏗᎵᎾᎵ
enfesta	ᎡᏂᏪᏍᏔ
enguera	ᎡᏂᎨᎳ
enguidanos	ᎡᏂᎩᏓᏃᏍ
enix	ᎡᏂᎩᏍ
entrena	ᎡᏂᏘᎴᎾ
entrimo	ᎡᏂᏘᎵᎼ
enveija	ᎡᏂᏇᎢᎭ
epila	ᎡᏈᎳ
erice	ᎡᎵᏎ
erillas	ᎡᎵᎵᏯᏍ
eriste	ᎡᎵᏍᏖ
erla	ᎡᎵᎳ
ermua	ᎡᎵᎻᏩ
errazu	ᎡᎳᏑ
erro	ᎡᎶ
erustes	ᎡᎷᏍᏖᏍ
escairon	ᎡᏍᎧᎢᎶᏂ
escalada	ᎡᏍᎧᎳᏓ
escalante	ᎡᏍᎧᎳᏂᏖ
escalo	ᎡᏍᎧᎶ
escalona	ᎡᏍᎧᎶᎾ
escalonilla	ᎡᏍᎧᎶᏂᎵᏯ
escamilla	ᎡᏍᎧᎻᎵᏯ
escanuela	ᎡᏍᎧᏂᏪᎳ
escarroz	ᎡᏍᎧᎶᏍ
escatron	ᎡᏍᎧᏘᎶᏂ
esclavitud	ᎡᏍᎩᎳᏫᏚᏗ
escombreas	ᎡᏍᎪᎻᏈᎴᎠᏍ
escorca	ᎡᏍᎪᎵᎧ
escoriaza	ᎡᏍᎪᎵᏯᏌ
escorihuela	ᎡᏍᎪᎵᏪᎳ
escriche	ᎡᏍᎩᎵᏞ
escucha	ᎡᏍᎫᏝ
escullar	ᎡᏍᎫᎵᏯᎵ
escurial	ᎡᏍᎫᎵᏯᎵ
escusa	ᎡᏍᎫᏌ
escuzar	ᎡᏍᎫᏌᎵ
esfiliana	ᎡᏍᏫᎵᏯᎾ
esgos	ᎡᏍᎪᏍ
espadan	ᎡᏍᏆᏓᏂ
espadaña	ᎡᏍᏆᏓᎾ
espadañedo	ᎡᏍᏆᏓᏁᏙ
espadilla	ᎡᏍᏆᏗᎵᏯ
esparragalejo	ᎡᏍᏆᎳᎦᎴᎰ
esparraguera	ᎡᏍᏆᎳᎨᎳ
espasante	ᎡᏍᏆᏌᏂᏖ
espeja	ᎡᏍᏇᎭ
espejo	ᎡᏍᏇᎰ
espeluy	ᎡᏍᏇᎷᎢ
espera	ᎡᏍᏇᎳ
espes	ᎡᏍᏇᏍ
espiel	ᎡᏍᏈᏰᎵ
espigüete	ᎡᏍᏈᏇᏖ
espin	ᎡᏍᏈᏂ
espina	ᎡᏍᏈᎾ
espinama	ᎡᏍᏈᎾᎹ
espinilla	ᎡᏍᏈᏂᎵᏯ
espirdo	ᎡᏍᏈᎵᏙ
esplegares	ᎡᏍᏈᎴᎦᎴᏍ
esplugas	ᎡᏍᏈᎷᎦᏍ
esplus	ᎡᏍᏈᎷᏍ
espolla	ᎡᏍᏉᎵᏯ
espot	ᎡᏍᏉᏘ
esquivias	ᎡᏍᎩᏫᏯᏍ
establiments	ᎡᏍᏔᏫᎵᎺᏂᏘᏍ
estadilla	ᎡᏍᏔᏗᎵᏯ
estallo	ᎡᏍᏔᎵᏲ
estanyol	ᎡᏍᏔᏂᏲᎵ
esteban	ᎡᏍᏖᏩᏂ
estella	ᎡᏍᏖᎵᏯ
estena	ᎡᏍᏖᎾ
estepa	ᎡᏍᏖᏆ
estepar	ᎡᏍᏖᏆᎵ
estepona	ᎡᏍᏖᏉᎾ
estivella	ᎡᏍᏘᏪᎵᏯ
estopiñan	ᎡᏍᏙᏈᎾᏂ
estremera	ᎡᏍᏘᎴᎺᎳ
etreros	ᎡᏘᎴᎶᏍ
eulate	ᎡᎤᎳᏖ
extremadura	ᎡᏍᏘᎴᎹᏚᎳ
ezcaray	ᎡᏍᎧᎳᎢ
ezcurra	ᎡᏍᎫᎳ
fabara	ᏩᏩᎳ
fabero	ᏩᏪᎶ
facinas	ᏩᏏᎾᏍ
falces	ᏩᎵᏎᏍ
falconera	ᏩᎵᎪᏁᎳ
falset	ᏩᎵᏎᏘ
famorca	ᏩᎼᎵᎧ
fañanas	ᏩᎾᎾᏍ
fanlo	ᏩᏂᎶ
farajan	ᏩᎳᎭᏂ
farasdues	ᏩᎳᏍᏗᏪᏍ
farena	ᏩᎴᎾ
fariza	ᏩᎵᏌ
fatarella	ᏩᏔᎴᎵᏯ
faura	ᏩᎤᎳ
favareta	ᏩᏩᎴᏔ
fayon	ᏩᏲᏂ
febro	ᏪᏫᎶ
felanitx	ᏪᎳᏂᏟ
felechosa	ᏪᎴᏠᏌ
felix	ᏪᎵᎩᏍ
fene	ᏪᏁ
feria	ᏪᎵᏯ
fermoselle	ᏪᎵᎼᏎᎵᏰ
fernancaballero	ᏪᎵᎾᏂᎧᏩᎵᏰᎶ
ferreira	ᏪᎴᎢᎳ
ferrerias	ᏪᎴᎵᏯᏍ
ferreruela	ᏪᎴᎵᏪᎳ
figols	ᏫᎪᎵᏍ
figueras	ᏫᎨᎳᏍ
figueroles	ᏫᎨᎶᎴᏍ
figuerosa	ᏫᎨᎶᏌ
finana	ᏫᎾᎾ
finestrat	ᏫᏁᏍᏘᎳᏘ
finisterre	ᏫᏂᏍᏖᎴ
fiscal	ᏫᏍᎧᎵ
fitero	ᏫᏖᎶ
flassa	ᏫᎳᏌ
flix	ᏫᎵᎩᏍ
fondon	ᏬᏂᏙᏂ
fonelas	ᏬᏁᎳᏍ
fonfria	ᏬᏂᏫᎵᏯ
fonollosa	ᏬᏃᎵᏲᏌ
fonsagrada	ᏬᏂᏌᎩᎳᏓ
fontanar	ᏬᏂᏔᎾᎵ
fontanarejo	ᏬᏂᏔᎾᎴᎰ
fontanosas	ᏬᏂᏔᏃᏌᏍ
fontao	ᏬᏂᏔᎣ
fontellas	ᏬᏂᏖᎵᏯᏍ
fontioso	ᏬᏂᏘᏲᏐ
fontiveros	ᏬᏂᏘᏪᎶᏍ
fontllonga	ᏬᏂᏘᎵᏲᏂᎦ
fonz	ᏬᏂᏍ
forcarey	ᏬᎵᎧᎴᎢ
foronda	ᏬᎶᏂᏓ
forua	ᏬᎵᏩ
foz	ᏬᏍ
frades	ᏫᎳᏕᏍ
fraga	ᏫᎳᎦ
frailes	ᏫᎳᎢᎴᏍ
francos	ᏫᎳᏂᎪᏍ
frechilla	ᏫᎴᏟᎵᏯ
fredes	ᏫᎴᏕᏍ
freginals	ᏫᎴᎯᎾᎵᏍ
freila	ᏫᎴᎢᎳ
fresnedilla	ᏫᎴᏍᏁᏗᎵᏯ
fresnedo	ᏫᎴᏍᏁᏙ
frias	ᏫᎵᏯᏍ
frigiliana	ᏫᎵᎯᎵᏯᎾ
friol	ᏫᎵᏲᎵ
fromista	ᏫᎶᎻᏍᏔ
frumales	ᏫᎷᎹᎴᏍ
fuencaliente	ᏫᏪᏂᎧᎵᏰᏂᏖ
fuencarral	ᏫᏪᏂᎧᎳᎵ
fuencemillan	ᏫᏪᏂᏎᎻᎵᏯᏂ
fuendejalon	ᏫᏪᏂᏕᎭᎶᏂ
fuendetodos	ᏫᏪᏂᏕᏙᏙᏍ
fuenferrada	ᏫᏪᏂᏪᎳᏓ
fuengirola	ᏫᏪᏂᎯᎶᎳ
fuenlabrada	ᏫᏪᏂᎳᏫᎳᏓ
fuenllana	ᏫᏪᏂᎵᏯᎾ
fuenmayor	ᏫᏪᏂᎹᏲᎵ
fuensalida	ᏫᏪᏂᏌᎵᏓ
fuensanta	ᏫᏪᏂᏌᏂᏔ
fuentealbilla	ᏫᏪᏂᏖᎠᎵᏫᎵᏯ
fuenteboa	ᏫᏪᏂᏖᏬᎠ
fuentecen	ᏫᏪᏂᏖᏎᏂ
fuenteguinaldo	ᏫᏪᏂᏖᎩᎾᎵᏙ
fuenteheridos	ᏫᏪᏂᏖᎡᎵᏙᏍ
fuentelapeña	ᏫᏪᏂᏖᎳᏇᎾ
fuentelcesped	ᏫᏪᏂᏖᎵᏎᏍᏇᏗ
fuentelmonje	ᏫᏪᏂᏖᎵᎼᏂᎮ
fuentelsaz	ᏫᏪᏂᏖᎵᏌᏍ
fuentemilanos	ᏫᏪᏂᏖᎻᎳᏃᏍ
fuentenovilla	ᏫᏪᏂᏖᏃᏫᎵᏯ
fuentepelayo	ᏫᏪᏂᏖᏇᎳᏲ
fuentepinilla	ᏫᏪᏂᏖᏈᏂᎵᏯ
fuenterrabia	ᏫᏪᏂᏖᎳᏫᏯ
fuenterrebollo	ᏫᏪᏂᏖᎴᏬᎵᏲ
fuenterrobles	ᏫᏪᏂᏖᎶᏫᎴᏍ
fuentes	ᏫᏪᏂᏖᏍ
fuentesaúco	ᏫᏪᏂᏖᏌᎤᎪ
fuentescusa	ᏫᏪᏂᏖᏍᎫᏌ
fuentesecas	ᏫᏪᏂᏖᏎᎧᏍ
fuentespalda	ᏫᏪᏂᏖᏍᏆᎵᏓ
fuentespina	ᏫᏪᏂᏖᏍᏈᎾ
fuentidueña	ᏫᏪᏂᏘᏗᏪᎾ
funes	ᏭᏁᏍ
furnas	ᏭᎵᎾᏍ
fustiñana	ᏭᏍᏘᎾᎾ
gabaldon	ᎦᏩᎵᏙᏂ
gabarret	ᎦᏩᎴᏘ
gabasa	ᎦᏩᏌ
gador	ᎦᏙᎵ
gajanejos	ᎦᎭᏁᎰᏍ
gajates	ᎦᎭᏖᏍ
galapagar	ᎦᎳᏆᎦᎵ
galapagos	ᎦᎳᏆᎪᏍ
galar	ᎦᎳᎵ
galaroza	ᎦᎳᎶᏌ
galbarra	ᎦᎵᏩᎳ
galdacano	ᎦᎵᏓᎧᏃ
galdames	ᎦᎵᏓᎺᏍ
galende	ᎦᎴᏂᏕ
galera	ᎦᎴᎳ
galicia	ᎦᎵᏍᏯ
galinduste	ᎦᎵᏂᏚᏍᏖ
galisteo	ᎦᎵᏍᏖᎣ
gallegos	ᎦᎵᏰᎪᏍ
gallinal	ᎦᎵᏱᎾᎵ
gallur	ᎦᎵᏳᎵ
galvez	ᎦᎵᏪᏍ
gamonal	ᎦᎼᎾᎵ
ganame	ᎦᎾᎺ
gandesa	ᎦᏂᏕᏌ
gandia	ᎦᏂᏗᏯ
ganuelas	ᎦᏂᏪᎳᏍ
garaballa	ᎦᎳᏩᎵᏯ
garayoa	ᎦᎳᏲᎠ
garcillan	ᎦᎵᏏᎵᏯᏂ
gargaligas	ᎦᎵᎦᎵᎦᏍ
gargallo	ᎦᎵᎦᎵᏲ
gargüera	ᎦᎵᏇᎳ
garinoain	ᎦᎵᏃᎠᎢᏂ
garoiez	ᎦᎶᏰᏍ
garraf	ᎦᎳᏫ
garralda	ᎦᎳᎵᏓ
garray	ᎦᎳᎢ
garrigas	ᎦᎵᎦᏍ
garrovillas	ᎦᎶᏫᎵᏯᏍ
garrucha	ᎦᎷᏝ
gascueña	ᎦᏍᏇᎾ
gata	ᎦᏔ
gatova	ᎦᏙᏩ
gaucin	ᎦᎤᏏᏂ
gauna	ᎦᎤᎾ
gava	ᎦᏩ
gavanes	ᎦᏩᏁᏍ
gelida	ᎮᎵᏓ
gelsa	ᎮᎵᏌ
gelves	ᎮᎵᏪᏍ
genalguacil	ᎮᎾᎵᏆᏏᎵ
genave	ᎮᎾᏪ
genevilla	ᎮᏁᏫᎵᏯ
gerena	ᎮᎴᎾ
germade	ᎮᎵᎹᏕ
gerona	ᎮᎶᎾ
gerri	ᎮᎵ
gesera	ᎮᏎᎳ
geve	ᎮᏪ
gibarroyo	ᎯᏩᎶᏲ
gijon	ᎯᎰᏂ
gilena	ᎯᎴᎾ
gimenells	ᎯᎺᏁᎵᏱᏍ
gironella	ᎯᎶᏁᎵᏯ
godall	ᎪᏓᎵᏱ
godelleta	ᎪᏕᎵᏰᏔ
goiriz	ᎪᎢᎵᏍ
goizueta	ᎪᎢᏍᏪᏔ
golada	ᎪᎳᏓ
golpejas	ᎪᎵᏇᎭᏍ
gomara	ᎪᎹᎳ
gomecello	ᎪᎺᏎᎵᏲ
gomesende	ᎪᎺᏎᏂᏕ
gondomar	ᎪᏂᏙᎹᎵ
gor	ᎪᎵ
gorafe	ᎪᎳᏪ
gormaz	ᎪᎵᎹᏍ
gotarrendura	ᎪᏔᎴᏂᏚᎳ
gozon	ᎪᏐᏂ
gradefes	ᎩᎳᏕᏪᏍ
grado	ᎩᎳᏙ
grajera	ᎩᎳᎮᎳ
granada	ᎩᎳᎾᏓ
granadella	ᎩᎳᎾᏕᎵᏯ
granadilla	ᎩᎳᎾᏗᎵᏯ
granatula	ᎩᎳᎾᏚᎳ
grandes	ᎩᎳᏂᏕᏍ
grañén	ᎩᎳᏁᏂ
granollers	ᎩᎳᏃᎵᏰᎵᏍ
graus	ᎩᎳᎤᏍ
gravalos	ᎩᎳᏩᎶᏍ
grazalema	ᎩᎳᏌᎴᎹ
griegos	ᎩᎵᏰᎪᏍ
griñón	ᎩᎵᏃᏂ
grisen	ᎩᎵᏎᏂ
grove	ᎩᎶᏪ
guadahortuna	ᏆᏓᎣᎵᏚᎾ
guadajoz	ᏆᏓᎰᏍ
guadalajara	ᏆᏓᎳᎭᎳ
guadalaviar	ᏆᏓᎳᏫᏯᎵ
guadalcanal	ᏆᏓᎵᎧᎾᎵ
guadalcazar	ᏆᏓᎵᎧᏌᎵ
guadalupe	ᏆᏓᎷᏇ
guadamur	ᏆᏓᎽᎵ
guadarrama	ᏆᏓᎳᎹ
guadarranque	ᏆᏓᎳᏂᎨ
guadasuar	ᏆᏓᏍᏩᎵ
guadix	ᏆᏗᎩᏍ
gualchos	ᏆᎵᏠᏍ
gualta	ᏆᎵᏔ
guardiola	ᏆᎵᏗᏲᎳ
guardo	ᏆᎵᏙ
guareña	ᏆᎴᎾ
guaro	ᏆᎶ
guarroman	ᏆᎶᎹᏂ
gudar	ᎫᏓᎵ
guecho	ᎨᏠ
güeñes	ᏇᏁᏍ
güesa	ᏇᏌ
guetaria	ᎨᏔᎵᏯ
guiana	ᎩᏯᎾ
guijo	ᎩᎰ
guijuelo	ᎩᎯᏪᎶ
guillarey	ᎩᎵᏯᎴᎢ
guillena	ᎩᎵᏰᎾ
guillerias	ᎩᎵᏰᎵᏯᏍ
guimaray	ᎩᎹᎳᎢ
guimera	ᎩᎺᎳ
guisona	ᎩᏐᎾ
guitiriz	ᎩᏘᎵᏍ
gulina	ᎫᎵᎾ
guntin	ᎫᏂᏘᏂ
guriezo	ᎫᎵᏰᏐ
gurp	ᎫᎵᏈ
hacinas	ᎠᏏᎾᏍ
haro	ᎠᎶ
hecho	ᎡᏠ
helechal	ᎡᎴᏝᎵ
helechosa	ᎡᎴᏠᏌ
hellin	ᎡᎵᏱᏂ
henarejos	ᎡᎾᎴᎰᏍ
henche	ᎡᏂᏞ
herbes	ᎡᎵᏪᏍ
herencia	ᎡᎴᏂᏍᏯ
hernani	ᎡᎵᎾᏂ
hernansancho	ᎡᎵᎾᏂᏌᏂᏠ
herramelluri	ᎡᎳᎺᎵᏳᎵ
herrera	ᎡᎴᎳ
herreria	ᎡᎴᎵᏯ
herrerias	ᎡᎴᎵᏯᏍ
herreros	ᎡᎴᎶᏍ
herreruela	ᎡᎴᎵᏪᎳ
hervas	ᎡᎵᏩᏍ
higa	ᎢᎦ
higuera	ᎢᎨᎳ
higueruela	ᎢᎨᎵᏪᎳ
higueruelas	ᎢᎨᎵᏪᎳᏍ
hijar	ᎢᎭᎵ
hinodejo	ᎢᏃᏕᎰ
hinojal	ᎢᏃᎭᎵ
hinojales	ᎢᏃᎭᎴᏍ
hinojares	ᎢᏃᎭᎴᏍ
hinojos	ᎢᏃᎰᏍ
hinojosa	ᎢᏃᎰᏌ
hinojosas	ᎢᏃᎰᏌᏍ
holguera	ᎣᎵᎨᎳ
hombrados	ᎣᎻᏈᎳᏙᏍ
honrubia	ᎣᏂᎷᏫᏯ
hontalbilla	ᎣᏂᏔᎵᏫᎵᏯ
hontanares	ᎣᏂᏔᎾᎴᏍ
hontanaya	ᎣᏂᏔᎾᏯ
hontecillos	ᎣᏂᏖᏏᎵᏲᏍ
hontoba	ᎣᏂᏙᏩ
horche	ᎣᎵᏞ
hornos	ᎣᎵᏃᏍ
hospitalet	ᎣᏍᏈᏔᎴᏘ
hoyos	ᎣᏲᏍ
hoyuelos	ᎣᏱᏪᎶᏍ
huarte	ᏩᎵᏖ
huelago	ᏪᎳᎪ
huelamo	ᏪᎳᎼ
huelma	ᏪᎵᎹ
huelva	ᏪᎵᏩ
huelves	ᏪᎵᏪᏍ
hueneja	ᏪᏁᎭ
huermeces	ᏪᎵᎺᏎᏍ
huerrios	ᏪᎵᏲᏍ
huertahernando	ᏪᎵᏔᎡᎵᎾᏂᏙ
huerteles	ᏪᎵᏖᎴᏍ
huerto	ᏪᎵᏙ
huesa	ᏪᏌ
huesca	ᏪᏍᎧ
huescar	ᏪᏍᎧᎵ
huete	ᏪᏖ
humanes	ᎤᎹᏁᏍ
humilladero	ᎤᎻᎵᏯᏕᎶ
husillos	ᎤᏏᎵᏲᏍ
ibahernando	ᎢᏩᎡᎵᎾᏂᏙ
ibdes	ᎢᏫᏕᏍ
ibi	ᎢᏫ
iborra	ᎢᏬᎳ
ibros	ᎢᏫᎶᏍ
idocin	ᎢᏙᏏᏂ
iglesias	ᎢᎩᎴᏍᏯᏍ
igualada	ᎢᏆᎳᏓ
igualeja	ᎢᏆᎴᎭ
igüeña	ᎢᏇᎾ
ilche	ᎢᎵᏞ
ilerda	ᎢᎴᎵᏓ
ilipa	ᎢᎵᏆ
illana	ᎢᎵᏯᎾ
illano	ᎢᎵᏯᏃ
illas	ᎢᎵᏯᏍ
illescas	ᎢᎵᏰᏍᎧᏍ
illora	ᎢᎵᏲᎳ
illueca	ᎢᎵᏱᏪᎧ
imon	ᎢᎼᏂ
incinillas	ᎢᏂᏏᏂᎵᏯᏍ
incio	ᎢᏂᏍᏲ
infantes	ᎢᏂᏩᏂᏖᏍ
infiesto	ᎢᏂᏫᏰᏍᏙ
iniesta	ᎢᏂᏰᏍᏔ
instincion	ᎢᏂᏍᏘᏂᏍᏲᏂ
irijo	ᎢᎵᎰ
irijoa	ᎢᎵᎰᎠ
irueste	ᎢᎵᏪᏍᏖ
irun	ᎢᎷᏂ
irura	ᎢᎷᎳ
irurita	ᎢᎷᎵᏔ
irurozqui	ᎢᎷᎶᏍᎩ
isaba	ᎢᏌᏩ
iscar	ᎢᏍᎧᎵ
isil	ᎢᏏᎵ
isona	ᎢᏐᎾ
isso	ᎢᏐ
istan	ᎢᏍᏔᏂ
isuerre	ᎢᏍᏪᎴ
itrabo	ᎢᏘᎳᏬ
ituero	ᎢᏘᏪᎶ
izalzu	ᎢᏌᎵᏑ
izarra	ᎢᏌᎳ
iznájar	ᎢᏍᏀᎠᎵ
iznalloz	ᎢᏍᎾᎵᏲᏍ
iznatoraf	ᎢᏍᎾᏙᎳᏫ
jabaga	ᎭᏩᎦ
jabalera	ᎭᏩᎴᎳ
jabaloyas	ᎭᏩᎶᏯᏍ
jabalquinto	ᎭᏩᎵᎩᏂᏙ
jabarriega	ᎭᏩᎵᏰᎦ
jabugo	ᎭᏭᎪ
jaca	ᎭᎧ
jadraque	ᎭᏗᎳᎨ
jaen	ᎭᎡᏂ
jalance	ᎭᎳᏂᏎ
jalon	ᎭᎶᏂ
jaraba	ᎭᎳᏩ
jaraco	ᎭᎳᎪ
jarafuel	ᎭᎳᏫᏪᎵ
jaraicejo	ᎭᎳᎢᏎᎰ
jarandilla	ᎭᎳᏂᏗᎵᏯ
jaray	ᎭᎳᎢ
jarque	ᎭᎵᎨ
jatar	ᎭᏔᎵ
jatiel	ᎭᏘᏰᎵ
jativa	ᎭᏘᏩ
jaulin	ᎭᎤᎵᏂ
jaurrieta	ᎭᎤᎵᏰᏔ
javea	ᎭᏪᎠ
jayena	ᎭᏰᎾ
jemenuño	ᎮᎺᏄᏃ
jeresa	ᎮᎴᏌ
jerica	ᎮᎵᎧ
jerte	ᎮᎵᏖ
jimena	ᎯᎺᎾ
jirueque	ᎯᎵᏪᎨ
jodar	ᎰᏓᎵ
jorairatar	ᎰᎳᎢᎳᏔᎵ
jorcas	ᎰᎵᎧᏍ
jorquera	ᎰᎵᎨᎳ
jove	ᎰᏪ
jubera	ᎱᏪᎳ
jubrique	ᎱᏫᎵᎨ
judes	ᎱᏕᏍ
judio	ᎱᏗᏲ
jumilla	ᎱᎻᎵᏯ
juncajo	ᎱᏂᎧᎰ
juncosa	ᎱᏂᎪᏌ
juneda	ᎱᏁᏓ
labacolla	ᎳᏩᎪᎵᏯ
labajos	ᎳᏩᎰᏍ
laborcillas	ᎳᏬᎵᏏᎵᏯᏍ
lacalahorra	ᎳᎧᎳᎣᎳ
lachar	ᎳᏝᎵ
lacumbre	ᎳᎫᎻᏈᎴ
lage	ᎳᎮ
laguarres	ᎳᏆᎴᏍ
laguarta	ᎳᏆᎵᏔ
lagunaseca	ᎳᎫᎾᏎᎧ
lagunilla	ᎳᎫᏂᎵᏯ
lalin	ᎳᎵᏂ
lama	ᎳᎹ
lanaja	ᎳᏀᎠ
lancara	ᎳᏂᎧᎳ
lanciego	ᎳᏂᏍᏰᎪ
landete	ᎳᏂᏕᏖ
lanestosa	ᎳᏁᏍᏙᏌ
langreo	ᎳᏂᎩᎴᎣ
languilla	ᎳᏂᎩᎵᏯ
lanjaron	ᎳᏂᎭᎶᏂ
lantadilla	ᎳᏂᏔᏗᎵᏯ
lanteira	ᎳᏂᏖᎢᎳ
lanz	ᎳᏂᏍ
lanza	ᎳᏂᏌ
lapeza	ᎳᏇᏌ
lardero	ᎳᎵᏕᎶ
laredo	ᎳᎴᏙ
laroco	ᎳᎶᎪ
laroles	ᎳᎶᎴᏍ
larrainzar	ᎳᎳᎢᏂᏌᎵ
larraona	ᎳᎳᎣᎾ
larrion	ᎳᎵᏲᏂ
lasarte	ᎳᏌᎵᏖ
latina	ᎳᏘᎾ
latre	ᎳᏘᎴ
lavadores	ᎳᏩᏙᎴᏍ
lavapiés	ᎳᏩᏈᏰᏍ
layana	ᎳᏯᎾ
layna	ᎳᎢᎾ
layos	ᎳᏲᏍ
laza	ᎳᏌ
leache	ᎴᎠᏞ
lebrija	ᎴᏫᎵᎭ
lecera	ᎴᏎᎳ
leciñena	ᎴᏏᏁᎾ
lecumberri	ᎴᎫᎻᏇᎵ
ledaña	ᎴᏓᎾ
ledanca	ᎴᏓᏂᎧ
ledesma	ᎴᏕᏍᎹ
leganés	ᎴᎦᏁᏍ
leganiel	ᎴᎦᏂᏰᎵ
leiro	ᎴᎢᎶ
leitariegos	ᎴᎢᏔᎵᏰᎪᏍ
leiza	ᎴᎢᏌ
lemona	ᎴᎼᎾ
lences	ᎴᏂᏎᏍ
lepe	ᎴᏇ
lequeitio	ᎴᎨᎢᏘᏲ
lerga	ᎴᎵᎦ
lerida	ᎴᎵᏓ
lerin	ᎴᎵᏂ
lerma	ᎴᎵᎹ
les	ᎴᏍ
lesaca	ᎴᏌᎧ
letur	ᎴᏚᎵ
letux	ᎴᏚᎩᏍ
leza	ᎴᏌ
lezama	ᎴᏌᎹ
lezuza	ᎴᏑᏌ
librilla	ᎵᏫᎵᎵᏯ
libros	ᎵᏫᎶᏍ
lidon	ᎵᏙᏂ
liédena	ᎵᏰᏕᎾ
lietor	ᎵᏰᏙᎵ
lijar	ᎵᎭᎵ
lillol	ᎵᎵᏲᎵ
limpias	ᎵᎻᏈᏯᏍ
linares	ᎵᎾᎴᏍ
liñola	ᎵᏃᎳ
liria	ᎵᎵᏯ
lizarraga	ᎵᏌᎳᎦ
llado	ᎵᏯᏙ
llafranc	ᎵᏯᏫᎳᏂᎩ
llagostera	ᎵᏯᎪᏍᏖᎳ
llanes	ᎵᏯᏁᏍ
llansa	ᎵᏯᏂᏌ
llauri	ᎵᏯᎤᎵ
llera	ᎵᏰᎳ
llerena	ᎵᏰᎴᎾ
llers	ᎵᏰᎵᏍ
lles	ᎵᏰᏍ
llivia	ᎵᏱᏫᏯ
llobregales	ᎵᏲᏫᎴᎦᎴᏍ
llodio	ᎵᏲᏗᏲ
llombay	ᎵᏲᎻᏆᎢ
lloseta	ᎵᏲᏎᏔ
llovera	ᎵᏲᏪᎳ
llubi	ᎵᏳᏫ
lluchmayor	ᎵᏳᏟᎹᏲᎵ
loarre	ᎶᎠᎴ
lobatejo	ᎶᏩᏖᎰ
lobera	ᎶᏪᎳ
lobon	ᎶᏬᏂ
lodosa	ᎶᏙᏌ
loeches	ᎶᎡᏞᏍ
logroño	ᎶᎩᎶᏃ
logrosan	ᎶᎩᎶᏌᏂ
loja	ᎶᎭ
lombrana	ᎶᎻᏈᎳᎾ
longares	ᎶᏂᎦᎴᏍ
lopera	ᎶᏇᎳ
lorca	ᎶᎵᎧ
lorcha	ᎶᎵᏝ
lorenzana	ᎶᎴᏂᏌᎾ
lores	ᎶᎴᏍ
lorqui	ᎶᎵᎩ
losacino	ᎶᏌᏏᏃ
lousame	ᎶᎤᏌᎺ
lovios	ᎶᏫᏲᏍ
lozoya	ᎶᏐᏯ
lozoyuela	ᎶᏐᏱᏪᎳ
luanco	ᎵᏩᏂᎪ
luarca	ᎵᏩᎵᎧ
lubian	ᎷᏫᏯᏂ
lubrin	ᎷᏫᎵᏂ
lucar	ᎷᎧᎵ
lucena	ᎷᏎᎾ
luceni	ᎷᏎᏂ
lucillo	ᎷᏏᎵᏲ
ludiente	ᎷᏗᏰᏂᏖ
luelmo	ᎵᏪᎵᎼ
luesia	ᎵᏪᏍᏯ
luezas	ᎵᏪᏌᏍ
lugan	ᎷᎦᏂ
lugo	ᎷᎪ
lugones	ᎷᎪᏁᏍ
lugros	ᎷᎩᎶᏍ
lujar	ᎷᎭᎵ
lumbier	ᎷᎻᏈᏰᎵ
lumbrales	ᎷᎻᏈᎳᎴᏍ
lumbreras	ᎷᎻᏈᎴᎳᏍ
lumpiaque	ᎷᎻᏈᏯᎨ
luna	ᎷᎾ
luque	ᎷᎨ
luyego	ᎷᏰᎪ
luzaga	ᎷᏌᎦ
luzon	ᎷᏐᏂ
macael	ᎹᎧᎡᎵ
maceda	ᎹᏎᏓ
machero	ᎹᏞᎶ
macotera	ᎹᎪᏖᎳ
maderuelo	ᎹᏕᎵᏪᎶ
madridejos	ᎹᏗᎵᏕᎰᏍ
madrigalejo	ᎹᏗᎵᎦᎴᎰ
madriguera	ᎹᏗᎵᎨᎳ
madrigueras	ᎹᏗᎵᎨᎳᏍ
madrona	ᎹᏗᎶᎾ
madronera	ᎹᏗᎶᏁᎳ
madroño	ᎹᏗᎶᏃ
maella	ᎹᎡᎵᏯ
maello	ᎹᎡᎵᏲ
maestre	ᎹᎡᏍᏘᎴ
maestu	ᎹᎡᏍᏚ
magacela	ᎹᎦᏎᎳ
magallon	ᎹᎦᎵᏲᏂ
magaña	ᎹᎦᎾ
magaz	ᎹᎦᏍ
magina	ᎹᎯᎾ
maguilla	ᎹᎩᎵᏯ
mahide	ᎹᎢᏕ
mahon	ᎹᎣᏂ
mahora	ᎹᎣᎳ
mainar	ᎹᎢᎾᎵ
majadas	ᎹᎭᏓᏍ
majaelrayo	ᎹᎭᎡᎵᎳᏲ
mala	ᎹᎳ
malagon	ᎹᎳᎪᏂ
malaguilla	ᎹᎳᎩᎵᏯ
malanquilla	ᎹᎳᏂᎩᎵᏯ
malcocinado	ᎹᎵᎪᏏᎾᏙ
malgrat	ᎹᎵᎩᎳᏘ
mallen	ᎹᎵᏰᏂ
malon	ᎹᎶᏂ
malpica	ᎹᎵᏈᎧ
maluenda	ᎹᎵᏪᏂᏓ
mampodre	ᎹᎻᏉᏗᎴ
manacor	ᎹᎾᎪᎵ
manchita	ᎹᏂᏟᏔ
mandayona	ᎹᏂᏓᏲᎾ
mañeru	ᎹᏁᎷ
manilva	ᎹᏂᎵᏩ
manises	ᎹᏂᏎᏍ
manlleu	ᎹᏂᎵᏰᎤ
manresa	ᎹᏂᎴᏌ
manresana	ᎹᏂᎴᏌᎾ
mansilla	ᎹᏂᏏᎵᏯ
mantañes	ᎹᏂᏔᏁᏍ
mantiel	ᎹᏂᏘᏰᎵ
manzanares	ᎹᏂᏌᎾᎴᏍ
manzaneda	ᎹᏂᏌᏁᏓ
manzanedo	ᎹᏂᏌᏁᏙ
manzaneque	ᎹᏂᏌᏁᎨ
manzanera	ᎹᏂᏌᏁᎳ
maqueda	ᎹᎨᏓ
maracena	ᎹᎳᏎᎾ
maranchon	ᎹᎳᏂᏠᏂ
marazoleja	ᎹᎳᏐᎴᎭ
marbella	ᎹᎵᏪᎵᏯ
marcilla	ᎹᎵᏏᎵᏯ
marganell	ᎹᎵᎦᏁᎵᏱ
mariana	ᎹᎵᏯᎾ
marin	ᎹᎵᏂ
marinaleda	ᎹᎵᎾᎴᏓ
marines	ᎹᎵᏁᏍ
marmolejo	ᎹᎵᎼᎴᎰ
marron	ᎹᎶᏂ
marrube	ᎹᎷᏪ
marrupe	ᎹᎷᏇ
martorell	ᎹᎵᏙᎴᎵᏱ
martos	ᎹᎵᏙᏍ
marugan	ᎹᎷᎦᏂ
masa	ᎹᏌ
masalaves	ᎹᏌᎳᏪᏍ
masamagrell	ᎹᏌᎹᎩᎴᎵᏱ
masanasa	ᎹᏌᎾᏌ
mascaraque	ᎹᏍᎧᎳᎨ
masegoso	ᎹᏎᎪᏐ
maside	ᎹᏏᏕ
masquefa	ᎹᏍᎨᏩ
massanas	ᎹᏌᎾᏍ
matabuena	ᎹᏔᏫᏪᎾ
matagalls	ᎹᏔᎦᎵᏱᏍ
matalebreras	ᎹᏔᎴᏫᎴᎳᏍ
matallana	ᎹᏔᎵᏯᎾ
matamorosa	ᎹᏔᎼᎶᏌ
matanza	ᎹᏔᏂᏌ
matapozuelos	ᎹᏔᏉᏍᏪᎶᏍ
mataro	ᎹᏔᎶ
matarrubia	ᎹᏔᎷᏫᏯ
matedeon	ᎹᏖᏕᎣᏂ
matienzo	ᎹᏘᏰᏂᏐ
matute	ᎹᏚᏖ
mausoleo	ᎹᎤᏐᎴᎣ
mayalde	ᎹᏯᎵᏕ
mayals	ᎹᏯᎵᏍ
mayorga	ᎹᏲᎵᎦ
mazarete	ᎹᏌᎴᏖ
mazaricos	ᎹᏌᎵᎪᏍ
mazarron	ᎹᏌᎶᏂ
mazarulleque	ᎹᏌᎷᎵᏰᎨ
mazateron	ᎹᏌᏖᎶᏂ
mazuecos	ᎹᏍᏪᎪᏍ
meano	ᎺᎠᏃ
meco	ᎺᎪ
mediana	ᎺᏗᏯᎾ
medina	ᎺᏗᎾ
mediña	ᎺᏗᎾ
medinaceli	ᎺᏗᎾᏎᎵ
mediodia	ᎺᏗᏲᏗᏯ
mediona	ᎺᏗᏲᎾ
meijaboy	ᎺᎢᎭᏬᎢ
meira	ᎺᎢᎳ
meis	ᎺᎢᏍ
mejorada	ᎺᎰᎳᏓ
meliana	ᎺᎵᏯᎾ
melida	ᎺᎵᏓ
mellid	ᎺᎵᏱᏗ
melon	ᎺᎶᏂ
membrilla	ᎺᎻᏈᎵᎵᏯ
membrillar	ᎺᎻᏈᎵᎵᏯᎵ
membrillera	ᎺᎻᏈᎵᎵᏰᎳ
membrio	ᎺᎻᏈᎵᏲ
menasalbas	ᎺᎾᏌᎵᏩᏍ
mencal	ᎺᏂᎧᎵ
mendavia	ᎺᏂᏓᏫᏯ
mendigorria	ᎺᏂᏗᎪᎵᏯ
meneses	ᎺᏁᏎᏍ
mengabril	ᎺᏂᎦᏫᎵᎵ
mengibar	ᎺᏂᎯᏩᎵ
mentrida	ᎺᏂᏘᎵᏓ
mequinenza	ᎺᎩᏁᏂᏌ
mera	ᎺᎳ
merida	ᎺᎵᏓ
mesia	ᎺᏍᏯ
mesones	ᎺᏐᏁᏍ
mestanza	ᎺᏍᏔᏂᏌ
miajadas	ᎻᏯᎭᏓᏍ
miedes	ᎻᏰᏕᏍ
mieras	ᎻᏰᎳᏍ
mieres	ᎻᏰᎴᏍ
mieza	ᎻᏰᏌ
miguelturra	ᎻᎨᎵᏚᎳ
mijares	ᎻᎭᎴᏍ
mijas	ᎻᎭᏍ
milagro	ᎻᎳᎩᎶ
millana	ᎻᎵᏯᎾ
millares	ᎻᎵᏯᎴᏍ
millena	ᎻᎵᏰᎾ
minana	ᎻᎾᎾ
minateda	ᎻᎾᏖᏓ
minaya	ᎻᎾᏯ
minglanilla	ᎻᏂᎩᎳᏂᎵᏯ
mingorria	ᎻᏂᎪᎵᏯ
miño	ᎻᏃ
mira	ᎻᎳ
mirabel	ᎻᎳᏪᎵ
mirambel	ᎻᎳᎻᏇᎵ
mirandilla	ᎻᎳᏂᏗᎵᏯ
miravalles	ᎻᎳᏩᎵᏰᏍ
miravet	ᎻᎳᏪᏘ
miravete	ᎻᎳᏪᏖ
moaña	ᎼᎠᎾ
mocejon	ᎼᏎᎰᏂ
mochales	ᎼᏝᎴᏍ
moclin	ᎼᎩᎵᏂ
moeche	ᎼᎡᏞ
mofrecho	ᎼᏫᎴᏠ
mogente	ᎼᎮᏂᏖ
mogon	ᎼᎪᏂ
moguer	ᎼᎨᎵ
mohedas	ᎼᎡᏓᏍ
mohorte	ᎼᎣᎵᏖ
mojacar	ᎼᎭᎧᎵ
mojados	ᎼᎭᏙᏍ
mojina	ᎼᎯᎾ
mola	ᎼᎳ
molaton	ᎼᎳᏙᏂ
molinaseca	ᎼᎵᎾᏎᎧ
molinicos	ᎼᎵᏂᎪᏍ
molinos	ᎼᎵᏃᏍ
molledo	ᎼᎵᏰᏙ
mollerusa	ᎼᎵᏰᎷᏌ
mollet	ᎼᎵᏰᏘ
mollina	ᎼᎵᏱᎾ
mollo	ᎼᎵᏲ
moluengo	ᎼᎵᏪᏂᎪ
molvizar	ᎼᎵᏫᏌᎵ
mombeltran	ᎼᎻᏇᎵᏘᎳᏂ
mombuey	ᎼᎻᏈᏪᎢ
monachil	ᎼᎾᏟᎵ
monbeltran	ᎼᏂᏇᎵᏘᎳᏂ
moncada	ᎼᏂᎧᏓ
moncalvo	ᎼᏂᎧᎵᏬ
moncayo	ᎼᏂᎧᏲ
moncloa	ᎼᏂᎩᎶᎠ
moncofar	ᎼᏂᎪᏩᎵ
monda	ᎼᏂᏓ
mondariz	ᎼᏂᏓᎵᏍ
mondejar	ᎼᏂᏕᎭᎵ
mondoñedo	ᎼᏂᏙᏁᏙ
mondragon	ᎼᏂᏗᎳᎪᏂ
monduber	ᎼᏂᏚᏪᎵ
monegrillo	ᎼᏁᎩᎵᎵᏲ
monesterio	ᎼᏁᏍᏖᎵᏲ
moneva	ᎼᏁᏩ
monfero	ᎼᏂᏪᎶ
monflorite	ᎼᏂᏫᎶᎵᏖ
mongo	ᎼᏂᎪ
monistrol	ᎼᏂᏍᏘᎶᎵ
monleras	ᎼᏂᎴᎳᏍ
monovar	ᎼᏃᏩᎵ
monreal	ᎼᏂᎴᎠᎵ
monroy	ᎼᏂᎶᎢ
monroyo	ᎼᏂᎶᏲ
monsagro	ᎼᏂᏌᎩᎶ
monserrat	ᎼᏂᏎᎳᏘ
montalban	ᎼᏂᏔᎵᏩᏂ
montalbanejo	ᎼᏂᏔᎵᏩᏁᎰ
montalbo	ᎼᏂᏔᎵᏬ
montalbos	ᎼᏂᏔᎵᏬᏍ
montalvos	ᎼᏂᏔᎵᏬᏍ
montan	ᎼᏂᏔᏂ
montanchez	ᎼᏂᏔᏂᏞᏍ
montanyola	ᎼᏂᏔᏂᏲᎳ
montarto	ᎼᏂᏔᎵᏙ
monteagudo	ᎼᏂᏖᎠᎫᏙ
montearagon	ᎼᏂᏖᎠᎳᎪᏂ
montederramo	ᎼᏂᏖᏕᎳᎼ
montefrio	ᎼᏂᏖᏫᎵᏲ
montejaque	ᎼᏂᏖᎭᎨ
montejicar	ᎼᏂᏖᎯᎧᎵ
montellano	ᎼᏂᏖᎵᏯᏃ
montemolin	ᎼᏂᏖᎼᎵᏂ
monterrey	ᎼᏂᏖᎴᎢ
monterroso	ᎼᏂᏖᎶᏐ
monterrubio	ᎼᏂᏖᎷᏫᏲ
montesa	ᎼᏂᏖᏌ
montesclaros	ᎼᏂᏖᏍᎩᎳᎶᏍ
montiel	ᎼᏂᏘᏰᎵ
montijo	ᎼᏂᏘᎰ
montilla	ᎼᏂᏘᎵᏯ
montillana	ᎼᏂᏘᎵᏯᎾ
montizon	ᎼᏂᏘᏐᏂ
montmelo	ᎼᏂᏘᎺᎶ
monton	ᎼᏂᏙᏂ
montoro	ᎼᏂᏙᎶ
montras	ᎼᏂᏘᎳᏍ
montroy	ᎼᏂᏘᎶᎢ
montuenga	ᎼᏂᏘᏪᏂᎦ
montuiri	ᎼᏂᏘᏫᎵ
monturque	ᎼᏂᏚᎵᎨ
monzon	ᎼᏂᏐᏂ
mora	ᎼᎳ
moral	ᎼᎳᎵ
moraleja	ᎼᎳᎴᎭ
morales	ᎼᎳᎴᏍ
moralina	ᎼᎳᎵᎾ
moraña	ᎼᎳᎾ
morante	ᎼᎳᏂᏖ
moratalla	ᎼᎳᏔᎵᏯ
morcillo	ᎼᎵᏏᎵᏲ
moreda	ᎼᎴᏓ
morell	ᎼᎴᎵᏱ
morella	ᎼᎴᎵᏯ
morentin	ᎼᎴᏂᏘᏂ
mores	ᎼᎴᏍ
morey	ᎼᎴᎢ
moriles	ᎼᎵᎴᏍ
morillejo	ᎼᎵᎵᏰᎰ
morla	ᎼᎵᎳ
moros	ᎼᎶᏍ
mos	ᎼᏍ
mosqueruela	ᎼᏍᎨᎵᏪᎳ
mostoles	ᎼᏍᏙᎴᏍ
motilla	ᎼᏘᎵᏯ
motilleja	ᎼᏘᎵᏰᎭ
motos	ᎼᏙᏍ
motril	ᎼᏘᎵᎵ
moya	ᎼᏯ
moyuela	ᎼᏱᏪᎳ
mozoncillo	ᎼᏐᏂᏏᎵᏲ
muchamiel	ᎽᏝᎻᏰᎵ
mucientes	ᎽᏍᏰᏂᏖᏍ
muel	ᎻᏪᎵ
mugaire	ᎽᎦᎢᎴ
mugardos	ᎽᎦᎵᏙᏍ
mugia	ᎽᎯᏯ
mugica	ᎽᎯᎧ
muiños	ᎻᏫᏃᏍ
mula	ᎽᎳ
muñana	ᎽᎾᎾ
munebrega	ᎽᏁᏫᎴᎦ
munera	ᎽᏁᎳ
mungia	ᎽᏂᎯᏯ
munico	ᎽᏂᎪ
muniesa	ᎽᏂᏰᏌ
munilla	ᎽᏂᎵᏯ
muñogalindo	ᎽᏃᎦᎵᏂᏙ
muñogrande	ᎽᏃᎩᎳᏂᏕ
muntadas	ᎽᏂᏔᏓᏍ
muras	ᎽᎳᏍ
murchante	ᎽᎵᏝᏂᏖ
murcia	ᎽᎵᏍᏯ
murguia	ᎽᎵᎩᏯ
muriel	ᎽᎵᏰᎵ
muro	ᎽᎶ
muros	ᎽᎶᏍ
murtas	ᎽᎵᏔᏍ
murueta	ᎽᎵᏪᏔ
nacimiento	ᎾᏏᎻᏰᏂᏙ
nagore	ᎾᎪᎴ
naharros	ᎾᎠᎶᏍ
najera	ᏀᎡᎳ
nambroca	ᎾᎻᏈᎶᎧ
naquera	ᎾᎨᎳ
narboneta	ᎾᎵᏬᏁᏔ
naron	ᎾᎶᏂ
nava	ᎾᏩ
navacerrada	ᎾᏩᏎᎳᏓ
navachica	ᎾᏩᏟᎧ
navaconcejo	ᎾᏩᎪᏂᏎᎰ
navafria	ᎾᏩᏫᎵᏯ
navahermosa	ᎾᏩᎡᎵᎼᏌ
navahondilla	ᎾᏩᎣᏂᏗᎵᏯ
navajas	ᎾᏩᎭᏍ
naval	ᎾᏩᎵ
navalacruz	ᎾᏩᎳᎩᎷᏍ
navalagamella	ᎾᏩᎳᎦᎺᎵᏯ
navalcaballo	ᎾᏩᎵᎧᏩᎵᏲ
navalcan	ᎾᏩᎵᎧᏂ
navaleno	ᎾᏩᎴᏃ
navalguijo	ᎾᏩᎵᎩᎰ
navalilla	ᎾᏩᎵᎵᏯ
navalmanzano	ᎾᏩᎵᎹᏂᏌᏃ
navalmoral	ᎾᏩᎵᎼᎳᎵ
navalmoralejo	ᎾᏩᎵᎼᎳᎴᎰ
navalonguilla	ᎾᏩᎶᏂᎩᎵᏯ
navalosa	ᎾᏩᎶᏌ
navalpino	ᎾᏩᎵᏈᏃ
navalsauz	ᎾᏩᎵᏌᎤᏍ
navaluenga	ᎾᏩᎵᏪᏂᎦ
navardun	ᎾᏩᎵᏚᏂ
navarres	ᎾᏩᎴᏍ
navarrete	ᎾᏩᎴᏖ
navas	ᎾᏩᏍ
navasa	ᎾᏩᏌ
navascues	ᎾᏩᏍᏇᏍ
navasfrias	ᎾᏩᏍᏫᎵᏯᏍ
navata	ᎾᏩᏔ
navelgas	ᎾᏪᎵᎦᏍ
naves	ᎾᏪᏍ
navia	ᎾᏫᏯ
nebreda	ᏁᏫᎴᏓ
neda	ᏁᏓ
negredo	ᏁᎩᎴᏙ
negreira	ᏁᎩᎴᎢᎳ
neila	ᏁᎢᎳ
nerja	ᏁᎵᎭ
nerpio	ᏁᎵᏈᏲ
nerva	ᏁᎵᏩ
nestar	ᏁᏍᏔᎵ
niebla	ᏂᏰᏫᎳ
nieves	ᏂᏰᏪᏍ
nigran	ᏂᎩᎳᏂ
niguelas	ᏂᎨᎳᏍ
nijar	ᏂᎭᎵ
noain	ᏃᎠᎢᏂ
noalejo	ᏃᎠᎴᎰ
noblejas	ᏃᏫᎴᎭᏍ
noceda	ᏃᏎᏓ
noez	ᏃᎡᏍ
nofuentes	ᏃᏫᏪᏂᏖᏍ
nogales	ᏃᎦᎴᏍ
nograles	ᏃᎩᎳᎴᏍ
noguera	ᏃᎨᎳ
nogueruelas	ᏃᎨᎵᏪᎳᏍ
nois	ᏃᎢᏍ
nolay	ᏃᎳᎢ
nombela	ᏃᎻᏇᎳ
nonaspe	ᏃᎾᏍᏇ
noreña	ᏃᎴᎾ
novales	ᏃᏩᎴᏍ
novallas	ᏃᏩᎵᏯᏍ
novelda	ᏃᏪᎵᏓ
noves	ᏃᏪᏍ
novillas	ᏃᏫᎵᏯᏍ
noya	ᏃᏯ
nueno	ᏂᏪᏃ
nueva	ᏂᏪᏩ
nules	ᏄᎴᏍ
nulles	ᏄᎵᏰᏍ
numancia	ᏄᎹᏂᏍᏯ
nuñomoral	ᏄᏃᎼᎳᎵ
obon	ᎣᏬᏂ
ocaña	ᎣᎧᎾ
ocejon	ᎣᏎᎰᏂ
ocentejo	ᎣᏎᏂᏖᎰ
ochagavia	ᎣᏝᎦᏫᏯ
ochandiano	ᎣᏝᏂᏗᏯᏃ
oden	ᎣᏕᏂ
odon	ᎣᏙᏂ
ohanes	ᎣᎠᏁᏍ
oímbra	ᎣᎢᎻᏈᎳ
ojen	ᎣᎮᏂ
ojos	ᎣᎰᏍ
olalla	ᎣᎳᎵᏯ
olave	ᎣᎳᏪ
olazagutia	ᎣᎳᏌᎫᏘᏯ
olba	ᎣᎵᏩ
oleiros	ᎣᎴᎢᎶᏍ
oliana	ᎣᎵᏯᎾ
olias	ᎣᎵᏯᏍ
oliete	ᎣᎵᏰᏖ
oliola	ᎣᎵᏲᎳ
olite	ᎣᎵᏖ
oliva	ᎣᎵᏩ
olivares	ᎣᎵᏩᎴᏍ
olivella	ᎣᎵᏪᎵᏯ
olivenza	ᎣᎵᏪᏂᏌ
olleria	ᎣᎵᏰᎵᏯ
ollo	ᎣᎵᏲ
olmedillas	ᎣᎵᎺᏗᎵᏯᏍ
olmedo	ᎣᎵᎺᏙ
olmillos	ᎣᎵᎻᎵᏲᏍ
olocau	ᎣᎶᎧᎤ
olombrada	ᎣᎶᎻᏈᎳᏓ
olost	ᎣᎶᏍᏘ
olot	ᎣᎶᏘ
olvan	ᎣᎵᏩᏂ
olvega	ᎣᎵᏪᎦ
olvena	ᎣᎵᏪᎾ
olvera	ᎣᎵᏪᎳ
olza	ᎣᎵᏌ
oña	ᎣᎾ
oñate	ᎣᎾᏖ
oncala	ᎣᏂᎧᎳ
onda	ᎣᏂᏓ
ondara	ᎣᏂᏓᎳ
ondarroa	ᎣᏂᏓᎶᎠ
onis	ᎣᏂᏍ
ontaneda	ᎣᏂᏔᏁᏓ
onteniente	ᎣᏂᏖᏂᏰᏂᏖ
ontur	ᎣᏂᏚᎵ
onzonilla	ᎣᏂᏐᏂᎵᏯ
oquillas	ᎣᎩᎵᏯᏍ
orbara	ᎣᎵᏩᎳ
orce	ᎣᎵᏎ
orcera	ᎣᎵᏎᎳ
orcheta	ᎣᎵᏞᏔ
orduña	ᎣᎵᏚᎾ
orea	ᎣᎴᎠ
orejo	ᎣᎴᎰ
orense	ᎣᎴᏂᏎ
ores	ᎣᎴᏍ
orgaña	ᎣᎵᎦᎾ
orgaz	ᎣᎵᎦᏍ
orgiva	ᎣᎵᎯᏩ
oria	ᎣᎵᏯ
orihuela	ᎣᎵᏪᎳ
orio	ᎣᎵᏲ
oris	ᎣᎵᏍ
orista	ᎣᎵᏍᏔ
orle	ᎣᎵᎴ
orol	ᎣᎶᎵ
oropesa	ᎣᎶᏇᏌ
oroso	ᎣᎶᏐ
orozco	ᎣᎶᏍᎪ
orrios	ᎣᎵᏲᏍ
orrius	ᎣᎵᏳᏍ
orusco	ᎣᎷᏍᎪ
osera	ᎣᏎᎳ
osor	ᎣᏐᎵ
osorno	ᎣᏐᎵᏃ
ostiz	ᎣᏍᏘᏍ
osuna	ᎣᏑᎾ
oteiza	ᎣᏖᎢᏌ
oteo	ᎣᏖᎣ
otero	ᎣᏖᎶ
otivar	ᎣᏘᏩᎵ
otura	ᎣᏚᎳ
oural	ᎣᎤᎳᎵ
outes	ᎣᎤᏖᏍ
ouviaño	ᎣᎤᏫᏯᏃ
ovejo	ᎣᏪᎰ
oviedo	ᎣᏫᏰᏙ
oya	ᎣᏯ
oyarzun	ᎣᏯᎵᏑᏂ
oyon	ᎣᏲᏂ
ozaeta	ᎣᏌᎡᏔ
padron	ᏆᏗᎶᏂ
padul	ᏆᏚᎵ
paguera	ᏆᎨᎳ
pajares	ᏆᎭᎴᏍ
pajaron	ᏆᎭᎶᏂ
pajaroncillo	ᏆᎭᎶᏂᏏᎵᏲ
palafrugell	ᏆᎳᏫᎷᎮᎵᏱ
palamos	ᏆᎳᎼᏍ
palancas	ᏆᎳᏂᎧᏍ
palanques	ᏆᎳᏂᎨᏍ
palanquinos	ᏆᎳᏂᎩᏃᏍ
palencia	ᏆᎴᏂᏍᏯ
palenciana	ᏆᎴᏂᏍᏯᎾ
palentino	ᏆᎴᏂᏘᏃ
palenzuela	ᏆᎴᏂᏍᏪᎳ
pallares	ᏆᎵᏯᎴᏍ
pallars	ᏆᎵᏯᎵᏍ
palleja	ᏆᎵᏰᎭ
pallerols	ᏆᎵᏰᎶᎵᏍ
palma	ᏆᎵᎹ
palo	ᏆᎶ
palomas	ᏆᎶᎹᏍ
palomeque	ᏆᎶᎺᎨ
palomera	ᏆᎶᎺᎳ
pals	ᏆᎵᏍ
pampliega	ᏆᎻᏈᎵᏰᎦ
pamplona	ᏆᎻᏈᎶᎾ
pancorbo	ᏆᏂᎪᎵᏬ
pancrudo	ᏆᏂᎩᎷᏙ
panes	ᏆᏁᏍ
paniza	ᏆᏂᏌ
panticosa	ᏆᏂᏘᎪᏌ
pantoja	ᏆᏂᏙᎭ
panton	ᏆᏂᏙᏂ
paones	ᏆᎣᏁᏍ
papeles	ᏆᏇᎴᏍ
paracuellos	ᏆᎳᏇᎵᏲᏍ
paradas	ᏆᎳᏓᏍ
paradaseca	ᏆᎳᏓᏎᎧ
paradela	ᏆᎳᏕᎳ
paramo	ᏆᎳᎼ
parauta	ᏆᎳᎤᏔ
parcent	ᏆᎵᏎᏂᏘ
pardilla	ᏆᎵᏗᎵᏯ
paredes	ᏆᎴᏕᏍ
pareja	ᏆᎴᎭ
parets	ᏆᎴᏘᏍ
parga	ᏆᎵᎦ
parla	ᏆᎵᎳ
parlaba	ᏆᎵᎳᏩ
parres	ᏆᎴᏍ
parrillas	ᏆᎵᎵᏯᏍ
partaloa	ᏆᎵᏔᎶᎠ
parzan	ᏆᎵᏌᏂ
pasajes	ᏆᏌᎮᏍ
pasaron	ᏆᏌᎶᏂ
pastoriza	ᏆᏍᏙᎵᏌ
pastrana	ᏆᏍᏘᎳᎾ
pauls	ᏆᎤᎵᏍ
pavias	ᏆᏫᏯᏍ
paymogo	ᏆᎢᎼᎪ
pechina	ᏇᏟᎾ
pedralba	ᏇᏗᎳᎵᏩ
pedralbes	ᏇᏗᎳᎵᏪᏍ
pedreguer	ᏇᏗᎴᎨᎵ
pedrera	ᏇᏗᎴᎳ
pedroche	ᏇᏗᎶᏞ
pedrola	ᏇᏗᎶᎳ
pedroso	ᏇᏗᎶᏐ
pedrouzos	ᏇᏗᎶᎤᏐᏍ
pegalajar	ᏇᎦᎳᎭᎵ
pego	ᏇᎪ
pelahustan	ᏇᎳᎤᏍᏔᏂ
peleagonzalo	ᏇᎴᎠᎪᏂᏌᎶ
pelegrina	ᏇᎴᎩᎵᎾ
peloche	ᏇᎶᏞ
peñacerrada	ᏇᎾᏎᎳᏓ
peñafiel	ᏇᎾᏫᏰᎵ
peñaflor	ᏇᎾᏫᎶᎵ
peñagolosa	ᏇᎾᎪᎶᏌ
penagos	ᏇᎾᎪᏍ
peñalba	ᏇᎾᎵᏩ
peñalen	ᏇᎾᎴᏂ
peñarrubia	ᏇᎾᎷᏫᏯ
peñascosa	ᏇᎾᏍᎪᏌ
peñausende	ᏇᎾᎤᏎᏂᏕ
peniscola	ᏇᏂᏍᎪᎳ
pepino	ᏇᏈᏃ
peracense	ᏇᎳᏎᏂᏎ
perafita	ᏇᎳᏫᏔ
peral	ᏇᎳᎵ
peralejos	ᏇᎳᎴᎰᏍ
peralta	ᏇᎳᎵᏔ
peraltilla	ᏇᎳᎵᏘᎵᏯ
peralveche	ᏇᎳᎵᏪᏞ
peramola	ᏇᎳᎼᎳ
peranzanes	ᏇᎳᏂᏌᏁᏍ
peratallada	ᏇᎳᏔᎵᏯᏓ
perdiguera	ᏇᎵᏗᎨᎳ
perelada	ᏇᎴᎳᏓ
perello	ᏇᎴᎵᏲ
pereña	ᏇᎴᎾ
pereruela	ᏇᎴᎵᏪᎳ
periana	ᏇᎵᏯᎾ
perorrubio	ᏇᎶᎷᏫᏲ
pertusa	ᏇᎵᏚᏌ
perves	ᏇᎵᏪᏍ
pesaguero	ᏇᏌᎨᎶ
pescueza	ᏇᏍᏇᏌ
pesquera	ᏇᏍᎨᎳ
pesues	ᏇᏍᏪᏍ
petin	ᏇᏘᏂ
pias	ᏈᏯᏍ
picacho	ᏈᎧᏠ
picasent	ᏈᎧᏎᏂᏘ
picon	ᏈᎪᏂ
picorro	ᏈᎪᎶ
piedrabuena	ᏈᏰᏗᎳᏫᏪᎾ
piedrafita	ᏈᏰᏗᎳᏫᏔ
piedrahita	ᏈᏰᏗᎳᎢᏔ
piera	ᏈᏰᎳ
pilas	ᏈᎳᏍ
piloña	ᏈᎶᎾ
pina	ᏈᎾ
pinar	ᏈᎾᎵ
pinarejo	ᏈᎾᎴᎰ
pinarejos	ᏈᎾᎴᎰᏍ
pineda	ᏈᏁᏓ
pinet	ᏈᏁᏘ
pinillos	ᏈᏂᎵᏲᏍ
pinofranqueado	ᏈᏃᏫᎳᏂᎨᎠᏙ
piñor	ᏈᏃᎵ
pinos	ᏈᏃᏍ
pinoso	ᏈᏃᏐ
pintano	ᏈᏂᏔᏃ
pipaon	ᏈᏆᎣᏂ
piqueras	ᏈᎨᎳᏍ
pira	ᏈᎳ
pitillas	ᏈᏘᎵᏯᏍ
pizarra	ᏈᏌᎳ
pizarral	ᏈᏌᎳᎵ
plan	ᏈᎳᏂ
planes	ᏈᎳᏁᏍ
plasencia	ᏈᎳᏎᏂᏍᏯ
plasenzuela	ᏈᎳᏎᏂᏍᏪᎳ
plencia	ᏈᎴᏂᏍᏯ
pliego	ᏈᎵᏰᎪ
plou	ᏈᎶᎤ
pobes	ᏉᏪᏍ
poblete	ᏉᏫᎴᏖ
poboleda	ᏉᏬᎴᏓ
pol	ᏉᎵ
polanco	ᏉᎳᏂᎪ
polenino	ᏉᎴᏂᏃ
polentinos	ᏉᎴᏂᏘᏃᏍ
polientes	ᏉᎵᏰᏂᏖᏍ
pollensa	ᏉᎵᏰᏂᏌ
pollos	ᏉᎵᏲᏍ
polopos	ᏉᎶᏉᏍ
pomar	ᏉᎹᎵ
pomer	ᏉᎺᎵ
ponferrada	ᏉᏂᏪᎳᏓ
ponga	ᏉᏂᎦ
pons	ᏉᏂᏍ
pontevedra	ᏉᏂᏖᏪᏗᎳ
pontones	ᏉᏂᏙᏁᏍ
pontons	ᏉᏂᏙᏂᏍ
ponzano	ᏉᏂᏌᏃ
porcuna	ᏉᎵᎫᎾ
porquera	ᏉᎵᎨᎳ
porrera	ᏉᎴᎳ
porreras	ᏉᎴᎳᏍ
porriño	ᏉᎵᏃ
porron	ᏉᎶᏂ
portaje	ᏉᎵᏔᎮ
porto	ᏉᎵᏙ
porzuna	ᏉᎵᏑᎾ
posada	ᏉᏌᏓ
posadas	ᏉᏌᏓᏍ
posadilla	ᏉᏌᏗᎵᏯ
potes	ᏉᏖᏍ
povedilla	ᏉᏪᏗᎵᏯ
poyales	ᏉᏯᎴᏍ
poyatos	ᏉᏯᏙᏍ
poyo	ᏉᏲ
poyos	ᏉᏲᏍ
pozaldez	ᏉᏌᎵᏕᏍ
pozoantiguo	ᏉᏐᎠᏂᏘᏉ
pozohondo	ᏉᏐᎣᏂᏙ
pozondon	ᏉᏐᏂᏙᏂ
pozorrubio	ᏉᏐᎷᏫᏲ
pozoseco	ᏉᏐᏎᎪ
pozuelo	ᏉᏍᏪᎶ
pradairo	ᏈᎳᏓᎢᎶ
pradales	ᏈᎳᏓᎴᏍ
pradejon	ᏈᎳᏕᎰᏂ
pradena	ᏈᎳᏕᎾ
prades	ᏈᎳᏕᏍ
pradillo	ᏈᎳᏗᎵᏲ
prado	ᏈᎳᏙ
pradoluengo	ᏈᎳᏙᎵᏪᏂᎪ
pratdip	ᏈᎳᏘᏗᏈ
pravia	ᏈᎳᏫᏯ
preixens	ᏈᎴᎢᎩᏎᏂᏍ
prejano	ᏈᎴᎭᏃ
priego	ᏈᎵᏰᎪ
prioro	ᏈᎵᏲᎶ
proaza	ᏈᎶᎠᏌ
progalo	ᏈᎶᎦᎶ
pruna	ᏈᎷᎾ
puenteareas	ᏈᏪᏂᏖᎠᎴᎠᏍ
puentedeume	ᏈᏪᏂᏖᏕᎤᎺ
puentenansa	ᏈᏪᏂᏖᎾᏂᏌ
puenteviesgo	ᏈᏪᏂᏖᏫᏰᏍᎪ
pueyo	ᏈᏪᏲ
pujerra	ᏊᎮᎳ
pulgar	ᏊᎵᎦᎵ
pulpi	ᏊᎵᏈ
pungin	ᏊᏂᎯᏂ
purchena	ᏊᎵᏞᎾ
purujosa	ᏊᎷᎰᏌ
purullena	ᏊᎷᎵᏰᎾ
puzol	ᏊᏐᎵ
quart	ᏆᎵᏘ
quel	ᎨᎵ
quemada	ᎨᎹᏓ
quero	ᎨᎶ
quesa	ᎨᏌ
quesada	ᎨᏌᏓ
quintanapalla	ᎩᏂᏔᎾᏆᎵᏯ
quintanavides	ᎩᏂᏔᎾᏫᏕᏍ
quintanilla	ᎩᏂᏔᏂᎵᏯ
quintela	ᎩᏂᏖᎳ
quinto	ᎩᏂᏙ
quiroga	ᎩᎶᎦ
quiros	ᎩᎶᏍ
quisicedo	ᎩᏏᏎᏙ
quismondo	ᎩᏍᎼᏂᏙ
rabade	ᎳᏩᏕ
rabanales	ᎳᏩᎾᎴᏍ
rabasa	ᎳᏩᏌ
rabo	ᎳᏬ
radona	ᎳᏙᎾ
rafales	ᎳᏩᎴᏍ
ragama	ᎳᎦᎹ
ragol	ᎳᎪᎵ
rajadell	ᎳᎭᏕᎵᏱ
ramacastañas	ᎳᎹᎧᏍᏔᎾᏍ
ramallosa	ᎳᎹᎵᏲᏌ
rascafria	ᎳᏍᎧᏫᎵᏯ
rasines	ᎳᏏᏁᏍ
raso	ᎳᏐ
rasquera	ᎳᏍᎨᎳ
rasueros	ᎳᏍᏪᎶᏍ
reales	ᎴᎠᎴᏍ
rebalsadores	ᎴᏩᎵᏌᏙᎴᏍ
rebollera	ᎴᏬᎵᏰᎳ
rebollo	ᎴᏬᎵᏲ
recas	ᎴᎧᏍ
redona	ᎴᏙᎾ
redondela	ᎴᏙᏂᏕᎳ
regenjo	ᎴᎮᏂᎰ
reillo	ᎴᎢᎵᏲ
reina	ᎴᎢᎾ
reinosa	ᎴᎢᏃᏌ
relleu	ᎴᎵᏰᎤ
rellinas	ᎴᎵᏱᎾᏍ
rena	ᎴᎾ
renales	ᎴᎾᎴᏍ
renedo	ᎴᏁᏙ
renera	ᎴᏁᎳ
rengos	ᎴᏂᎪᏍ
renteria	ᎴᏂᏖᎵᏯ
reocin	ᎴᎣᏏᏂ
requejo	ᎴᎨᎰ
requena	ᎴᎨᎾ
resoba	ᎴᏐᏩ
respaldiza	ᎴᏍᏆᎵᏗᏌ
restiello	ᎴᏍᏘᏰᎵᏲ
retamal	ᎴᏔᎹᎵ
retamosa	ᎴᏔᎼᏌ
retiendas	ᎴᏘᏰᏂᏓᏍ
reus	ᎴᎤᏍ
revillarruz	ᎴᏫᎵᏯᎷᏍ
revolcadores	ᎴᏬᎵᎧᏙᎴᏍ
riahuelas	ᎵᏯᏪᎳᏍ
rialp	ᎵᏯᎵᏈ
rianjo	ᎵᏯᏂᎰ
riaño	ᎵᏯᏃ
riaza	ᎵᏯᏌ
ribadavia	ᎵᏩᏓᏫᏯ
ribadeo	ᎵᏩᏕᎣ
ribadesella	ᎵᏩᏕᏎᎵᏯ
ribadumia	ᎵᏩᏚᎻᏯ
ribaforada	ᎵᏩᏬᎳᏓ
ribafrecha	ᎵᏩᏫᎴᏝ
ribarredonda	ᎵᏩᎴᏙᏂᏓ
ribatajada	ᎵᏩᏔᎭᏓ
ribesalbes	ᎵᏪᏌᎵᏪᏍ
ribota	ᎵᏬᏔ
ricla	ᎵᎩᎳ
ricobayo	ᎵᎪᏩᏲ
ricote	ᎵᎪᏖ
riello	ᎵᏰᎵᏲ
rielves	ᎵᏰᎵᏪᏍ
riglos	ᎵᎩᎶᏍ
rigoitia	ᎵᎪᎢᏘᏯ
rilla	ᎵᎵᏯ
riner	ᎵᏁᎵ
rio	ᎵᏲ
riobarba	ᎵᏲᏩᎵᏩ
riocabado	ᎵᏲᎧᏩᏙ
riocaldo	ᎵᏲᎧᎵᏙ
riodeva	ᎵᏲᏕᏩ
riofrio	ᎵᏲᏫᎵᏲ
riogordo	ᎵᏲᎪᎵᏙ
rioja	ᎵᏲᎭ
riolobos	ᎵᏲᎶᏬᏍ
riopar	ᎵᏲᏆᎵ
rios	ᎵᏲᏍ
riosa	ᎵᏲᏌ
riotorto	ᎵᏲᏙᎵᏙ
ripoll	ᎵᏉᎵᏱ
ripollet	ᎵᏉᎵᏰᏘ
risco	ᎵᏍᎪ
riudarenas	ᎵᏳᏓᎴᎾᏍ
riudaura	ᎵᏳᏓᎤᎳ
riudecanas	ᎵᏳᏕᎧᎾᏍ
riudecols	ᎵᏳᏕᎪᎵᏍ
riudoms	ᎵᏳᏙᎻᏍ
riveira	ᎵᏪᎢᎳ
rivero	ᎵᏪᎶ
roa	ᎶᎠ
roales	ᎶᎠᎴᏍ
robleda	ᎶᏫᎴᏓ
robledo	ᎶᏫᎴᏙ
robledollano	ᎶᏫᎴᏙᎵᏯᏃ
robres	ᎶᏫᎴᏍ
rocallaura	ᎶᎧᎵᏯᎤᎳ
rociana	ᎶᏍᏯᎾ
rodana	ᎶᏓᎾ
rodeiro	ᎶᏕᎢᎶ
rodellar	ᎶᏕᎵᏯᎵ
rodenas	ᎶᏕᎾᏍ
rodiezmo	ᎶᏗᏰᏍᎼ
rodoña	ᎶᏙᎾ
rodos	ᎶᏙᏍ
rois	ᎶᎢᏍ
rojales	ᎶᎭᎴᏍ
rollan	ᎶᎵᏯᏂ
romanones	ᎶᎹᏃᏁᏍ
roncal	ᎶᏂᎧᎵ
roncesvalles	ᎶᏂᏎᏍᏩᎵᏰᏍ
ronda	ᎶᏂᏓ
roquetas	ᎶᎨᏔᏍ
rosal	ᎶᏌᎵ
rosas	ᎶᏌᏍ
rosell	ᎶᏎᎵᏱ
rota	ᎶᏔ
rotova	ᎶᏙᏩ
royuela	ᎶᏱᏪᎳ
ruanes	ᎵᏩᏁᏍ
rubena	ᎷᏪᎾ
rubi	ᎷᏫ
rubiales	ᎷᏫᏯᎴᏍ
rubian	ᎷᏫᏯᏂ
rubiana	ᎷᏫᏯᎾ
rubio	ᎷᏫᏲ
rubite	ᎷᏫᏖ
rudilla	ᎷᏗᎵᏯ
rueda	ᎵᏪᏓ
ruesta	ᎵᏪᏍᏔ
ruguilla	ᎷᎩᎵᏯ
ruidera	ᎵᏫᏕᎳ
rupia	ᎷᏈᏯ
rus	ᎷᏍ
rute	ᎷᏖ
sabadell	ᏌᏩᏕᎵᏱ
sabero	ᏌᏪᎶ
sabiñánigo	ᏌᏫᎾᏂᎪ
sabiote	ᏌᏫᏲᏖ
sacañet	ᏌᎧᏁᏘ
sacedon	ᏌᏎᏙᏂ
sacedoncillo	ᏌᏎᏙᏂᏏᎵᏲ
saceruela	ᏌᏎᎵᏪᎳ
sacramenia	ᏌᎩᎳᎺᏂᏯ
sada	ᏌᏓ
sadaba	ᏌᏓᏩ
saelices	ᏌᎡᎵᏎᏍ
sagaro	ᏌᎦᎶ
sagides	ᏌᎯᏕᏍ
sagra	ᏌᎩᎳ
sagunto	ᏌᎫᏂᏙ
sahagun	ᏌᎠᎫᏂ
salada	ᏌᎳᏓ
salamanca	ᏌᎳᎹᏂᎧ
salamon	ᏌᎳᎼᏂ
salar	ᏌᎳᎵ
salardu	ᏌᎳᎵᏚ
salas	ᏌᎳᏍ
salce	ᏌᎵᏎ
salcedo	ᏌᎵᏎᏙ
saldaña	ᏌᎵᏓᎾ
saldon	ᏌᎵᏙᏂ
salduero	ᏌᎵᏗᏪᎶ
salinas	ᏌᎵᎾᏍ
salinas	ᏌᎵᎾᏍ
sallent	ᏌᎵᏰᏂᏘ
salmeron	ᏌᎵᎺᎶᏂ
salmoral	ᏌᎵᎼᎳᎵ
salobral	ᏌᎶᏫᎳᎵ
salobre	ᏌᎶᏫᎴ
salobrena	ᏌᎶᏫᎴᎾ
salomo	ᏌᎶᎼ
salorino	ᏌᎶᎵᏃ
salou	ᏌᎶᎤ
salsadella	ᏌᎵᏌᏕᎵᏯ
salt	ᏌᎵᏘ
salvacañete	ᏌᎵᏩᎧᏁᏖ
salvatierra	ᏌᎵᏩᏘᏰᎳ
samboal	ᏌᎻᏉᎠᎵ
samos	ᏌᎼᏍ
sampedor	ᏌᎻᏇᏙᎵ
samper	ᏌᎻᏇᎵ
sanabria	ᏌᎾᏫᎵᏯ
sanahuja	ᏌᎾᎤᎭ
sancedo	ᏌᏂᏎᏙ
sanchidrian	ᏌᏂᏟᏗᎵᏯᏂ
sanchonuño	ᏌᏂᏠᏄᏃ
sandianes	ᏌᏂᏗᏯᏁᏍ
sando	ᏌᏂᏙ
sangenjo	ᏌᏂᎮᏂᎰ
sangüesa	ᏌᏂᏇᏌ
sansol	ᏌᏂᏐᎵ
santacara	ᏌᏂᏔᎧᎳ
santaella	ᏌᏂᏔᎡᎵᏯ
santany	ᏌᏂᏔᏂ
santibañez	ᏌᏂᏘᏩᏁᏍ
santillana	ᏌᏂᏘᎵᏯᎾ
santiso	ᏌᏂᏘᏐ
santiuste	ᏌᏂᏘᏳᏍᏖ
santiz	ᏌᏂᏘᏍ
santolea	ᏌᏂᏙᎴᎠ
santomera	ᏌᏂᏙᎺᎳ
santoña	ᏌᏂᏙᎾ
santovenia	ᏌᏂᏙᏪᏂᏯ
santucri	ᏌᏂᏚᎩᎵ
santurce	ᏌᏂᏚᎵᏎ
santurde	ᏌᏂᏚᎵᏕ
sanzoles	ᏌᏂᏐᎴᏍ
sapeira	ᏌᏇᎢᎳ
saragossa	ᏌᎳᎪᏌ
sariego	ᏌᎵᏰᎪ
sariñena	ᏌᎵᏁᎾ
sarratella	ᏌᎳᏖᎵᏯ
sarreal	ᏌᎴᎠᎵ
sarreaus	ᏌᎴᎠᎤᏍ
sarria	ᏌᎵᏯ
sarrion	ᏌᎵᏲᏂ
sarroca	ᏌᎶᎧ
sarvise	ᏌᎵᏫᏎ
sasamon	ᏌᏌᎼᏂ
sasdonigas	ᏌᏍᏙᏂᎦᏍ
sastago	ᏌᏍᏔᎪ
sauca	ᏌᎤᎧ
saucedilla	ᏌᎤᏎᏗᎵᏯ
saucelle	ᏌᎤᏎᎵᏰ
saviñan	ᏌᏫᎾᏂ
saviñao	ᏌᏫᎾᎣ
sax	ᏌᎩᏍ
sayaton	ᏌᏯᏙᏂ
sebulcor	ᏎᏭᎵᎪᎵ
secorun	ᏎᎪᎷᏂ
sedano	ᏎᏓᏃ
sedella	ᏎᏕᎵᏯ
segorbe	ᏎᎪᎵᏪ
segurilla	ᏎᎫᎵᎵᏯ
selaya	ᏎᎳᏯ
selgua	ᏎᎵᏆ
sella	ᏎᎵᏯ
sellano	ᏎᎵᏯᏃ
selva	ᏎᎵᏩ
semillas	ᏎᎻᎵᏯᏍ
sena	ᏎᎾ
senes	ᏎᏁᏍ
senmanat	ᏎᏂᎹᎾᏘ
senra	ᏎᏂᎳ
senterada	ᏎᏂᏖᎳᏓ
sepulveda	ᏎᏊᎵᏪᏓ
sequeros	ᏎᎨᎶᏍ
serantes	ᏎᎳᏂᏖᏍ
seriña	ᏎᎵᎾ
seron	ᏎᎶᏂ
seros	ᏎᎶᏍ
serra	ᏎᎳ
serrada	ᏎᎳᏓ
serradero	ᏎᎳᏕᎶ
serradilla	ᏎᎳᏗᎵᏯ
serranillos	ᏎᎳᏂᎵᏲᏍ
serrateix	ᏎᎳᏖᎢᎩᏍ
serrejon	ᏎᎴᎰᏂ
sesa	ᏎᏌ
seseña	ᏎᏎᎾ
sesma	ᏎᏍᎹ
sestao	ᏎᏍᏔᎣ
sestrica	ᏎᏍᏘᎵᎧ
setcases	ᏎᏘᎧᏎᏍ
setenil	ᏎᏖᏂᎵ
setiles	ᏎᏘᎴᏍ
seva	ᏎᏩ
sevilla	ᏎᏫᎵᏯ
seville	ᏎᏫᎵᏰ
sierro	ᏍᏰᎶ
sietamo	ᏍᏰᏔᎼ
sigüenza	ᏏᏇᏂᏌ
sigüés	ᏏᏇᏍ
siles	ᏏᎴᏍ
silla	ᏏᎵᏯ
silleda	ᏏᎵᏰᏓ
sils	ᏏᎵᏍ
simancas	ᏏᎹᏂᎧᏍ
sineu	ᏏᏁᎤ
sinlabajos	ᏏᏂᎳᏩᎰᏍ
sipan	ᏏᏆᏂ
siruela	ᏏᎵᏪᎳ
sisamon	ᏏᏌᎼᏂ
sisante	ᏏᏌᏂᏖ
sober	ᏐᏪᎵ
sobradillo	ᏐᏫᎳᏗᎵᏲ
sobrado	ᏐᏫᎳᏙ
sobrelapeña	ᏐᏫᎴᎳᏇᎾ
sobrescobio	ᏐᏫᎴᏍᎪᏫᏲ
socobos	ᏐᎪᏬᏍ
socuellamos	ᏐᏇᎵᏯᎼᏍ
sodupe	ᏐᏚᏇ
solares	ᏐᎳᎴᏍ
solera	ᏐᎴᎳ
solivella	ᏐᎵᏪᎵᏯ
sollana	ᏐᎵᏯᎾ
soller	ᏐᎵᏰᎵ
solosancho	ᏐᎶᏌᏂᏠ
solsona	ᏐᎵᏐᎾ
somio	ᏐᎻᏲ
somolinos	ᏐᎼᎵᏃᏍ
somontano	ᏐᎼᏂᏔᏃ
somontin	ᏐᎼᏂᏘᏂ
somosierra	ᏐᎼᏍᏰᎳ
somozas	ᏐᎼᏌᏍ
soncillo	ᏐᏂᏏᎵᏲ
sondica	ᏐᏂᏗᎧ
soneja	ᏐᏁᎭ
sopeira	ᏐᏇᎢᎳ
sorbas	ᏐᎵᏩᏍ
soria	ᏐᎵᏯ
sorihuela	ᏐᎵᏪᎳ
sorlada	ᏐᎵᎳᏓ
sorpe	ᏐᎵᏇ
sorribes	ᏐᎵᏪᏍ
sort	ᏐᎵᏘ
sorzano	ᏐᎵᏌᏃ
soses	ᏐᏎᏍ
sotes	ᏐᏖᏍ
sotiello	ᏐᏘᏰᎵᏲ
sotodosos	ᏐᏙᏙᏐᏍ
sotomayor	ᏐᏙᎹᏲᎵ
sotopalacios	ᏐᏙᏆᎳᏍᏲᏍ
sotos	ᏐᏙᏍ
sotoserrano	ᏐᏙᏎᎳᏃ
sotresgudo	ᏐᏘᎴᏍᎫᏙ
sotuelamos	ᏐᏘᏪᎳᎼᏍ
suances	ᏍᏩᏂᏎᏍ
subijana	ᏑᏫᎭᎾ
subirana	ᏑᏫᎳᎾ
sucina	ᏑᏏᎾ
sudanell	ᏑᏓᏁᎵᏱ
sueca	ᏍᏪᎧ
sumbilla	ᏑᎻᏈᎵᏯ
suria	ᏑᎵᏯ
tabara	ᏔᏩᎳ
taberno	ᏔᏪᎵᏃ
taboada	ᏔᏬᎠᏓ
taboadela	ᏔᏬᎠᏕᎳ
tabuenca	ᏔᏫᏪᏂᎧ
tafalla	ᏔᏩᎵᏯ
tahal	ᏔᎠᎵ
tahus	ᏔᎤᏍ
tal	ᏔᎵ
talamantes	ᏔᎳᎹᏂᏖᏍ
talarrubias	ᏔᎳᎷᏫᏯᏍ
talavan	ᏔᎳᏩᏂ
talayon	ᏔᎳᏲᏂ
talayuela	ᏔᎳᏱᏪᎳ
talayuelas	ᏔᎳᏱᏪᎳᏍ
talayuelo	ᏔᎳᏱᏪᎶ
taliga	ᏔᎵᎦ
talladell	ᏔᎵᏯᏕᎵᏱ
tallante	ᏔᎵᏯᏂᏖ
tamajon	ᏔᎹᎰᏂ
tamame	ᏔᎹᎺ
tamames	ᏔᎹᎺᏍ
tamariu	ᏔᎹᎵᏳ
tambre	ᏔᎻᏈᎴ
tamurejo	ᏔᎽᎴᎰ
tapioles	ᏔᏈᏲᎴᏍ
taracena	ᏔᎳᏎᎾ
taradell	ᏔᎳᏕᎵᏱ
taramundi	ᏔᎳᎽᏂᏗ
tarancon	ᏔᎳᏂᎪᏂ
taravilla	ᏔᎳᏫᎵᏯ
tarazona	ᏔᎳᏐᎾ
tarbena	ᏔᎵᏪᎾ
tardajos	ᏔᎵᏓᎰᏍ
tardelcuende	ᏔᎵᏕᎵᏇᏂᏕ
tardienta	ᏔᎵᏗᏰᏂᏔ
tarifa	ᏔᎵᏩ
tarija	ᏔᎵᎭ
tarna	ᏔᎵᎾ
tarragona	ᏔᎳᎪᎾ
tarrasa	ᏔᎳᏌ
tarrega	ᏔᎴᎦ
tarrio	ᏔᎵᏲ
tarroja	ᏔᎶᎭ
tarros	ᏔᎶᏍ
tauste	ᏔᎤᏍᏖ
tavaruela	ᏔᏩᎵᏪᎳ
tazones	ᏔᏐᏁᏍ
teba	ᏖᏩ
tebar	ᏖᏩᎵ
tejadillos	ᏖᎭᏗᎵᏲᏍ
tejares	ᏖᎭᎴᏍ
tejeiro	ᏖᎮᎢᎶ
tejera	ᏖᎮᎳ
tembleque	ᏖᎻᏈᎴᎨ
tempul	ᏖᎻᏊᎵ
tendilla	ᏖᏂᏗᎵᏯ
tenebron	ᏖᏁᏫᎶᏂ
teo	ᏖᎣ
termens	ᏖᎵᎺᏂᏍ
termino	ᏖᎵᎻᏃ
terminon	ᏖᎵᎻᏃᏂ
terradas	ᏖᎳᏓᏍ
terriente	ᏖᎵᏰᏂᏖ
terrinches	ᏖᎵᏂᏞᏍ
terroba	ᏖᎶᏩ
teruel	ᏖᎵᏪᎵ
teulada	ᏖᎤᎳᏓ
teverga	ᏖᏪᎵᎦ
tiana	ᏘᏯᎾ
tibi	ᏘᏫ
tibidabo	ᏘᏫᏓᏬ
tiebas	ᏘᏰᏩᏍ
tiedra	ᏘᏰᏗᎳ
tielve	ᏘᏰᎵᏪ
tierga	ᏘᏰᎵᎦ
tiermas	ᏘᏰᎵᎹᏍ
tierzo	ᏘᏰᎵᏐ
tiesa	ᏘᏰᏌ
tijola	ᏘᎰᎳ
tinajas	ᏘᏀᎠᏍ
tineo	ᏘᏁᎣ
tiñosillos	ᏘᏃᏏᎵᏲᏍ
tirgo	ᏘᎵᎪ
tirig	ᏘᎵᎩ
tirteafuera	ᏘᎵᏖᎠᏫᏪᎳ
titaguas	ᏘᏔᏆᏍ
tiurana	ᏘᏳᎳᎾ
tivenys	ᏘᏪᏂᏍ
tivisa	ᏘᏫᏌ
tobarra	ᏙᏩᎳ
tobia	ᏙᏫᏯ
tocina	ᏙᏏᎾ
todellego	ᏙᏕᎵᏰᎪ
todolella	ᏙᏙᎴᎵᏯ
toledo	ᏙᎴᏙ
tolocirio	ᏙᎶᏏᎵᏲ
tolosa	ᏙᎶᏌ
tolox	ᏙᎶᎩᏍ
tolva	ᏙᎵᏩ
tomelloso	ᏙᎺᎵᏲᏐ
tomiño	ᏙᎻᏃ
tona	ᏙᎾ
topares	ᏙᏆᎴᏍ
toques	ᏙᎨᏍ
tor	ᏙᎵ
tora	ᏙᎳ
toras	ᏙᎳᏍ
tordehumos	ᏙᎵᏕᎤᎼᏍ
tordera	ᏙᎵᏕᎳ
tordomar	ᏙᎵᏙᎹᎵ
tordoya	ᏙᎵᏙᏯ
torello	ᏙᎴᎵᏲ
toreno	ᏙᎴᏃ
torija	ᏙᎵᎭ
toril	ᏙᎵᎵ
torla	ᏙᎵᎳ
tormon	ᏙᎵᎼᏂ
tornavacas	ᏙᎵᎾᏩᎧᏍ
toro	ᏙᎶ
torquemada	ᏙᎵᎨᎹᏓ
torralba	ᏙᎳᎵᏩ
torreadrada	ᏙᎴᎠᏗᎳᏓ
torrebeleña	ᏙᎴᏪᎴᎾ
torrebeses	ᏙᎴᏪᏎᏍ
torrecaballeros	ᏙᎴᎧᏩᎵᏰᎶᏍ
torrecampo	ᏙᎴᎧᎻᏉ
torrecilla	ᏙᎴᏏᎵᏯ
torredembarra	ᏙᎴᏕᎻᏆᎳ
torredonjimeno	ᏙᎴᏙᏂᎯᎺᏃ
torrefarrera	ᏙᎴᏩᎴᎳ
torregrosa	ᏙᎴᎩᎶᏌ
torreiglesias	ᏙᎴᎢᎩᎴᏍᏯᏍ
torrejoncillo	ᏙᎴᎰᏂᏏᎵᏲ
torrelaguna	ᏙᎴᎳᎫᎾ
torrelapaja	ᏙᎴᎳᏆᎭ
torrelavega	ᏙᎴᎳᏪᎦ
torrellano	ᏙᎴᎵᏯᏃ
torrellas	ᏙᎴᎵᏯᏍ
torrelobaton	ᏙᎴᎶᏩᏙᏂ
torrelodones	ᏙᎴᎶᏙᏁᏍ
torremanzanas	ᏙᎴᎹᏂᏌᎾᏍ
torremayor	ᏙᎴᎹᏲᎵ
torremegia	ᏙᎴᎺᎯᏯ
torremocha	ᏙᎴᎼᏝ
torremolinos	ᏙᎴᎼᎵᏃᏍ
torremontalbo	ᏙᎴᎼᏂᏔᎵᏬ
torrente	ᏙᎴᏂᏖ
torrenueva	ᏙᎴᏂᏪᏩ
torreorgaz	ᏙᎴᎣᎵᎦᏍ
torreperogil	ᏙᎴᏇᎶᎯᎵ
torrequebradilla	ᏙᎴᎨᏫᎳᏗᎵᏯ
torrequemada	ᏙᎴᎨᎹᏓ
torres	ᏙᎴᏍ
torresandino	ᏙᎴᏌᏂᏗᏃ
torresmenudas	ᏙᎴᏍᎺᏄᏓᏍ
torrevelilla	ᏙᎴᏪᎵᎵᏯ
torrevieja	ᏙᎴᏫᏰᎭ
torrijas	ᏙᎵᎭᏍ
torrijo	ᏙᎵᎰ
torrijos	ᏙᎵᎰᏍ
torronteras	ᏙᎶᏂᏖᎳᏍ
torrox	ᏙᎶᎩᏍ
tortajada	ᏙᎵᏔᎭᏓ
tortella	ᏙᎵᏖᎵᏯ
tortola	ᏙᎵᏙᎳ
tortonda	ᏙᎵᏙᏂᏓ
tortuera	ᏙᎵᏘᏪᎳ
tortuero	ᏙᎵᏘᏪᎶ
torviscon	ᏙᎵᏫᏍᎪᏂ
torviscoso	ᏙᎵᏫᏍᎪᏐ
tosas	ᏙᏌᏍ
totana	ᏙᏔᎾ
totanes	ᏙᏔᏁᏍ
touro	ᏙᎤᎶ
tous	ᏙᎤᏍ
trabada	ᏘᎳᏩᏓ
trabadelo	ᏘᎳᏩᏕᎶ
trabanca	ᏘᎳᏩᏂᎧ
trabazos	ᏘᎳᏩᏐᏍ
tragacete	ᏘᎳᎦᏎᏖ
traiguera	ᏘᎳᎢᎨᎳ
tramacastilla	ᏘᎳᎹᎧᏍᏘᎵᏯ
trasierra	ᏘᎳᏍᏰᎳ
traslavina	ᏘᎳᏍᎳᏫᎾ
trasmiras	ᏘᎳᏍᎻᎳᏍ
trasobares	ᏘᎳᏐᏩᎴᏍ
traspinedo	ᏘᎳᏍᏈᏁᏙ
trazo	ᏘᎳᏐ
trebujena	ᏘᎴᏭᎮᎾ
tredos	ᏘᎴᏙᏍ
tremp	ᏘᎴᎻᏈ
tresjuncos	ᏘᎴᏍᎱᏂᎪᏍ
treto	ᏘᎴᏙ
trevelez	ᏘᎴᏪᎴᏍ
treviana	ᏘᎴᏫᏯᎾ
trevias	ᏘᎴᏫᏯᏍ
treviño	ᏘᎴᏫᏃ
triacastela	ᏘᎵᏯᎧᏍᏖᎳ
trigueros	ᏘᎵᎨᎶᏍ
trillo	ᏘᎵᎵᏲ
triollo	ᏘᎵᏲᎵᏲ
triste	ᏘᎵᏍᏖ
troncedo	ᏘᎶᏂᏎᏙ
tronchon	ᏘᎶᏂᏠᏂ
trubia	ᏘᎷᏫᏯ
truchas	ᏘᎷᏝᏍ
truchillas	ᏘᎷᏟᎵᏯᏍ
trujillanos	ᏘᎷᎯᎵᏯᏃᏍ
trujillo	ᏘᎷᎯᎵᏲ
trujillos	ᏘᎷᎯᎵᏲᏍ
tudanca	ᏚᏓᏂᎧ
tudela	ᏚᏕᎳ
tuejar	ᏘᏪᎭᎵ
tulebras	ᏚᎴᏫᎳᏍ
turcia	ᏚᎵᏍᏯ
turegano	ᏚᎴᎦᏃ
turis	ᏚᎵᏍ
turleque	ᏚᎵᎴᎨ
turon	ᏚᎶᏂ
turre	ᏚᎴ
turrillas	ᏚᎵᎵᏯᏍ
turruncun	ᏚᎷᏂᎫᏂ
tuy	ᏚᎢ
ubeda	ᎤᏪᏓ
ubidea	ᎤᏫᏕᎠ
ubrique	ᎤᏫᎵᎨ
uceda	ᎤᏎᏓ
ucero	ᎤᏎᎶ
udias	ᎤᏗᏯᏍ
ugijar	ᎤᎯᎭᎵ
ujo	ᎤᎰ
ujue	ᎤᎯᏪ
ulea	ᎤᎴᎠ
ulldecona	ᎤᎵᏱᏕᎪᎾ
ulldemolins	ᎤᎵᏱᏕᎼᎵᏂᏍ
umbrete	ᎤᎻᏈᎴᏖ
uña	ᎤᎾ
uncastillo	ᎤᏂᎧᏍᏘᎵᏲ
unquera	ᎤᏂᎨᎳ
unzue	ᎤᏂᏍᏪ
urbies	ᎤᎵᏫᏰᏍ
urda	ᎤᎵᏓ
urracal	ᎤᎳᎧᎵ
urries	ᎤᎵᏰᏍ
urroz	ᎤᎶᏍ
urueña	ᎤᎵᏪᎾ
urueñas	ᎤᎵᏪᎾᏍ
usagre	ᎤᏌᎩᎴ
used	ᎤᏎᏗ
useras	ᎤᏎᎳᏍ
utebo	ᎤᏖᏬ
utiel	ᎤᏘᏰᎵ
utrera	ᎤᏘᎴᎳ
utrillas	ᎤᏘᎵᎵᏯᏍ
uztarroz	ᎤᏍᏔᎶᏍ
vadocondes	ᏆᏙᎪᏂᏕᏍ
vadollano	ᏆᏙᎵᏯᏃ
valacloche	ᏆᎳᎩᎶᏞ
valcavadillo	ᏆᎵᎧᏩᏗᎵᏲ
valdaracete	ᏆᎵᏓᎳᏎᏖ
valdarachas	ᏆᎵᏓᎳᏝᏍ
valdeajos	ᏆᎵᏕᎠᎰᏍ
valdeavero	ᏆᎵᏕᎠᏪᎶ
valdeaveruelo	ᏆᎵᏕᎠᏪᎵᏪᎶ
valdecaballeros	ᏆᎵᏕᎧᏩᎵᏰᎶᏍ
valdecabras	ᏆᎵᏕᎧᏫᎳᏍ
valdecarros	ᏆᎵᏕᎧᎶᏍ
valdecebollas	ᏆᎵᏕᏎᏬᎵᏯᏍ
valdecebro	ᏆᎵᏕᏎᏫᎶ
valdeconcha	ᏆᎵᏕᎪᏂᏝ
valdeconejos	ᏆᎵᏕᎪᏁᎰᏍ
valdecuenca	ᏆᎵᏕᏇᏂᎧ
valdedios	ᏆᎵᏕᏗᏲᏍ
valdefresno	ᏆᎵᏕᏫᎴᏍᏃ
valdefuentes	ᏆᎵᏕᏫᏪᏂᏖᏍ
valdegamas	ᏆᎵᏕᎦᎹᏍ
valdeganga	ᏆᎵᏕᎦᏂᎦ
valdegovia	ᏆᎵᏕᎪᏫᏯ
valdehijaderos	ᏆᎵᏕᎢᎭᏕᎶᏍ
valdelagua	ᏆᎵᏕᎳᏆ
valdelaguna	ᏆᎵᏕᎳᎫᎾ
valdelcubo	ᏆᎵᏕᎵᎫᏬ
valdelinares	ᏆᎵᏕᎵᎾᎴᏍ
valdelosa	ᏆᎵᏕᎶᏌ
valdelugueros	ᏆᎵᏕᎷᎨᎶᏍ
valdemaluque	ᏆᎵᏕᎹᎷᎨ
valdemorillo	ᏆᎵᏕᎼᎵᎵᏲ
valdemoro	ᏆᎵᏕᎼᎶ
valdenoceda	ᏆᎵᏕᏃᏎᏓ
valdenoches	ᏆᎵᏕᏃᏞᏍ
valdeobispo	ᏆᎵᏕᎣᏫᏍᏉ
valdeolivas	ᏆᎵᏕᎣᎵᏩᏍ
valdeorras	ᏆᎵᏕᎣᎳᏍ
valdepeñas	ᏆᎵᏕᏇᎾᏍ
valdepielago	ᏆᎵᏕᏈᏰᎳᎪ
valdepolo	ᏆᎵᏕᏉᎶ
valdeprados	ᏆᎵᏕᏈᎳᏙᏍ
valderas	ᏆᎵᏕᎳᏍ
valderrey	ᏆᎵᏕᎴᎢ
valderrobres	ᏆᎵᏕᎶᏫᎴᏍ
valdesamario	ᏆᎵᏕᏌᎹᎵᏲ
valdesaz	ᏆᎵᏕᏌᏍ
valdespina	ᏆᎵᏕᏍᏈᎾ
valdespino	ᏆᎵᏕᏍᏈᏃ
valdestillas	ᏆᎵᏕᏍᏘᎵᏯᏍ
valdeteja	ᏆᎵᏕᏖᎭ
valdetorres	ᏆᎵᏕᏙᎴᏍ
valdevimbre	ᏆᎵᏕᏫᎻᏈᎴ
valdezarza	ᏆᎵᏕᏌᎵᏌ
valdihuelo	ᏆᎵᏗᏪᎶ
valdilecha	ᏆᎵᏗᎴᏝ
valdoviño	ᏆᎵᏙᏫᏃ
valdunquillo	ᏆᎵᏚᏂᎩᎵᏲ
valencia	ᏆᎴᏂᏍᏯ
valenzuela	ᏆᎴᏂᏍᏪᎳ
valeria	ᏆᎴᎵᏯ
valga	ᏆᎵᎦ
valjunquera	ᏆᎵᎱᏂᎨᎳ
vallada	ᏆᎵᏯᏓ
valladolises	ᏆᎵᏯᏙᎵᏎᏍ
vallanca	ᏆᎵᏯᏂᎧ
vallbona	ᏆᎵᏱᏬᎾ
valldemosa	ᏆᎵᏱᏕᎼᏌ
valle	ᏆᎵᏰ
vallecas	ᏆᎵᏰᎧᏍ
vallelado	ᏆᎵᏰᎳᏙ
vallfogona	ᏆᎵᏱᏬᎪᎾ
vallibona	ᏆᎵᏱᏬᎾ
vallirana	ᏆᎵᏱᎳᎾ
vallmoll	ᏆᎵᏱᎼᎵᏱ
vallromanas	ᏆᎵᏱᎶᎹᎾᏍ
valls	ᏆᎵᏱᏍ
valmala	ᏆᎵᎹᎳ
valmaseda	ᏆᎵᎹᏎᏓ
valmojado	ᏆᎵᎼᎭᏙ
valnera	ᏆᎵᏁᎳ
valor	ᏆᎶᎵ
valronquillo	ᏆᎵᎶᏂᎩᎵᏲ
valseca	ᏆᎵᏎᎧ
valsequillo	ᏆᎵᏎᎩᎵᏲ
valtajeros	ᏆᎵᏔᎮᎶᏍ
vandellos	ᏆᏂᏕᎵᏲᏍ
vañes	ᏆᏁᏍ
vascongadas	ᏆᏍᎪᏂᎦᏓᏍ
vecinos	ᏇᏏᏃᏍ
vedra	ᏇᏗᎳ
vegadeo	ᏇᎦᏕᎣ
vegamian	ᏇᎦᎻᏯᏂ
veganzones	ᏇᎦᏂᏐᏁᏍ
vegapagar	ᏇᎦᏆᎦᎵ
vegaquemada	ᏇᎦᎨᎹᏓ
vegarienza	ᏇᎦᎵᏰᏂᏌ
velada	ᏇᎳᏓ
velascalvaro	ᏇᎳᏍᎧᎵᏩᎶ
velefique	ᏇᎴᏫᎨ
velilla	ᏇᎵᎵᏯ
vellisca	ᏇᎵᏱᏍᎧ
vendrell	ᏇᏂᏗᎴᎵᏱ
venialbo	ᏇᏂᏯᎵᏬ
ventas	ᏇᏂᏔᏍ
ventillas	ᏇᏂᏘᎵᏯᏍ
venturada	ᏇᏂᏚᎳᏓ
vera	ᏇᎳ
verdu	ᏇᎵᏚ
verea	ᏇᎴᎠ
veredas	ᏇᎴᏓᏍ
vergara	ᏇᎵᎦᎳ
vergel	ᏇᎵᎮᎵ
verges	ᏇᎵᎮᏍ
verin	ᏇᎵᏂ
vezdemarban	ᏇᏍᏕᎹᎵᏩᏂ
viacamp	ᏈᏯᎧᎻᏈ
viana	ᏈᏯᎾ
vianos	ᏈᏯᏃᏍ
viascon	ᏈᏯᏍᎪᏂ
viator	ᏈᏯᏙᎵ
vicalvaro	ᏈᎧᎵᏩᎶ
vicar	ᏈᎧᎵ
vicien	ᏈᏍᏰᏂ
vicolozano	ᏈᎪᎶᏌᏃ
vidangoz	ᏈᏓᏂᎪᏍ
vidiago	ᏈᏗᏯᎪ
vidreras	ᏈᏗᎴᎳᏍ
viella	ᏈᏰᎵᏯ
viguera	ᏈᎨᎳ
vilabella	ᏈᎳᏪᎵᏯ
vilaboa	ᏈᎳᏬᎠ
vilada	ᏈᎳᏓ
vilademat	ᏈᎳᏕᎹᏘ
vilademuls	ᏈᎳᏕᎽᎵᏍ
viladrau	ᏈᎳᏗᎳᎤ
vilagrasa	ᏈᎳᎩᎳᏌ
vilaller	ᏈᎳᎵᏰᎵ
vilanova	ᏈᎳᏃᏩ
vilaplana	ᏈᎳᏈᎳᎾ
vilapouca	ᏈᎳᏉᎤᎧ
vilarrodona	ᏈᎳᎶᏙᎾ
vilaseca	ᏈᎳᏎᎧ
vilatan	ᏈᎳᏔᏂ
vilches	ᏈᎵᏞᏍ
villabona	ᏈᎵᏯᏬᎾ
villacañas	ᏈᎵᏯᎧᎾᏍ
villacarriedo	ᏈᎵᏯᎧᎵᏰᏙ
villacarrillo	ᏈᎵᏯᎧᎵᎵᏲ
villacastin	ᏈᎵᏯᎧᏍᏘᏂ
villaconejos	ᏈᎵᏯᎪᏁᎰᏍ
villada	ᏈᎵᏯᏓ
villadecanes	ᏈᎵᏯᏕᎧᏁᏍ
villadepera	ᏈᎵᏯᏕᏇᎳ
villadiego	ᏈᎵᏯᏗᏰᎪ
villaescusa	ᏈᎵᏯᎡᏍᎫᏌ
villafames	ᏈᎵᏯᏩᎺᏍ
villaflores	ᏈᎵᏯᏫᎶᎴᏍ
villafranca	ᏈᎵᏯᏫᎳᏂᎧ
villafranqueza	ᏈᎵᏯᏫᎳᏂᎨᏌ
villafrechos	ᏈᎵᏯᏫᎴᏠᏍ
villafruela	ᏈᎵᏯᏫᎵᏪᎳ
villagaton	ᏈᎵᏯᎦᏙᏂ
villager	ᏈᎵᏯᎮᎵ
villagonzalo	ᏈᎵᏯᎪᏂᏌᎶ
villahermosa	ᏈᎵᏯᎡᎵᎼᏌ
villahoz	ᏈᎵᏯᎣᏍ
villajoyosa	ᏈᎵᏯᎰᏲᏌ
villalba	ᏈᎵᏯᎵᏩ
villalengua	ᏈᎵᏯᎴᏂᏆ
villalmanzo	ᏈᎵᏯᎵᎹᏂᏐ
villalonga	ᏈᎵᏯᎶᏂᎦ
villalpando	ᏈᎵᏯᎵᏆᏂᏙ
villalube	ᏈᎵᏯᎷᏪ
villaluenga	ᏈᎵᏯᎵᏪᏂᎦ
villalumbroso	ᏈᎵᏯᎷᎻᏈᎶᏐ
villalvaro	ᏈᎵᏯᎵᏩᎶ
villamalea	ᏈᎵᏯᎹᎴᎠ
villamalur	ᏈᎵᏯᎹᎷᎵ
villamañan	ᏈᎵᏯᎹᎾᏂ
villamandos	ᏈᎵᏯᎹᏂᏙᏍ
villamanrique	ᏈᎵᏯᎹᏂᎵᎨ
villamanta	ᏈᎵᏯᎹᏂᏔ
villamantilla	ᏈᎵᏯᎹᏂᏘᎵᏯ
villamarin	ᏈᎵᏯᎹᎵᏂ
villamartin	ᏈᎵᏯᎹᎵᏘᏂ
villamayor	ᏈᎵᏯᎹᏲᎵ
villamea	ᏈᎵᏯᎺᎠ
villamediana	ᏈᎵᏯᎺᏗᏯᎾ
villamejil	ᏈᎵᏯᎺᎯᎵ
villamesias	ᏈᎵᏯᎺᏍᏯᏍ
villamizar	ᏈᎵᏯᎻᏌᎵ
villamol	ᏈᎵᏯᎼᎵ
villamuelas	ᏈᎵᏯᎻᏪᎳᏍ
villanúa	ᏈᎵᏯᏄᎠ
villanubla	ᏈᎵᏯᏄᏫᎳ
villanueva	ᏈᎵᏯᏂᏪᏩ
villaobispo	ᏈᎵᏯᎣᏫᏍᏉ
villapalacios	ᏈᎵᏯᏆᎳᏍᏲᏍ
villaquejida	ᏈᎵᏯᎨᎯᏓ
villaquilambre	ᏈᎵᏯᎩᎳᎻᏈᎴ
villaralbo	ᏈᎵᏯᎳᎵᏬ
villaralto	ᏈᎵᏯᎳᎵᏙ
villarejo	ᏈᎵᏯᎴᎰ
villarente	ᏈᎵᏯᎴᏂᏖ
villaricos	ᏈᎵᏯᎵᎪᏍ
villarino	ᏈᎵᏯᎵᏃ
villarrabe	ᏈᎵᏯᎳᏪ
villarramiel	ᏈᎵᏯᎳᎻᏰᎵ
villarrasa	ᏈᎵᏯᎳᏌ
villarreal	ᏈᎵᏯᎴᎠᎵ
villarrobledo	ᏈᎵᏯᎶᏫᎴᏙ
villarrodrigo	ᏈᎵᏯᎶᏗᎵᎪ
villarroya	ᏈᎵᏯᎶᏯ
villarrubia	ᏈᎵᏯᎷᏫᏯ
villarrubio	ᏈᎵᏯᎷᏫᏲ
villasabariego	ᏈᎵᏯᏌᏩᎵᏰᎪ
villasandino	ᏈᎵᏯᏌᏂᏗᏃ
villasante	ᏈᎵᏯᏌᏂᏖ
villasarracino	ᏈᎵᏯᏌᎳᏏᏃ
villasayas	ᏈᎵᏯᏌᏯᏍ
villaseca	ᏈᎵᏯᏎᎧ
villaselan	ᏈᎵᏯᏎᎳᏂ
villasilos	ᏈᎵᏯᏏᎶᏍ
villasrubias	ᏈᎵᏯᏍᎷᏫᏯᏍ
villastar	ᏈᎵᏯᏍᏔᎵ
villatobas	ᏈᎵᏯᏙᏩᏍ
villatoro	ᏈᎵᏯᏙᎶ
villatoya	ᏈᎵᏯᏙᏯ
villaturiel	ᏈᎵᏯᏚᎵᏰᎵ
villava	ᏈᎵᏯᏩ
villavaquerin	ᏈᎵᏯᏩᎨᎵᏂ
villavendimio	ᏈᎵᏯᏪᏂᏗᎻᏲ
villaviciosa	ᏈᎵᏯᏫᏍᏲᏌ
villaviudas	ᏈᎵᏯᏫᏳᏓᏍ
villayon	ᏈᎵᏯᏲᏂ
villaza	ᏈᎵᏯᏌ
villegas	ᏈᎵᏰᎦᏍ
villel	ᏈᎵᏰᎵ
villena	ᏈᎵᏰᎾ
villerias	ᏈᎵᏰᎵᏯᏍ
villodrigo	ᏈᎵᏲᏗᎵᎪ
villoldo	ᏈᎵᏲᎵᏙ
villora	ᏈᎵᏲᎳ
villores	ᏈᎵᏲᎴᏍ
villoria	ᏈᎵᏲᎵᏯ
vilvestre	ᏈᎵᏪᏍᏘᎴ
vimianzo	ᏈᎻᏯᏂᏐ
vinaceite	ᏈᎾᏎᎢᏖ
vinaroz	ᏈᎾᎶᏍ
vindel	ᏈᏂᏕᎵ
vinebre	ᏈᏁᏫᎴ
viñuela	ᏈᏂᏪᎳ
viñuelas	ᏈᏂᏪᎳᏍ
vinuesa	ᏈᏂᏪᏌ
viruela	ᏈᎵᏪᎳ
visaurin	ᏈᏌᎤᎵᏂ
visiedo	ᏈᏍᏰᏙ
vitigudino	ᏈᏘᎫᏗᏃ
viver	ᏈᏪᎵ
vivero	ᏈᏪᎶ
viveros	ᏈᏪᎶᏍ
vizcaínos	ᏈᏍᎧᎢᏃᏍ
vizmanos	ᏈᏍᎹᏃᏍ
yanguas	ᏯᏂᏆᏍ
yatova	ᏯᏙᏩ
yebes	ᏰᏪᏍ
yebra	ᏰᏫᎳ
yecla	ᏰᎩᎳ
yegen	ᏰᎮᏂ
yela	ᏰᎳ
yepes	ᏰᏇᏍ
yerga	ᏰᎵᎦ
yesa	ᏰᏌ
yeste	ᏰᏍᏖ
yuncler	ᏳᏂᎩᎴᎵ
yuncos	ᏳᏂᎪᏍ
yunquera	ᏳᏂᎨᎳ
zafarraya	ᏌᏩᎳᏯ
zagra	ᏌᎩᎳ
zahara	ᏌᎠᎳ
zahinos	ᏌᎢᏃᏍ
zaidin	ᏌᎢᏗᏂ
zalla	ᏌᎵᏯ
zamarramala	ᏌᎹᎳᎹᎳ
zamayon	ᏌᎹᏲᏂ
zambra	ᏌᎻᏈᎳ
zambrana	ᏌᎻᏈᎳᎾ
zamora	ᏌᎼᎳ
zaorejas	ᏌᎣᎴᎭᏍ
zaragoza	ᏌᎳᎪᏌ
zaratan	ᏌᎳᏔᏂ
zarauz	ᏌᎳᎤᏍ
zarra	ᏌᎳ
zarzalejo	ᏌᎵᏌᎴᎰ
zas	ᏌᏍ
zizur	ᏏᏑᎵ
zorita	ᏐᎵᏔ
zubia	ᏑᏫᏯ
zubieta	ᏑᏫᏰᏔ
zubiri	ᏑᏫᎵ
zucaina	ᏑᎧᎢᎾ
zudaire	ᏑᏓᎢᎴ
zuera	ᏍᏪᎳ
zuheros	ᏑᎡᎶᏍ
zujar	ᏑᎭᎵ
zumarraga	ᏑᎹᎳᎦ
zumaya	ᏑᎹᏯ
zuniga	ᏑᏂᎦ
zurgena	ᏑᎵᎮᎾ
zurzarren	ᏑᎵᏌᎴᏂ
