ababuj	アバブフ
abades	アバデス
abadia	アバディア
abadiano	アバディアノ
abadin	アバディン
abanades	アバナデス
abanilla	アバニリャ
abaran	アバラン
abegondo	アベゴンド
abejar	アベハル
abejuela	アベフエラ
abengibra	アベンヒブラ
abenojar	アベノハル
abiego	アビエゴ
abla	アブラ
ablitas	アブリタス
abrera	アブレラ
abrucena	アブルセナ
acebo	アセボ
acedera	アセデラ
acehuche	アセウチェ
aceuchal	アセウチャル
acrijos	アクリホス
adahuesca	アダウエスカ
adamuz	アダムス
adanero	アダネロ
aday	アダイ
adeje	アデヘ
ademuz	アデムス
ador	アドル
adra	アドラ
adradas	アドラダス
adrados	アドラドス
adzaneta	アドサネタ
agaete	アガエテ
ager	アヘル
agoncillo	アゴンシリョ
agost	アゴスト
agramon	アグラモン
agramunt	アグラムント
agreda	アグレダ
agres	アグレス
agron	アグロン
aguadulce	アグアドゥルセ
aguamansa	アグアマンサ
aguaron	アグアロン
aguas	アグアス
aguaviva	アグアビバ
agudo	アグド
agüera	アグエラ
agüero	アグエロ
aguila	アグイラ
aguilafuente	アグイラフエンテ
aguilas	アグイラス
agüimes	アグイメス
agullana	アグリャナ
agulo	アグロ
ahigal	アイガル
ahillones	アイリョネス
aianis	アヤニス
aibar	アイバル
aiguamurcia	アイグアムルシア
ainsa	アインサ
aizpun	アイスプン
ajamil	アハミル
alaejos	アラエホス
alagon	アラゴン
alajar	アラハル
alajero	アラヘロ
alameda	アラメダ
alamedilla	アラメディリャ
alamillo	アラミリョ
alaminos	アラミノス
alange	アランヘ
alarcon	アラルコン
alarilla	アラリリャ
alaro	アラロ
alatoz	アラトス
alayor	アラヨル
alba	アルバ
albacete	アルバセテ
albages	アルバヘス
albaladejo	アルバラデホ
albalatillo	アルバラティリョ
albana	アルバナ
albanchez	アルバンチェス
albares	アルバレス
albarracin	アルバラシン
albatana	アルバタナ
albatera	アルバテラ
albendea	アルベンデア
albendin	アルベンディン
albentosa	アルベントサ
alberique	アルベリケ
alberite	アルベリテ
albesa	アルベサ
albinana	アルビナナ
albocacer	アルボカセル
alboloduy	アルボロドゥイ
albolote	アルボロテ
albondon	アルボンドン
alboraya	アルボラヤ
alborea	アルボレア
albox	アルボクス
albudeite	アルブデイテ
albujon	アルブホン
albuñol	アルブニョル
albuñuelas	アルブニュエラス
alcadozo	アルカドソ
alcaine	アルカイネ
alcampel	アルカンペル
alcanadre	アルカナドレ
alcanar	アルカナル
alcanices	アルカニセス
alcaniz	アルカニス
alcantara	アルカンタラ
alcantarilla	アルカンタリリャ
alcantud	アルカントゥー
alcaracejos	アルカラセホス
alcaraz	アルカラス
alcarras	アルカラス
alcaucin	アルカウシン
alcaudete	アルカウデテ
alcazaren	アルカサレン
alceda	アルセダ
alcira	アルシラ
alcoba	アルコバ
alcobendas	アルコベンダス
alcocebre	アルコセブレ
alcocer	アルコセル
alcohujate	アルコウハテ
alcolea	アルコレア
alcollarin	アルコリャリン
alconchel	アルコンチェル
alconera	アルコネラ
alcontar	アルコンタル
alcora	アルコラ
alcorisa	アルコリサ
alcoroches	アルコロチェス
alcover	アルコベル
alcoy	アルコイ
alcubierre	アルクビエレ
alcubillas	アルクビリャス
alcublas	アルクブラス
alcudia	アルクディア
alcuescar	アルクエスカル
alcuneza	アルクネサ
aldaya	アルダヤ
aldea	アルデア
aldeacentenera	アルデアセンテネラ
aldealpozo	アルデアルポソ
aldeaquemada	アルデアケマダ
aldearrodrigo	アルデアロドリゴ
aldeavieja	アルデアビエハ
aldehuela	アルデウエラ
aldeire	アルデイレ
aldover	アルドベル
aledo	アレド
alegria	アレグリア
alerre	アレレ
aleson	アレソン
alfacar	アルファカル
alfaiz	アルファイス
alfajarin	アルファハリン
alfambra	アルファンブラ
alfamen	アルファメン
alfara	アルファラ
alfaraz	アルファラス
alfaro	アルファロ
alfarras	アルファラス
alfoz	アルフォス
algaida	アルガイダ
algamitas	アルガミタス
algarinejo	アルガリネホ
algarra	アルガラ
algarrobo	アルガロボ
algatocin	アルガトシン
algeciras	アルヘシラス
algemesi	アルヘメシ
algete	アルヘテ
alginet	アルヒネト
algodonales	アルゴドナレス
algora	アルゴラ
algria	アルグリア
alguaire	アルグアイレ
alguazas	アルグアサス
algueña	アルグエニャ
alia	アリア
aliaga	アリアガ
alicante	アリカンテ
aliseda	アリセダ
aljaraque	アルハラケ
aljibe	アルヒベ
aljorra	アルホラ
aljucen	アルフセン
allariz	アリャリス
allepuz	アレプス
aller	アレル
alles	アレス
allo	アリョ
alloza	アリョサ
almacellas	アルマセリャス
almachar	アルマチャル
almaciles	アルマシレス
almaden	アルマデン
almadenejos	アルマデネホス
almadrones	アルマドロネス
almagro	アルマグロ
almajano	アルマハノ
almaluez	アルマルエス
almansa	アルマンサ
almanza	アルマンサ
almaraz	アルマラス
almatret	アルマトレト
almazan	アルマサン
almazora	アルマソラ
almazul	アルマスル
almedina	アルメディナ
almedinilla	アルメディニリャ
almegijar	アルメヒハル
almeida	アルメイダ
almenar	アルメナル
almenara	アルメナラ
almendra	アルメンドラ
almendral	アルメンドラル
almendralejo	アルメンドラレホ
almendricos	アルメンドリコス
almendros	アルメンドロス
almeria	アルメリア
almogia	アルモヒア
almoguera	アルモグエラ
almohaja	アルモアハ
almoharin	アルモアリン
almonte	アルモンテ
almoradi	アルモラディ
almorox	アルモロクス
almudebar	アルムデバル
almuñécar	アルムニェカル
almuniente	アルムニエンテ
almuradiel	アルムラディエル
almusafes	アルムサフェス
alobras	アロブラス
alocen	アロセン
alora	アロラ
alos	アロス
alosno	アロスノ
alovera	アロベラ
alozaina	アロサイナ
alp	アルプ
alpandeire	アルパンデイレ
alpanseque	アルパンセケ
alpedroches	アルペドロチェス
alpeñés	アルペニェス
alpens	アルペンス
alpera	アルペラ
alperiz	アルペリス
alpuente	アルプエンテ
alquezar	アルケサル
alsasua	アルサスア
altable	アルタブレ
altamira	アルタミラ
altarejos	アルタレホス
altea	アルテア
altorricon	アルトリコン
altoteiro	アルトテイロ
altura	アルトゥラ
alustante	アルスタンテ
alvires	アルビレス
alzola	アルソラ
amaya	アマヤ
amer	アメル
ames	アメス
ameyugo	アメユゴ
amezaga	アメサガ
amieva	アミエバ
amoeiro	アモエイロ
amorebieta	アモレビエタ
amposta	アンポスタ
ampudia	アンプディア
ampuero	アンプエロ
ampurias	アンプリアス
amurrio	アムリオ
amusco	アムスコ
aña	アニャ
anchuras	アンチュラス
ancin	アンシン
andalucia	アンダルシア
andavias	アンダビアス
andilla	アンディリャ
andoain	アンドアイン
andorra	アンドラ
andosilla	アンドシリャ
andraitx	アンドライチュ
andujar	アンドゥハル
angles	アングレス
anglesola	アングレソラ
angüés	アングエス
anguiano	アングイアノ
anguix	アングイクス
aniñón	アニニョン
anleo	アンレオ
añon	アニョン
añora	アニョラ
anso	アンソ
antas	アンタス
antequera	アンテケラ
antigüedad	アンティグエダー
antonaña	アントナニャ
anzanigo	アンサニゴ
anzuola	アンスオラ
anzur	アンスル
apatamonasterio	アパタモナステリオ
apellaniz	アペリャニス
aquilue	アキルエ
aracena	アラセナ
arafo	アラフォ
aragon	アラゴン
aragoncillo	アラゴンシリョ
aranarache	アラナラチェ
aranaz	アラナス
arandillo	アランディリョ
aranjuez	アランフエス
arano	アラノ
aranzazu	アランサス
aranzuegue	アランスエグエ
arapiles	アラピレス
aras	アラス
aravaca	アラバカ
araya	アラヤ
arbeca	アルベカ
arbo	アルボ
arbos	アルボス
arceniega	アルセニエガ
archena	アルチェナ
archilla	アルチリャ
arcos	アルコス
arcusa	アルクサ
ardisa	アルディサ
aren	アレン
arenas	アレナス
areo	アレオ
ares	アレス
areta	アレタ
arevalillo	アレバリリョ
arevalo	アレバロ
arganda	アルガンダ
arganza	アルガンサ
arguedas	アルグエダス
arguellite	アルグエリテ
arguineguin	アルグイネグイン
arguis	アルグイス
arija	アリハ
arinaga	アリナガ
ariñez	アリニェス
ariño	アリニョ
arive	アリベ
ariza	アリサ
arizala	アリサラ
arjona	アルホナ
arjonilla	アルホニリャ
arlanzon	アルランソン
armuna	アルムナ
arnedillo	アルネディリョ
arnedo	アルネド
arnes	アルネス
arnoya	アルノヤ
arnuero	アルヌエロ
aroche	アロチェ
aroizu	アロイス
arona	アロナ
arquillos	アルキリョス
arrabalde	アラバルデ
arrancacepas	アランカセパス
arrazola	アラソラ
arrecife	アレシフェ
arredondo	アレドンド
arriate	アリアテ
arrieta	アリエタ
arrigorriaga	アリゴリアガ
arriondas	アリオンダス
arroba	アロバ
arroniz	アロニス
arroyal	アロヤル
arroyos	アロヨス
arta	アルタ
artajona	アルタホナ
artana	アルタナ
artazu	アルタス
arteijo	アルテイホ
artenara	アルテナラ
artes	アルテス
artieda	アルティエダ
arties	アルティエス
arucas	アルカス
arure	アルレ
arzúa	アルスア
asco	アスコ
asin	アシン
asomadilla	アソマディリャ
ason	アソン
aspariegos	アスパリエゴス
aspe	アスペ
astillero	アスティレロ
astudillo	アストゥディリョ
asturianos	アストゥリアノス
asturias	アストゥリアス
atalaya	アタラヤ
atalayasa	アタラヤサ
ataquines	アタキネス
atarfe	アタルフェ
atauta	アタウタ
atea	アテア
ateca	アテカ
atienza	アティエンサ
atocha	アトチャ
auñón	アウニョン
ausejo	アウセホ
autol	アウトル
autoria	アウトリア
aveinte	アベインテ
avellanes	アベリャネス
avila	アビラ
aviles	アビレス
avinyo	アビンヨ
avinyonet	アビンヨネト
avion	アビオン
ayamonte	アヤモンテ
ayedo	アイェド
ayllon	アイリョン
ayna	アイナ
ayora	アヨラ
aytona	アイトナ
azagra	アサグラ
azaila	アサイラ
azañón	アサニョン
azanuy	アサヌイ
azcoitia	アスコイティア
aznalcazar	アスナルカサル
aznalcollar	アスナルコリャル
azpeitia	アスペイティア
azuaga	アスアガ
azuara	アスアラ
azuelo	アスエロ
babilafuente	バビラフエンテ
bacares	バカレス
badajoz	バダホス
badalona	バダロナ
badaran	バダラン
badenas	バデナス
badolatosa	バドラトサ
badules	バドゥレス
baena	バエナ
baeza	バエサ
baga	バガ
baguena	バグエナ
bagur	バグル
bahillo	バイリョ
bailen	バイレン
baillo	バイリョ
bajamar	バハマル
balaguer	バラグエル
balazote	バラソテ
balces	バルセス
balconete	バルコネテ
baleira	バレイラ
balerma	バレルマ
balimbra	バリンブラ
balira	バリラ
ballerias	バレリアス
ballestar	バレスタル
ballesteros	バレステロス
ballobar	バリョバル
balsareny	バルサレニ
balsicas	バルシカス
baltanas	バルタナス
baltar	バルタル
bañares	バニャレス
bande	バンデ
bañeras	バニェラス
bañobarez	バニョバレス
bañolas	バニョラス
bañon	バニョン
banyoles	バンヨレス
banyos	バンヨス
baracaldo	バラカルド
barahona	バラオナ
barajas	バラハス
baralla	バラリャ
barambio	バランビオ
barasoain	バラソアイン
barbadanes	バルバダネス
barbadillo	バルバディリョ
barbalimpia	バルバリンピア
barbastro	バルバストロ
barca	バルカ
barcarrota	バルカロタ
barcena	バルセナ
barcheta	バルチェタ
barcience	バルシエンセ
barcones	バルコネス
bareyo	バレヨ
bargas	バルガス
barjos	バルホス
barqueros	バルケロス
barracas	バラカス
barrachina	バラチナ
barraco	バラコ
barrax	バラクス
barreiros	バレイロス
barriomartin	バリオマルティン
barro	バロ
barruecopardo	バルエコパルド
barzana	バルサナ
basauri	バサウリ
bascara	バスカラ
basella	バセリャ
batea	バテア
baterno	バテルノ
bayo	バヨ
bayona	バヨナ
baza	バサ
beade	ベアデ
beariz	ベアリス
beas	ベアス
becarrea	ベカレア
beceite	ベセイテ
bechi	ベチ
bedar	ベダル
bedmar	ベドマル
begijar	ベヒハル
begonte	ベゴンテ
beire	ベイレ
beires	ベイレス
bejar	ベハル
bejis	ベヒス
belchite	ベルチテ
belianes	ベリアネス
belinchón	ベリンチョン
bello	ベリョ
belltall	ベルタル
bellver	ベルベル
bellvey	ベルベイ
bellvis	ベルビス
belmez	ベルメス
belmonte	ベルモンテ
belmontejo	ベルモンテホ
belorado	ベロラド
belver	ベルベル
bembibre	ベンビブレ
benabarre	ベナバレ
benacazon	ベナカソン
benafigos	ベナフィゴス
benagalbon	ベナガルボン
benaguacil	ベナグアシル
benahadux	ベナアドゥクス
benahavis	ベナアビス
benajarafa	ベナハラファ
benalauria	ベナラウリア
benamaurel	ベナマウレル
benameji	ベナメヒ
benamocarra	ベナモカラ
benaocaz	ベナオカス
benaojan	ベナオハン
benarraba	ベナラバ
benasal	ベナサル
benasque	ベナスケ
benatae	ベナタエ
benavente	ベナベンテ
benavides	ベナビデス
benavites	ベナビテス
benegiles	ベネヒレス
benejama	ベネハマ
benejuzar	ベネフサル
benferri	ベンフェリ
beniarda	ベニアルダ
beniarres	ベニアレス
benicasim	ベニカシム
benichembla	ベニチェンブラ
benifallet	ベニファレト
benifallim	ベニファリム
benifayo	ベニファヨ
beniganim	ベニガニム
benilloba	ベニリョバ
benimasot	ベニマソト
beninar	ベニナル
beniopa	ベニオパ
benisa	ベニサ
benisanet	ベニサネト
beniseno	ベニセノ
benitachell	ベニタチェル
benizalon	ベニサロン
benuza	ベヌサ
benzu	ベンス
beranga	ベランガ
berantevilla	ベランテビリャ
bercedo	ベルセド
bercero	ベルセロ
berducedo	ベルドゥセド
berdun	ベルドゥン
berga	ベルガ
bergasa	ベルガサ
bergondo	ベルゴンド
bergüenda	ベルグエンダ
berja	ベルハ
berlanga	ベルランガ
bermeo	ベルメオ
berriz	ベリス
berrocal	ベロカル
berzocana	ベルソカナ
besalu	ベサル
besaya	ベサヤ
bescane	ベスカネ
betancuria	ベタンクリア
betanzos	ベタンソス
betelu	ベテル
betera	ベテラ
beteta	ベテタ
bezes	ベセス
biar	ビアル
bibey	ビベイ
biel	ビエル
bielsa	ビエルサ
bienvenida	ビエンベニダ
biescas	ビエスカス
bigastro	ビガストロ
biguezal	ビグエサル
bimeda	ビメダ
bimenes	ビメネス
binaced	ビナセー
binefar	ビネファル
binies	ビニエス
binisalem	ビニサレム
binue	ビヌエ
biosca	ビオスカ
biota	ビオタ
biscarrues	ビスカルエス
biurrun	ビウルン
bizberri	ビスベリ
blanca	ブランカ
blancas	ブランカス
blancos	ブランコス
blanes	ブラネス
blanquilla	ブランキリャ
blazques	ブラスケス
blecua	ブレクア
blesa	ブレサ
boada	ボアダ
boadilla	ボアディリャ
boal	ボアル
bobadilla	ボバディリャ
boboras	ボボラス
bocairente	ボカイレンテ
boceguillas	ボセグイリャス
bocigas	ボシガス
boecillo	ボエシリョ
bogarra	ボガラ
bogarre	ボガレ
bohoyo	ボオヨ
boimorto	ボイモルト
bojar	ボハル
bolaños	ボラニョス
bolea	ボレア
boltaña	ボルタニャ
bonanza	ボナンサ
boñar	ボニャル
bonares	ボナレス
boniches	ボニチェス
bonilla	ボニリャ
boqueijon	ボケイホン
bordon	ボルドン
borines	ボリネス
borja	ボルハ
bornoba	ボルノバ
bornos	ボルノス
borobia	ボロビア
borox	ボロクス
borres	ボレス
borriol	ボリオル
bosost	ボソスト
bot	ボト
botorrita	ボトリタ
boveda	ボベダ
brabatas	ブラバタス
brañosera	ブラニョセラ
braojos	ブラオホス
brea	ブレア
breda	ブレダ
brenes	ブレネス
bretun	ブレトゥン
brihuega	ブリウエガ
briñas	ブリニャス
brion	ブリオン
briones	ブリオネス
briviesca	ブリビエスカ
bronchales	ブロンチャレス
broto	ブロト
brozas	ブロサス
brunete	ブルネテ
brunola	ブルノラ
buciegas	ブシエガス
budia	ブディア
buena	ブエナ
buenavista	ブエナビスタ
buendia	ブエンディア
bueu	ブエウ
bufali	ブファリ
bugarra	ブガラ
buger	ブヘル
buitre	ブイトレ
bujalance	ブハランセ
bujan	ブハン
bujaraloz	ブハラロス
bullas	ブリャス
buñero	ブニェロ
buniel	ブニエル
buñol	ブニョル
buñola	ブニョラ
buñuel	ブニュエル
burbaguena	ブルバグエナ
bures	ブレス
burgo	ブルゴ
burgohondo	ブルゴオンド
burgos	ブルゴス
burguete	ブルグエテ
burgui	ブルグイ
burguillos	ブルグイリョス
buron	ブロン
burriana	ブリアナ
burujon	ブルホン
busot	ブソト
busquistar	ブスキスタル
cabana	カバナ
cabañaquinta	カバニャキンタ
cabañas	カバニャス
cabanes	カバネス
cabanillas	カバニリャス
cabe	カベ
cabezamesada	カベサメサダ
cabezarados	カベサラドス
cabezo	カベソ
cabolafuente	カボラフエンテ
cabra	カブラ
cabrales	カブラレス
cabranes	カブラネス
cabreiros	カブレイロス
cabrillanes	カブリリャネス
cabrillas	カブリリャス
cacabelos	カカベロス
caceres	カセレス
cachilla	カチリャ
cachorrilla	カチョリリャ
cacin	カシン
cadagua	カダグア
cadaques	カダケス
cadavedo	カダベド
cadi	カディ
cadiar	カディアル
cadreita	カドレイタ
cadrete	カドレテ
cala	カラ
calaceite	カラセイテ
calaf	カラフ
calafell	カラフェル
calahorra	カラオラ
calamocha	カラモチャ
calamonte	カラモンテ
calañas	カラニャス
calanda	カランダ
calasparra	カラスパラ
calatanazor	カラタナソル
calatayud	カラタユー
calatorao	カラトラオ
calaveruela	カラベルエラ
caldas	カルダス
calderina	カルデリナ
caleruega	カレルエガ
caleta	カレタ
calicasas	カリカサス
calig	カリグ
callejas	カレハス
calonge	カロンヘ
calpe	カルペ
caltojar	カルトハル
calvia	カルビア
calzadilla	カルサディリャ
camaleno	カマレノ
camallera	カマレラ
camarao	カマラオ
camarasa	カマラサ
camarena	カマレナ
camarillas	カマリリャス
camariñas	カマリニャス
camas	カマス
cambados	カンバドス
cambil	カンビル
cambre	カンブレ
cambrils	カンブリルス
caminomorisco	カミノモリスコ
caminreal	カミンレアル
campanario	カンパナリオ
campanet	カンパネト
campanillas	カンパニリャス
campano	カンパノ
campaspero	カンパスペロ
campdevanol	カンプデバノル
campello	カンペリョ
campillo	カンピリョ
campillos	カンピリョス
campisabalos	カンピサバロス
campomanes	カンポマネス
camporredondo	カンポレドンド
camporrells	カンポレルス
camporrobles	カンポロブレス
campos	カンポス
campotejar	カンポテハル
camprodor	カンプロドル
camprovin	カンプロビン
camunas	カムナス
cañada	カニャダ
cañadajuncosa	カニャダフンコサ
canales	カナレス
canals	カナルス
cañamares	カニャマレス
cañamero	カニャメロ
cañar	カニャル
cañaveral	カニャベラル
cañaveras	カニャベラス
cancarix	カンカリクス
cancienes	カンシエネス
candas	カンダス
candasnos	カンダスノス
candelaria	カンデラリア
candelario	カンデラリオ
candeleda	カンデレダ
candilichera	カンディリチェラ
candin	カンディン
canedo	カネド
canena	カネナ
canero	カネロ
canfranc	カンフランク
cangas	カンガス
caniles	カニレス
canillas	カニリャス
canizal	カニサル
canizares	カニサレス
canizo	カニソ
canjayar	カンハヤル
cantalapiedra	カンタラピエドラ
cantalejo	カンタレホ
cantalojas	カンタロハス
cantalpino	カンタルピノ
cantareros	カンタレロス
cantavieja	カンタビエハ
canteras	カンテラス
cantillana	カンティリャナ
cantoral	カントラル
cantoria	カントリア
canyellas	カンイェリャス
caparroso	カパロソ
capdella	カプデリャ
capdepera	カプデペラ
capellades	カペリャデス
capilduy	カピルドゥイ
capilla	カピリャ
carabaña	カラバニャ
carabanchel	カラバンチェル
caracuel	カラクエル
caralps	カラルプス
caravaca	カラバカ
carbajo	カルバホ
carbia	カルビア
carcaboso	カルカボソ
carcabuey	カルカブエイ
carcagente	カルカヘンテ
carcar	カルカル
carcastillo	カルカスティリョ
carcelen	カルセレン
carchel	カルチェル
carchelejo	カルチェレホ
cardejon	カルデホン
cardona	カルドナ
carenas	カレナス
cariñena	カリニェナ
cariño	カリニョ
carlet	カルレト
carmena	カルメナ
carracedelo	カラセデロ
carral	カラル
carranque	カランケ
carranza	カランサ
carrascalejo	カラスカレホ
carrascosa	カラスコサ
carratraca	カラトラカ
carreña	カレニャ
carril	カリル
carrizal	カリサル
carrizo	カリソ
carrizosa	カリソサ
carrocera	カロセラ
carroo	カロオ
cartama	カルタマ
cartaya	カルタヤ
cartelle	カルテレ
carucedo	カルセド
casalarreina	カサラレイナ
casar	カサル
casarabonela	カサラボネラ
casarejos	カサレホス
casares	カサレス
casariche	カサリチェ
casasimarro	カサシマロ
casatejada	カサテハダ
casavieja	カサビエハ
cascante	カスカンテ
caseda	カセダ
caseras	カセラス
caserras	カセラス
casinos	カシノス
caso	カソ
caspe	カスペ
castala	カスタラ
castalla	カスタリャ
castanesa	カスタネサ
castaño	カスタニョ
castaras	カスタラス
castejon	カステホン
castelflorite	カステルフロリテ
castellanos	カステリャノス
castelldans	カステルダンス
castelldefels	カステルデフェルス
castellote	カステリョテ
castells	カステルス
castelltallat	カステルタリャト
castellvell	カステルベル
castelseras	カステルセラス
castelvispal	カステルビスパル
castielfabib	カスティエルファビブ
castildelgado	カスティルデルガド
castiliscar	カスティリスカル
castilla	カスティリャ
castillejar	カスティレハル
castilmimbre	カスティルミンブレ
castilnuevo	カスティルヌエボ
castralvo	カストラルボ
castril	カストリル
castrillon	カストリリョン
castrocalion	カストロカリオン
castrocontrigo	カストロコントリゴ
castrodeza	カストロデサ
castrogeriz	カストロヘリス
castrogonzalo	カストロゴンサロ
castromocho	カストロモチョ
castromonte	カストロモンテ
castromudarra	カストロムダラ
castronuevo	カストロヌエボ
castronuño	カストロヌニョ
castropodame	カストロポダメ
castropol	カストロポル
castuera	カストゥエラ
catadau	カタダウ
catarroja	カタロハ
cati	カティ
catllal	カトリャル
catoira	カトイラ
catoute	カトウテ
catral	カトラル
caude	カウデ
caudete	カウデテ
caudiel	カウディエル
caurel	カウレル
cavezon	カベソン
cayon	カヨン
cazalegas	カサレガス
cea	セア
ceadea	セアデア
ceanuri	セアヌリ
cebanico	セバニコ
cebolla	セボリャ
cebollar	セボリャル
cebollera	セボレラ
cebreros	セブレロス
cebron	セブロン
ceclavin	セクラビン
cecos	セコス
cedeira	セデイラ
cedillo	セディリョ
cedrillas	セドリリャス
cee	セエ
cehegin	セエヒン
ceinos	セイノス
cejo	セホ
celadas	セラダス
celanova	セラノバ
cella	セリャ
celtiberia	セルティベリア
cenia	セニア
cenicero	セニセロ
cenicientos	セニシエントス
cenizate	セニサテ
cenlle	センレ
centellas	センテリャス
centenillo	センテニリョ
centro	セントロ
cepeda	セペダ
cerceda	セルセダ
cercedilla	セルセディリャ
cerda	セルダ
cerdedo	セルデド
cerdido	セルディド
cerezo	セレソ
cernegula	セルネグラ
cerollera	セロレラ
cerralbo	セラルボ
cervera	セルベラ
cespedossa	セスペドサ
cestona	セストナ
cesuras	セスラス
cetina	セティナ
ceuti	セウティ
chamartin	チャマルティン
chamberi	チャンベリ
chantada	チャンタダ
chapineria	チャピネリア
charches	チャルチェス
chauchina	チャウチナ
chavaler	チャバレル
checa	チェカ
cheles	チェレス
chella	チェリャ
chelva	チェルバ
chera	チェラ
chercos	チェルコス
chert	チェルト
cherta	チェルタ
cheste	チェステ
chiclana	チクラナ
chilches	チルチェス
chilizarrias	チリサリアス
chillon	チリョン
chiloeches	チロエチェス
chimerraes	チメラエス
chinchon	チンチョン
chío	チオ
chipiona	チピオナ
chiprana	チプラナ
chirivel	チリベル
chiva	チバ
chodos	チョドス
chovar	チョバル
chueca	チュエカ
chulilla	チュリリャ
chullo	チュリョ
ciadoncha	シアドンチャ
cibea	シベア
cidad	シダー
cidones	シドネス
ciempozuelos	シエンポスエロス
cieza	シエサ
cifuentes	シフエンテス
cigales	シガレス
cigüenza	シグエンサ
cillamayor	シリャマヨル
cillas	シリャス
cilleros	シレロス
cimballa	シンバリャ
cinctorres	シンクトレス
cintruenigo	シントルエニゴ
cional	シオナル
ciordia	シオルディア
ciperez	シペレス
cirat	シラト
cirauqui	シラウキ
ciria	シリア
ciriza	シリサ
ciruelos	シルエロス
cirugeda	シルヘダ
cisla	シスラ
cisneros	シスネロス
cistierna	システィエルナ
ciudadela	シウダデラ
ciutadilla	シウタディリャ
clariana	クラリアナ
coaña	コアニャ
cobatillas	コバティリャス
cobdar	コブダル
cobeta	コベタ
cobreros	コブレロス
coca	コカ
cocentaina	コセンタイナ
codeseda	コデセダ
codos	コドス
cofete	コフェテ
cogollos	コゴリョス
cogolludo	コゴリュド
coín	コイン
coiros	コイロス
coles	コレス
colgadizos	コルガディソス
colindres	コリンドレス
collados	コリャドス
collanzo	コリャンソ
colliga	コリガ
colmenar	コルメナル
colmenarejo	コルメナレホ
colomera	コロメラ
colunga	コルンガ
comares	コマレス
combarros	コンバロス
comillas	コミリャス
competa	コンペタ
compostela	コンポステラ
concud	コンクー
conil	コニル
conjo	コンホ
conques	コンケス
conquista	コンキスタ
consuegra	コンスエグラ
contes	コンテス
copons	コポンス
corbaton	コルバトン
corbelle	コルベレ
corbera	コルベラ
corchuela	コルチュエラ
corconte	コルコンテ
corcubion	コルクビオン
cordoba	コルドバ
cordova	コルドバ
cordovin	コルドビン
corella	コレリャ
coreses	コレセス
corgo	コルゴ
coria	コリア
coripe	コリペ
coristanco	コリスタンコ
corme	コルメ
cornago	コルナゴ
corpa	コルパ
corralejo	コラレホ
corrales	コラレス
corredoiras	コレドイラス
corrubedo	コルベド
cortegada	コルテガダ
cortegana	コルテガナ
cortelazor	コルテラソル
cortes	コルテス
corullon	コルリョン
corvera	コルベラ
cosa	コサ
coscurita	コスクリタ
coslada	コスラダ
cospeito	コスペイト
costitx	コスティチュ
cosvenda	コスベンダ
cotiella	コティエリャ
cotillas	コティリャス
cotillo	コティリョ
cotobad	コトバー
cousa	コウサ
covadonga	コバドンガ
covarrubias	コバルビアス
covas	コバス
covelo	コベロ
cox	コクス
cozar	コサル
creciente	クレシエンテ
cremenes	クレメネス
crespos	クレスポス
cretas	クレタス
crevillente	クレビレンテ
cripan	クリパン
cristobal	クリストバル
cruce	クルセ
cuadros	クアドロス
cualedro	クアレドロ
cuatretonda	クアトレトンダ
cubells	クベルス
cubla	クブラ
cucutas	ククタス
cudillero	クディレロ
cuellar	クエリャル
cuenca	クエンカ
culla	クリャ
cullera	クレラ
culleredo	クレレド
cuntis	クンティス
curueña	クルエニャ
daimiel	ダイミエル
dalias	ダリアス
dancharinea	ダンチャリネア
darnius	ダルニウス
daroca	ダロカ
darrical	ダリカル
darro	ダロ
degaña	デガニャ
deifontes	デイフォンテス
deleitosa	デレイトサ
delicias	デリシアス
denia	デニア
destriana	デストリアナ
deusto	デウスト
deva	デバ
deya	デヤ
deza	デサ
dicastillo	ディカスティリョ
diezma	ディエスマ
dilar	ディラル
dima	ディマ
diustes	ディウステス
dobro	ドブロ
dodro	ドドロ
dolar	ドラル
dolores	ドロレス
domeno	ドメノ
domingo	ドミンゴ
donado	ドナド
dosbarrios	ドスバリオス
dozon	ドソン
driebes	ドリエベス
dueñas	ドゥエニャス
dumbria	ドゥンブリア
durango	ドゥランゴ
duraton	ドゥラトン
durcal	ドゥルカル
ea	エア
echalar	エチャラル
echalecu	エチャレク
echano	エチャノ
echarri	エチャリ
ecija	エシハ
egues	エグエス
eibar	エイバル
ejulve	エフルベ
elanchove	エランチョベ
elche	エルチェ
elda	エルダ
elgoibar	エルゴイバル
elizondo	エリソンド
eljas	エルハス
elorrio	エロリオ
embid	エンビー
embun	エンブン
empanadas	エンパナダス
encinas	エンシナス
encinasola	エンシナソラ
encinedo	エンシネド
encinillas	エンシニリャス
enciso	エンシソ
endrinal	エンドリナル
enfesta	エンフェスタ
enguera	エングエラ
enguidanos	エングイダノス
enix	エニクス
entrena	エントレナ
entrimo	エントリモ
enveija	エンベイハ
epila	エピラ
erice	エリセ
erillas	エリリャス
eriste	エリステ
erla	エルラ
ermua	エルムア
errazu	エラス
erro	エロ
erustes	エルステス
escairon	エスカイロン
escalada	エスカラダ
escalante	エスカランテ
escalo	エスカロ
escalona	エスカロナ
escalonilla	エスカロニリャ
escamilla	エスカミリャ
escanuela	エスカヌエラ
escarroz	エスカロス
escatron	エスカトロン
esclavitud	エスクラビトゥー
escombreas	エスコンブレアス
escorca	エスコルカ
escoriaza	エスコリアサ
escorihuela	エスコリウエラ
escriche	エスクリチェ
escucha	エスクチャ
escullar	エスクリャル
escurial	エスクリアル
escusa	エスクサ
escuzar	エスクサル
esfiliana	エスフィリアナ
esgos	エスゴス
espadan	エスパダン
espadaña	エスパダニャ
espadañedo	エスパダニェド
espadilla	エスパディリャ
esparragalejo	エスパラガレホ
esparraguera	エスパラグエラ
espasante	エスパサンテ
espeja	エスペハ
espejo	エスペホ
espeluy	エスペルイ
espera	エスペラ
espes	エスペス
espiel	エスピエル
espigüete	エスピグエテ
espin	エスピン
espina	エスピナ
espinama	エスピナマ
espinilla	エスピニリャ
espirdo	エスピルド
esplegares	エスプレガレス
esplugas	エスプルガス
esplus	エスプルス
espolla	エスポリャ
espot	エスポト
esquivias	エスキビアス
establiments	エスタブリメンツ
estadilla	エスタディリャ
estallo	エスタリョ
estanyol	エスタンヨル
esteban	エステバン
estella	エステリャ
estena	エステナ
estepa	エステパ
estepar	エステパル
estepona	エステポナ
estivella	エスティベリャ
estopiñan	エストピニャン
estremera	エストレメラ
etreros	エトレロス
eulate	エウラテ
extremadura	エストレマドゥラ
ezcaray	エスカライ
ezcurra	エスクラ
fabara	ファバラ
fabero	ファベロ
facinas	ファシナス
falces	ファルセス
falconera	ファルコネラ
falset	ファルセト
famorca	ファモルカ
fañanas	ファニャナス
fanlo	ファンロ
farajan	ファラハン
farasdues	ファラスドゥエス
farena	ファレナ
fariza	ファリサ
fatarella	ファタレリャ
faura	ファウラ
favareta	ファバレタ
fayon	ファヨン
febro	フェブロ
felanitx	フェラニチュ
felechosa	フェレチョサ
felix	フェリクス
fene	フェネ
feria	フェリア
fermoselle	フェルモセレ
fernancaballero	フェルナンカバレロ
ferreira	フェレイラ
ferrerias	フェレリアス
ferreruela	フェレルエラ
figols	フィゴルス
figueras	フィグエラス
figueroles	フィグエロレス
figuerosa	フィグエロサ
finana	フィナナ
finestrat	フィネストラト
finisterre	フィニステレ
fiscal	フィスカル
fitero	フィテロ
flassa	フラサ
flix	フリクス
fondon	フォンドン
fonelas	フォネラス
fonfria	フォンフリア
fonollosa	フォノリョサ
fonsagrada	フォンサグラダ
fontanar	フォンタナル
fontanarejo	フォンタナレホ
fontanosas	フォンタノサス
fontao	フォンタオ
fontellas	フォンテリャス
fontioso	フォンティオソ
fontiveros	フォンティベロス
fontllonga	フォントリョンガ
fonz	フォンス
forcarey	フォルカレイ
foronda	フォロンダ
forua	フォルア
foz	フォス
frades	フラデス
fraga	フラガ
frailes	フライレス
francos	フランコス
frechilla	フレチリャ
fredes	フレデス
freginals	フレヒナルス
freila	フレイラ
fresnedilla	フレスネディリャ
fresnedo	フレスネド
frias	フリアス
frigiliana	フリヒリアナ
friol	フリオル
fromista	フロミスタ
frumales	フルマレス
fuencaliente	フエンカリエンテ
fuencarral	フエンカラル
fuencemillan	フエンセミリャン
fuendejalon	フエンデハロン
fuendetodos	フエンデトドス
fuenferrada	フエンフェラダ
fuengirola	フエンヒロラ
fuenlabrada	フエンラブラダ
fuenllana	フエンリャナ
fuenmayor	フエンマヨル
fuensalida	フエンサリダ
fuensanta	フエンサンタ
fuentealbilla	フエンテアルビリャ
fuenteboa	フエンテボア
fuentecen	フエンテセン
fuenteguinaldo	フエンテグイナルド
fuenteheridos	フエンテエリドス
fuentelapeña	フエンテラペニャ
fuentelcesped	フエンテルセスペー
fuentelmonje	フエンテルモンヘ
fuentelsaz	フエンテルサス
fuentemilanos	フエンテミラノス
fuentenovilla	フエンテノビリャ
fuentepelayo	フエンテペラヨ
fuentepinilla	フエンテピニリャ
fuenterrabia	フエンテラビア
fuenterrebollo	フエンテレボリョ
fuenterrobles	フエンテロブレス
fuentes	フエンテス
fuentesaúco	フエンテサウコ
fuentescusa	フエンテスクサ
fuentesecas	フエンテセカス
fuentespalda	フエンテスパルダ
fuentespina	フエンテスピナ
fuentidueña	フエンティドゥエニャ
funes	フネス
furnas	フルナス
fustiñana	フスティニャナ
gabaldon	ガバルドン
gabarret	ガバレト
gabasa	ガバサ
gador	ガドル
gajanejos	ガハネホス
gajates	ガハテス
galapagar	ガラパガル
galapagos	ガラパゴス
galar	ガラル
galaroza	ガラロサ
galbarra	ガルバラ
galdacano	ガルダカノ
galdames	ガルダメス
galende	ガレンデ
galera	ガレラ
galicia	ガリシア
galinduste	ガリンドゥステ
galisteo	ガリステオ
gallegos	ガレゴス
gallinal	ガリナル
gallur	ガリュル
galvez	ガルベス
gamonal	ガモナル
ganame	ガナメ
gandesa	ガンデサ
gandia	ガンディア
ganuelas	ガヌエラス
garaballa	ガラバリャ
garayoa	ガラヨア
garcillan	ガルシリャン
gargaligas	ガルガリガス
gargallo	ガルガリョ
gargüera	ガルグエラ
garinoain	ガリノアイン
garoiez	ガロイェス
garraf	ガラフ
garralda	ガラルダ
garray	ガライ
garrigas	ガリガス
garrovillas	ガロビリャス
garrucha	ガルチャ
gascueña	ガスクエニャ
gata	ガタ
gatova	ガトバ
gaucin	ガウシン
gauna	ガウナ
gava	ガバ
gavanes	ガバネス
gelida	ヘリダ
gelsa	ヘルサ
gelves	ヘルベス
genalguacil	ヘナルグアシル
genave	ヘナベ
genevilla	ヘネビリャ
gerena	ヘレナ
germade	ヘルマデ
gerona	ヘロナ
gerri	ヘリ
gesera	ヘセラ
geve	ヘベ
gibarroyo	ヒバロヨ
gijon	ヒホン
gilena	ヒレナ
gimenells	ヒメネルス
gironella	ヒロネリャ
godall	ゴダル
godelleta	ゴデレタ
goiriz	ゴイリス
goizueta	ゴイスエタ
golada	ゴラダ
golpejas	ゴルペハス
gomara	ゴマラ
gomecello	ゴメセリョ
gomesende	ゴメセンデ
gondomar	ゴンドマル
gor	ゴル
gorafe	ゴラフェ
gormaz	ゴルマス
gotarrendura	ゴタレンドゥラ
gozon	ゴソン
gradefes	グラデフェス
grado	グラド
grajera	グラヘラ
granada	グラナダ
granadella	グラナデリャ
granadilla	グラナディリャ
granatula	グラナトゥラ
grandes	グランデス
grañén	グラニェン
granollers	グラノレルス
graus	グラウス
gravalos	グラバロス
grazalema	グラサレマ
griegos	グリエゴス
griñón	グリニョン
grisen	グリセン
grove	グロベ
guadahortuna	グアダオルトゥナ
guadajoz	グアダホス
guadalajara	グアダラハラ
guadalaviar	グアダラビアル
guadalcanal	グアダルカナル
guadalcazar	グアダルカサル
guadalupe	グアダルペ
guadamur	グアダムル
guadarrama	グアダラマ
guadarranque	グアダランケ
guadasuar	グアダスアル
guadix	グアディクス
gualchos	グアルチョス
gualta	グアルタ
guardiola	グアルディオラ
guardo	グアルド
guareña	グアレニャ
guaro	グアロ
guarroman	グアロマン
gudar	グダル
guecho	グエチョ
güeñes	グエニェス
güesa	グエサ
guetaria	グエタリア
guiana	グイアナ
guijo	グイホ
guijuelo	グイフエロ
guillarey	グイリャレイ
guillena	グイレナ
guillerias	グイレリアス
guimaray	グイマライ
guimera	グイメラ
guisona	グイソナ
guitiriz	グイティリス
gulina	グリナ
guntin	グンティン
guriezo	グリエソ
gurp	グルプ
hacinas	アシナス
haro	アロ
hecho	エチョ
helechal	エレチャル
helechosa	エレチョサ
hellin	エリン
henarejos	エナレホス
henche	エンチェ
herbes	エルベス
herencia	エレンシア
hernani	エルナニ
hernansancho	エルナンサンチョ
herramelluri	エラメリュリ
herrera	エレラ
herreria	エレリア
herrerias	エレリアス
herreros	エレロス
herreruela	エレルエラ
hervas	エルバス
higa	イガ
higuera	イグエラ
higueruela	イグエルエラ
higueruelas	イグエルエラス
hijar	イハル
hinodejo	イノデホ
hinojal	イノハル
hinojales	イノハレス
hinojares	イノハレス
hinojos	イノホス
hinojosa	イノホサ
hinojosas	イノホサス
holguera	オルグエラ
hombrados	オンブラドス
honrubia	オンルビア
hontalbilla	オンタルビリャ
hontanares	オンタナレス
hontanaya	オンタナヤ
hontecillos	オンテシリョス
hontoba	オントバ
horche	オルチェ
hornos	オルノス
hospitalet	オスピタレト
hoyos	オヨス
hoyuelos	オユエロス
huarte	ウアルテ
huelago	ウエラゴ
huelamo	ウエラモ
huelma	ウエルマ
huelva	ウエルバ
huelves	ウエルベス
hueneja	ウエネハ
huermeces	ウエルメセス
huerrios	ウエリオス
huertahernando	ウエルタエルナンド
huerteles	ウエルテレス
huerto	ウエルト
huesa	ウエサ
huesca	ウエスカ
huescar	ウエスカル
huete	ウエテ
humanes	ウマネス
humilladero	ウミリャデロ
husillos	ウシリョス
ibahernando	イバエルナンド
ibdes	イブデス
ibi	イビ
iborra	イボラ
ibros	イブロス
idocin	イドシン
iglesias	イグレシアス
igualada	イグアラダ
igualeja	イグアレハ
igüeña	イグエニャ
ilche	イルチェ
ilerda	イレルダ
ilipa	イリパ
illana	イリャナ
illano	イリャノ
illas	イリャス
illescas	イレスカス
illora	イリョラ
illueca	イリュエカ
imon	イモン
incinillas	インシニリャス
incio	インシオ
infantes	インファンテス
infiesto	インフィエスト
iniesta	イニエスタ
instincion	インスティンシオン
irijo	イリホ
irijoa	イリホア
irueste	イルエステ
irun	イルン
irura	イルラ
irurita	イルリタ
irurozqui	イルロスキ
isaba	イサバ
iscar	イスカル
isil	イシル
isona	イソナ
isso	イソ
istan	イスタン
isuerre	イスエレ
itrabo	イトラボ
ituero	イトゥエロ
izalzu	イサルス
izarra	イサラ
iznájar	イスナハル
iznalloz	イスナリョス
iznatoraf	イスナトラフ
jabaga	ハバガ
jabalera	ハバレラ
jabaloyas	ハバロヤス
jabalquinto	ハバルキント
jabarriega	ハバリエガ
jabugo	ハブゴ
jaca	ハカ
jadraque	ハドラケ
jaen	ハエン
jalance	ハランセ
jalon	ハロン
jaraba	ハラバ
jaraco	ハラコ
jarafuel	ハラフエル
jaraicejo	ハライセホ
jarandilla	ハランディリャ
jaray	ハライ
jarque	ハルケ
jatar	ハタル
jatiel	ハティエル
jativa	ハティバ
jaulin	ハウリン
jaurrieta	ハウリエタ
javea	ハベア
jayena	ハイェナ
jemenuño	ヘメヌニョ
jeresa	ヘレサ
jerica	ヘリカ
jerte	ヘルテ
jimena	ヒメナ
jirueque	ヒルエケ
jodar	ホダル
jorairatar	ホライラタル
jorcas	ホルカス
jorquera	ホルケラ
jove	ホベ
jubera	フベラ
jubrique	フブリケ
judes	フデス
judio	フディオ
jumilla	フミリャ
juncajo	フンカホ
juncosa	フンコサ
juneda	フネダ
labacolla	ラバコリャ
labajos	ラバホス
laborcillas	ラボルシリャス
lacalahorra	ラカラオラ
lachar	ラチャル
lacumbre	ラクンブレ
lage	ラヘ
laguarres	ラグアレス
laguarta	ラグアルタ
lagunaseca	ラグナセカ
lagunilla	ラグニリャ
lalin	ラリン
lama	ラマ
lanaja	ラナハ
lancara	ランカラ
lanciego	ランシエゴ
landete	ランデテ
lanestosa	ラネストサ
langreo	ラングレオ
languilla	ラングイリャ
lanjaron	ランハロン
lantadilla	ランタディリャ
lanteira	ランテイラ
lanz	ランス
lanza	ランサ
lapeza	ラペサ
lardero	ラルデロ
laredo	ラレド
laroco	ラロコ
laroles	ラロレス
larrainzar	ララインサル
larraona	ララオナ
larrion	ラリオン
lasarte	ラサルテ
latina	ラティナ
latre	ラトレ
lavadores	ラバドレス
lavapiés	ラバピエス
layana	ラヤナ
layna	ライナ
layos	ラヨス
laza	ラサ
leache	レアチェ
lebrija	レブリハ
lecera	レセラ
leciñena	レシニェナ
lecumberri	レクンベリ
ledaña	レダニャ
ledanca	レダンカ
ledesma	レデスマ
leganés	レガネス
leganiel	レガニエル
leiro	レイロ
leitariegos	レイタリエゴス
leiza	レイサ
lemona	レモナ
lences	レンセス
lepe	レペ
lequeitio	レケイティオ
lerga	レルガ
lerida	レリダ
lerin	レリン
lerma	レルマ
les	レス
lesaca	レサカ
letur	レトゥル
letux	レトゥクス
leza	レサ
lezama	レサマ
lezuza	レスサ
librilla	リブリリャ
libros	リブロス
lidon	リドン
liédena	リエデナ
lietor	リエトル
lijar	リハル
lillol	リリョル
limpias	リンピアス
linares	リナレス
liñola	リニョラ
liria	リリア
lizarraga	リサラガ
llado	リャド
llafranc	リャフランク
llagostera	リャゴステラ
llanes	リャネス
llansa	リャンサ
llauri	リャウリ
llera	レラ
llerena	レレナ
llers	レルス
lles	レス
llivia	リビア
llobregales	リョブレガレス
llodio	リョディオ
llombay	リョンバイ
lloseta	リョセタ
llovera	リョベラ
llubi	リュビ
lluchmayor	リュチュマヨル
loarre	ロアレ
lobatejo	ロバテホ
lobera	ロベラ
lobon	ロボン
lodosa	ロドサ
loeches	ロエチェス
logroño	ログロニョ
logrosan	ログロサン
loja	ロハ
lombrana	ロンブラナ
longares	ロンガレス
lopera	ロペラ
lorca	ロルカ
lorcha	ロルチャ
lorenzana	ロレンサナ
lores	ロレス
lorqui	ロルキ
losacino	ロサシノ
lousame	ロウサメ
lovios	ロビオス
lozoya	ロソヤ
lozoyuela	ロソユエラ
luanco	ルアンコ
luarca	ルアルカ
lubian	ルビアン
lubrin	ルブリン
lucar	ルカル
lucena	ルセナ
luceni	ルセニ
lucillo	ルシリョ
ludiente	ルディエンテ
luelmo	ルエルモ
luesia	ルエシア
luezas	ルエサス
lugan	ルガン
lugo	ルゴ
lugones	ルゴネス
lugros	ルグロス
lujar	ルハル
lumbier	ルンビエル
lumbrales	ルンブラレス
lumbreras	ルンブレラス
lumpiaque	ルンピアケ
luna	ルナ
luque	ルケ
luyego	ルイェゴ
luzaga	ルサガ
luzon	ルソン
macael	マカエル
maceda	マセダ
machero	マチェロ
macotera	マコテラ
maderuelo	マデルエロ
madridejos	マドリデホス
madrigalejo	マドリガレホ
madriguera	マドリグエラ
madrigueras	マドリグエラス
madrona	マドロナ
madronera	マドロネラ
madroño	マドロニョ
maella	マエリャ
maello	マエリョ
maestre	マエストレ
maestu	マエストゥ
magacela	マガセラ
magallon	マガリョン
magaña	マガニャ
magaz	マガス
magina	マヒナ
maguilla	マグイリャ
mahide	マイデ
mahon	マオン
mahora	マオラ
mainar	マイナル
majadas	マハダス
majaelrayo	マハエルラヨ
mala	マラ
malagon	マラゴン
malaguilla	マラグイリャ
malanquilla	マランキリャ
malcocinado	マルコシナド
malgrat	マルグラト
mallen	マレン
malon	マロン
malpica	マルピカ
maluenda	マルエンダ
mampodre	マンポドレ
manacor	マナコル
manchita	マンチタ
mandayona	マンダヨナ
mañeru	マニェル
manilva	マニルバ
manises	マニセス
manlleu	マンレウ
manresa	マンレサ
manresana	マンレサナ
mansilla	マンシリャ
mantañes	マンタニェス
mantiel	マンティエル
manzanares	マンサナレス
manzaneda	マンサネダ
manzanedo	マンサネド
manzaneque	マンサネケ
manzanera	マンサネラ
maqueda	マケダ
maracena	マラセナ
maranchon	マランチョン
marazoleja	マラソレハ
marbella	マルベリャ
marcilla	マルシリャ
marganell	マルガネル
mariana	マリアナ
marin	マリン
marinaleda	マリナレダ
marines	マリネス
marmolejo	マルモレホ
marron	マロン
marrube	マルベ
marrupe	マルペ
martorell	マルトレル
martos	マルトス
marugan	マルガン
masa	マサ
masalaves	マサラベス
masamagrell	マサマグレル
masanasa	マサナサ
mascaraque	マスカラケ
masegoso	マセゴソ
maside	マシデ
masquefa	マスケファ
massanas	マサナス
matabuena	マタブエナ
matagalls	マタガルス
matalebreras	マタレブレラス
matallana	マタリャナ
matamorosa	マタモロサ
matanza	マタンサ
matapozuelos	マタポスエロス
mataro	マタロ
matarrubia	マタルビア
matedeon	マテデオン
matienzo	マティエンソ
matute	マトゥテ
mausoleo	マウソレオ
mayalde	マヤルデ
mayals	マヤルス
mayorga	マヨルガ
mazarete	マサレテ
mazaricos	マサリコス
mazarron	マサロン
mazarulleque	マサルレケ
mazateron	マサテロン
mazuecos	マスエコス
meano	メアノ
meco	メコ
mediana	メディアナ
medina	メディナ
mediña	メディニャ
medinaceli	メディナセリ
mediodia	メディオディア
mediona	メディオナ
meijaboy	メイハボイ
meira	メイラ
meis	メイス
mejorada	メホラダ
meliana	メリアナ
melida	メリダ
mellid	メリー
melon	メロン
membrilla	メンブリリャ
membrillar	メンブリリャル
membrillera	メンブリレラ
membrio	メンブリオ
menasalbas	メナサルバス
mencal	メンカル
mendavia	メンダビア
mendigorria	メンディゴリア
meneses	メネセス
mengabril	メンガブリル
mengibar	メンヒバル
mentrida	メントリダ
mequinenza	メキネンサ
mera	メラ
merida	メリダ
mesia	メシア
mesones	メソネス
mestanza	メスタンサ
miajadas	ミアハダス
miedes	ミエデス
mieras	ミエラス
mieres	ミエレス
mieza	ミエサ
miguelturra	ミグエルトゥラ
mijares	ミハレス
mijas	ミハス
milagro	ミラグロ
millana	ミリャナ
millares	ミリャレス
millena	ミレナ
minana	ミナナ
minateda	ミナテダ
minaya	ミナヤ
minglanilla	ミングラニリャ
mingorria	ミンゴリア
miño	ミニョ
mira	ミラ
mirabel	ミラベル
mirambel	ミランベル
mirandilla	ミランディリャ
miravalles	ミラバレス
miravet	ミラベト
miravete	ミラベテ
moaña	モアニャ
mocejon	モセホン
mochales	モチャレス
moclin	モクリン
moeche	モエチェ
mofrecho	モフレチョ
mogente	モヘンテ
mogon	モゴン
moguer	モグエル
mohedas	モエダス
mohorte	モオルテ
mojacar	モハカル
mojados	モハドス
mojina	モヒナ
mola	モラ
molaton	モラトン
molinaseca	モリナセカ
molinicos	モリニコス
molinos	モリノス
molledo	モレド
mollerusa	モレルサ
mollet	モレト
mollina	モリナ
mollo	モリョ
moluengo	モルエンゴ
molvizar	モルビサル
mombeltran	モンベルトラン
mombuey	モンブエイ
monachil	モナチル
monbeltran	モンベルトラン
moncada	モンカダ
moncalvo	モンカルボ
moncayo	モンカヨ
moncloa	モンクロア
moncofar	モンコファル
monda	モンダ
mondariz	モンダリス
mondejar	モンデハル
mondoñedo	モンドニェド
mondragon	モンドラゴン
monduber	モンドゥベル
monegrillo	モネグリリョ
monesterio	モネステリオ
moneva	モネバ
monfero	モンフェロ
monflorite	モンフロリテ
mongo	モンゴ
monistrol	モニストロル
monleras	モンレラス
monovar	モノバル
monreal	モンレアル
monroy	モンロイ
monroyo	モンロヨ
monsagro	モンサグロ
monserrat	モンセラト
montalban	モンタルバン
montalbanejo	モンタルバネホ
montalbo	モンタルボ
montalbos	モンタルボス
montalvos	モンタルボス
montan	モンタン
montanchez	モンタンチェス
montanyola	モンタンヨラ
montarto	モンタルト
monteagudo	モンテアグド
montearagon	モンテアラゴン
montederramo	モンテデラモ
montefrio	モンテフリオ
montejaque	モンテハケ
montejicar	モンテヒカル
montellano	モンテリャノ
montemolin	モンテモリン
monterrey	モンテレイ
monterroso	モンテロソ
monterrubio	モンテルビオ
montesa	モンテサ
montesclaros	モンテスクラロス
montiel	モンティエル
montijo	モンティホ
montilla	モンティリャ
montillana	モンティリャナ
montizon	モンティソン
montmelo	モントメロ
monton	モントン
montoro	モントロ
montras	モントラス
montroy	モントロイ
montuenga	モントゥエンガ
montuiri	モントゥイリ
monturque	モントゥルケ
monzon	モンソン
mora	モラ
moral	モラル
moraleja	モラレハ
morales	モラレス
moralina	モラリナ
moraña	モラニャ
morante	モランテ
moratalla	モラタリャ
morcillo	モルシリョ
moreda	モレダ
morell	モレル
morella	モレリャ
morentin	モレンティン
mores	モレス
morey	モレイ
moriles	モリレス
morillejo	モリレホ
morla	モルラ
moros	モロス
mos	モス
mosqueruela	モスケルエラ
mostoles	モストレス
motilla	モティリャ
motilleja	モティレハ
motos	モトス
motril	モトリル
moya	モヤ
moyuela	モユエラ
mozoncillo	モソンシリョ
muchamiel	ムチャミエル
mucientes	ムシエンテス
muel	ムエル
mugaire	ムガイレ
mugardos	ムガルドス
mugia	ムヒア
mugica	ムヒカ
muiños	ムイニョス
mula	ムラ
muñana	ムニャナ
munebrega	ムネブレガ
munera	ムネラ
mungia	ムンヒア
munico	ムニコ
muniesa	ムニエサ
munilla	ムニリャ
muñogalindo	ムニョガリンド
muñogrande	ムニョグランデ
muntadas	ムンタダス
muras	ムラス
murchante	ムルチャンテ
murcia	ムルシア
murguia	ムルグイア
muriel	ムリエル
muro	ムロ
muros	ムロス
murtas	ムルタス
murueta	ムルエタ
nacimiento	ナシミエント
nagore	ナゴレ
naharros	ナアロス
najera	ナヘラ
nambroca	ナンブロカ
naquera	ナケラ
narboneta	ナルボネタ
naron	ナロン
nava	ナバ
navacerrada	ナバセラダ
navachica	ナバチカ
navaconcejo	ナバコンセホ
navafria	ナバフリア
navahermosa	ナバエルモサ
navahondilla	ナバオンディリャ
navajas	ナバハス
naval	ナバル
navalacruz	ナバラクルス
navalagamella	ナバラガメリャ
navalcaballo	ナバルカバリョ
navalcan	ナバルカン
navaleno	ナバレノ
navalguijo	ナバルグイホ
navalilla	ナバリリャ
navalmanzano	ナバルマンサノ
navalmoral	ナバルモラル
navalmoralejo	ナバルモラレホ
navalonguilla	ナバロングイリャ
navalosa	ナバロサ
navalpino	ナバルピノ
navalsauz	ナバルサウス
navaluenga	ナバルエンガ
navardun	ナバルドゥン
navarres	ナバレス
navarrete	ナバレテ
navas	ナバス
navasa	ナバサ
navascues	ナバスクエス
navasfrias	ナバスフリアス
navata	ナバタ
navelgas	ナベルガス
naves	ナベス
navia	ナビア
nebreda	ネブレダ
neda	ネダ
negredo	ネグレド
negreira	ネグレイラ
neila	ネイラ
nerja	ネルハ
nerpio	ネルピオ
nerva	ネルバ
nestar	ネスタル
niebla	ニエブラ
nieves	ニエベス
nigran	ニグラン
niguelas	ニグエラス
nijar	ニハル
noain	ノアイン
noalejo	ノアレホ
noblejas	ノブレハス
noceda	ノセダ
noez	ノエス
nofuentes	ノフエンテス
nogales	ノガレス
nograles	ノグラレス
noguera	ノグエラ
nogueruelas	ノグエルエラス
nois	ノイス
nolay	ノライ
nombela	ノンベラ
nonaspe	ノナスペ
noreña	ノレニャ
novales	ノバレス
novallas	ノバリャス
novelda	ノベルダ
noves	ノベス
novillas	ノビリャス
noya	ノヤ
nueno	ヌエノ
nueva	ヌエバ
nules	ヌレス
nulles	ヌレス
numancia	ヌマンシア
nuñomoral	ヌニョモラル
obon	オボン
ocaña	オカニャ
ocejon	オセホン
ocentejo	オセンテホ
ochagavia	オチャガビア
ochandiano	オチャンディアノ
oden	オデン
odon	オドン
ohanes	オアネス
oímbra	オインブラ
ojen	オヘン
ojos	オホス
olalla	オラリャ
olave	オラベ
olazagutia	オラサグティア
olba	オルバ
oleiros	オレイロス
oliana	オリアナ
olias	オリアス
oliete	オリエテ
oliola	オリオラ
olite	オリテ
oliva	オリバ
olivares	オリバレス
olivella	オリベリャ
olivenza	オリベンサ
olleria	オレリア
ollo	オリョ
olmedillas	オルメディリャス
olmedo	オルメド
olmillos	オルミリョス
olocau	オロカウ
olombrada	オロンブラダ
olost	オロスト
olot	オロト
olvan	オルバン
olvega	オルベガ
olvena	オルベナ
olvera	オルベラ
olza	オルサ
oña	オニャ
oñate	オニャテ
oncala	オンカラ
onda	オンダ
ondara	オンダラ
ondarroa	オンダロア
onis	オニス
ontaneda	オンタネダ
onteniente	オンテニエンテ
ontur	オントゥル
onzonilla	オンソニリャ
oquillas	オキリャス
orbara	オルバラ
orce	オルセ
orcera	オルセラ
orcheta	オルチェタ
orduña	オルドゥニャ
orea	オレア
orejo	オレホ
orense	オレンセ
ores	オレス
orgaña	オルガニャ
orgaz	オルガス
orgiva	オルヒバ
oria	オリア
orihuela	オリウエラ
orio	オリオ
oris	オリス
orista	オリスタ
orle	オルレ
orol	オロル
oropesa	オロペサ
oroso	オロソ
orozco	オロスコ
orrios	オリオス
orrius	オリウス
orusco	オルスコ
osera	オセラ
osor	オソル
osorno	オソルノ
ostiz	オスティス
osuna	オスナ
oteiza	オテイサ
oteo	オテオ
otero	オテロ
otivar	オティバル
otura	オトゥラ
oural	オウラル
outes	オウテス
ouviaño	オウビアニョ
ovejo	オベホ
oviedo	オビエド
oya	オヤ
oyarzun	オヤルスン
oyon	オヨン
ozaeta	オサエタ
padron	パドロン
padul	パドゥル
paguera	パグエラ
pajares	パハレス
pajaron	パハロン
pajaroncillo	パハロンシリョ
palafrugell	パラフルヘル
palamos	パラモス
palancas	パランカス
palanques	パランケス
palanquinos	パランキノス
palencia	パレンシア
palenciana	パレンシアナ
palentino	パレンティノ
palenzuela	パレンスエラ
pallares	パリャレス
pallars	パリャルス
palleja	パレハ
pallerols	パレロルス
palma	パルマ
palo	パロ
palomas	パロマス
palomeque	パロメケ
palomera	パロメラ
pals	パルス
pampliega	パンプリエガ
pamplona	パンプロナ
pancorbo	パンコルボ
pancrudo	パンクルド
panes	パネス
paniza	パニサ
panticosa	パンティコサ
pantoja	パントハ
panton	パントン
paones	パオネス
papeles	パペレス
paracuellos	パラクエリョス
paradas	パラダス
paradaseca	パラダセカ
paradela	パラデラ
paramo	パラモ
parauta	パラウタ
parcent	パルセント
pardilla	パルディリャ
paredes	パレデス
pareja	パレハ
parets	パレツ
parga	パルガ
parla	パルラ
parlaba	パルラバ
parres	パレス
parrillas	パリリャス
partaloa	パルタロア
parzan	パルサン
pasajes	パサヘス
pasaron	パサロン
pastoriza	パストリサ
pastrana	パストラナ
pauls	パウルス
pavias	パビアス
paymogo	パイモゴ
pechina	ペチナ
pedralba	ペドラルバ
pedralbes	ペドラルベス
pedreguer	ペドレグエル
pedrera	ペドレラ
pedroche	ペドロチェ
pedrola	ペドロラ
pedroso	ペドロソ
pedrouzos	ペドロウソス
pegalajar	ペガラハル
pego	ペゴ
pelahustan	ペラウスタン
peleagonzalo	ペレアゴンサロ
pelegrina	ペレグリナ
peloche	ペロチェ
peñacerrada	ペニャセラダ
peñafiel	ペニャフィエル
peñaflor	ペニャフロル
peñagolosa	ペニャゴロサ
penagos	ペナゴス
peñalba	ペニャルバ
peñalen	ペニャレン
peñarrubia	ペニャルビア
peñascosa	ペニャスコサ
peñausende	ペニャウセンデ
peniscola	ペニスコラ
pepino	ペピノ
peracense	ペラセンセ
perafita	ペラフィタ
peral	ペラル
peralejos	ペラレホス
peralta	ペラルタ
peraltilla	ペラルティリャ
peralveche	ペラルベチェ
peramola	ペラモラ
peranzanes	ペランサネス
peratallada	ペラタリャダ
perdiguera	ペルディグエラ
perelada	ペレラダ
perello	ペレリョ
pereña	ペレニャ
pereruela	ペレルエラ
periana	ペリアナ
perorrubio	ペロルビオ
pertusa	ペルトゥサ
perves	ペルベス
pesaguero	ペサグエロ
pescueza	ペスクエサ
pesquera	ペスケラ
pesues	ペスエス
petin	ペティン
pias	ピアス
picacho	ピカチョ
picasent	ピカセント
picon	ピコン
picorro	ピコロ
piedrabuena	ピエドラブエナ
piedrafita	ピエドラフィタ
piedrahita	ピエドライタ
piera	ピエラ
pilas	ピラス
piloña	ピロニャ
pina	ピナ
pinar	ピナル
pinarejo	ピナレホ
pinarejos	ピナレホス
pineda	ピネダ
pinet	ピネト
pinillos	ピニリョス
pinofranqueado	ピノフランケアド
piñor	ピニョル
pinos	ピノス
pinoso	ピノソ
pintano	ピンタノ
pipaon	ピパオン
piqueras	ピケラス
pira	ピラ
pitillas	ピティリャス
pizarra	ピサラ
pizarral	ピサラル
plan	プラン
planes	プラネス
plasencia	プラセンシア
plasenzuela	プラセンスエラ
plencia	プレンシア
pliego	プリエゴ
plou	プロウ
pobes	ポベス
poblete	ポブレテ
poboleda	ポボレダ
pol	ポル
polanco	ポランコ
polenino	ポレニノ
polentinos	ポレンティノス
polientes	ポリエンテス
pollensa	ポレンサ
pollos	ポリョス
polopos	ポロポス
pomar	ポマル
pomer	ポメル
ponferrada	ポンフェラダ
ponga	ポンガ
pons	ポンス
pontevedra	ポンテベドラ
pontones	ポントネス
pontons	ポントンス
ponzano	ポンサノ
porcuna	ポルクナ
porquera	ポルケラ
porrera	ポレラ
porreras	ポレラス
porriño	ポリニョ
porron	ポロン
portaje	ポルタヘ
porto	ポルト
porzuna	ポルスナ
posada	ポサダ
posadas	ポサダス
posadilla	ポサディリャ
potes	ポテス
povedilla	ポベディリャ
poyales	ポヤレス
poyatos	ポヤトス
poyo	ポヨ
poyos	ポヨス
pozaldez	ポサルデス
pozoantiguo	ポソアンティグオ
pozohondo	ポソオンド
pozondon	ポソンドン
pozorrubio	ポソルビオ
pozoseco	ポソセコ
pozuelo	ポスエロ
pradairo	プラダイロ
pradales	プラダレス
pradejon	プラデホン
pradena	プラデナ
prades	プラデス
pradillo	プラディリョ
prado	プラド
pradoluengo	プラドルエンゴ
pratdip	プラトディプ
pravia	プラビア
preixens	プレイクセンス
prejano	プレハノ
priego	プリエゴ
prioro	プリオロ
proaza	プロアサ
progalo	プロガロ
pruna	プルナ
puenteareas	プエンテアレアス
puentedeume	プエンテデウメ
puentenansa	プエンテナンサ
puenteviesgo	プエンテビエスゴ
pueyo	プエヨ
pujerra	プヘラ
pulgar	プルガル
pulpi	プルピ
pungin	プンヒン
purchena	プルチェナ
purujosa	プルホサ
purullena	プルレナ
puzol	プソル
quart	クアルト
quel	ケル
quemada	ケマダ
quero	ケロ
quesa	ケサ
quesada	ケサダ
quintanapalla	キンタナパリャ
quintanavides	キンタナビデス
quintanilla	キンタニリャ
quintela	キンテラ
quinto	キント
quiroga	キロガ
quiros	キロス
quisicedo	キシセド
quismondo	キスモンド
rabade	ラバデ
rabanales	ラバナレス
rabasa	ラバサ
rabo	ラボ
radona	ラドナ
rafales	ラファレス
ragama	ラガマ
ragol	ラゴル
rajadell	ラハデル
ramacastañas	ラマカスタニャス
ramallosa	ラマリョサ
rascafria	ラスカフリア
rasines	ラシネス
raso	ラソ
rasquera	ラスケラ
rasueros	ラスエロス
reales	レアレス
rebalsadores	レバルサドレス
rebollera	レボレラ
rebollo	レボリョ
recas	レカス
redona	レドナ
redondela	レドンデラ
regenjo	レヘンホ
reillo	レイリョ
reina	レイナ
reinosa	レイノサ
relleu	レレウ
rellinas	レリナス
rena	レナ
renales	レナレス
renedo	レネド
renera	レネラ
rengos	レンゴス
renteria	レンテリア
reocin	レオシン
requejo	レケホ
requena	レケナ
resoba	レソバ
respaldiza	レスパルディサ
restiello	レスティエリョ
retamal	レタマル
retamosa	レタモサ
retiendas	レティエンダス
reus	レウス
revillarruz	レビリャルス
revolcadores	レボルカドレス
riahuelas	リアウエラス
rialp	リアルプ
rianjo	リアンホ
riaño	リアニョ
riaza	リアサ
ribadavia	リバダビア
ribadeo	リバデオ
ribadesella	リバデセリャ
ribadumia	リバドゥミア
ribaforada	リバフォラダ
ribafrecha	リバフレチャ
ribarredonda	リバレドンダ
ribatajada	リバタハダ
ribesalbes	リベサルベス
ribota	リボタ
ricla	リクラ
ricobayo	リコバヨ
ricote	リコテ
riello	リエリョ
rielves	リエルベス
riglos	リグロス
rigoitia	リゴイティア
rilla	リリャ
riner	リネル
rio	リオ
riobarba	リオバルバ
riocabado	リオカバド
riocaldo	リオカルド
riodeva	リオデバ
riofrio	リオフリオ
riogordo	リオゴルド
rioja	リオハ
riolobos	リオロボス
riopar	リオパル
rios	リオス
riosa	リオサ
riotorto	リオトルト
ripoll	リポル
ripollet	リポレト
risco	リスコ
riudarenas	リウダレナス
riudaura	リウダウラ
riudecanas	リウデカナス
riudecols	リウデコルス
riudoms	リウドンス
riveira	リベイラ
rivero	リベロ
roa	ロア
roales	ロアレス
robleda	ロブレダ
robledo	ロブレド
robledollano	ロブレドリャノ
robres	ロブレス
rocallaura	ロカリャウラ
rociana	ロシアナ
rodana	ロダナ
rodeiro	ロデイロ
rodellar	ロデリャル
rodenas	ロデナス
rodiezmo	ロディエスモ
rodoña	ロドニャ
rodos	ロドス
rois	ロイス
rojales	ロハレス
rollan	ロリャン
romanones	ロマノネス
roncal	ロンカル
roncesvalles	ロンセスバレス
ronda	ロンダ
roquetas	ロケタス
rosal	ロサル
rosas	ロサス
rosell	ロセル
rota	ロタ
rotova	ロトバ
royuela	ロユエラ
ruanes	ルアネス
rubena	ルベナ
rubi	ルビ
rubiales	ルビアレス
rubian	ルビアン
rubiana	ルビアナ
rubio	ルビオ
rubite	ルビテ
rudilla	ルディリャ
rueda	ルエダ
ruesta	ルエスタ
ruguilla	ルグイリャ
ruidera	ルイデラ
rupia	ルピア
rus	ルス
rute	ルテ
sabadell	サバデル
sabero	サベロ
sabiñánigo	サビニャニゴ
sabiote	サビオテ
sacañet	サカニェト
sacedon	サセドン
sacedoncillo	サセドンシリョ
saceruela	サセルエラ
sacramenia	サクラメニア
sada	サダ
sadaba	サダバ
saelices	サエリセス
sagaro	サガロ
sagides	サヒデス
sagra	サグラ
sagunto	サグント
sahagun	サアグン
salada	サラダ
salamanca	サラマンカ
salamon	サラモン
salar	サラル
salardu	サラルドゥ
salas	サラス
salce	サルセ
salcedo	サルセド
saldaña	サルダニャ
saldon	サルドン
salduero	サルドゥエロ
salinas	サリナス
salinas	サリナス
sallent	サレント
salmeron	サルメロン
salmoral	サルモラル
salobral	サロブラル
salobre	サロブレ
salobrena	サロブレナ
salomo	サロモ
salorino	サロリノ
salou	サロウ
salsadella	サルサデリャ
salt	サルト
salvacañete	サルバカニェテ
salvatierra	サルバティエラ
samboal	サンボアル
samos	サモス
sampedor	サンペドル
samper	サンペル
sanabria	サナブリア
sanahuja	サナウハ
sancedo	サンセド
sanchidrian	サンチドリアン
sanchonuño	サンチョヌニョ
sandianes	サンディアネス
sando	サンド
sangenjo	サンヘンホ
sangüesa	サングエサ
sansol	サンソル
santacara	サンタカラ
santaella	サンタエリャ
santany	サンタニ
santibañez	サンティバニェス
santillana	サンティリャナ
santiso	サンティソ
santiuste	サンティウステ
santiz	サンティス
santolea	サントレア
santomera	サントメラ
santoña	サントニャ
santovenia	サントベニア
santucri	サントゥクリ
santurce	サントゥルセ
santurde	サントゥルデ
sanzoles	サンソレス
sapeira	サペイラ
saragossa	サラゴサ
sariego	サリエゴ
sariñena	サリニェナ
sarratella	サラテリャ
sarreal	サレアル
sarreaus	サレアウス
sarria	サリア
sarrion	サリオン
sarroca	サロカ
sarvise	サルビセ
sasamon	ササモン
sasdonigas	サスドニガス
sastago	サスタゴ
sauca	サウカ
saucedilla	サウセディリャ
saucelle	サウセレ
saviñan	サビニャン
saviñao	サビニャオ
sax	サクス
sayaton	サヤトン
sebulcor	セブルコル
secorun	セコルン
sedano	セダノ
sedella	セデリャ
segorbe	セゴルベ
segurilla	セグリリャ
selaya	セラヤ
selgua	セルグア
sella	セリャ
sellano	セリャノ
selva	セルバ
semillas	セミリャス
sena	セナ
senes	セネス
senmanat	センマナト
senra	センラ
senterada	センテラダ
sepulveda	セプルベダ
sequeros	セケロス
serantes	セランテス
seriña	セリニャ
seron	セロン
seros	セロス
serra	セラ
serrada	セラダ
serradero	セラデロ
serradilla	セラディリャ
serranillos	セラニリョス
serrateix	セラテイクス
serrejon	セレホン
sesa	セサ
seseña	セセニャ
sesma	セスマ
sestao	セスタオ
sestrica	セストリカ
setcases	セトカセス
setenil	セテニル
setiles	セティレス
seva	セバ
sevilla	セビリャ
seville	セビレ
sierro	シエロ
sietamo	シエタモ
sigüenza	シグエンサ
sigüés	シグエス
siles	シレス
silla	シリャ
silleda	シレダ
sils	シルス
simancas	シマンカス
sineu	シネウ
sinlabajos	シンラバホス
sipan	シパン
siruela	シルエラ
sisamon	シサモン
sisante	シサンテ
sober	ソベル
sobradillo	ソブラディリョ
sobrado	ソブラド
sobrelapeña	ソブレラペニャ
sobrescobio	ソブレスコビオ
socobos	ソコボス
socuellamos	ソクエリャモス
sodupe	ソドゥペ
solares	ソラレス
solera	ソレラ
solivella	ソリベリャ
sollana	ソリャナ
soller	ソレル
solosancho	ソロサンチョ
solsona	ソルソナ
somio	ソミオ
somolinos	ソモリノス
somontano	ソモンタノ
somontin	ソモンティン
somosierra	ソモシエラ
somozas	ソモサス
soncillo	ソンシリョ
sondica	ソンディカ
soneja	ソネハ
sopeira	ソペイラ
sorbas	ソルバス
soria	ソリア
sorihuela	ソリウエラ
sorlada	ソルラダ
sorpe	ソルペ
sorribes	ソリベス
sort	ソルト
sorzano	ソルサノ
soses	ソセス
sotes	ソテス
sotiello	ソティエリョ
sotodosos	ソトドソス
sotomayor	ソトマヨル
sotopalacios	ソトパラシオス
sotos	ソトス
sotoserrano	ソトセラノ
sotresgudo	ソトレスグド
sotuelamos	ソトゥエラモス
suances	スアンセス
subijana	スビハナ
subirana	スビラナ
sucina	スシナ
sudanell	スダネル
sueca	スエカ
sumbilla	スンビリャ
suria	スリア
tabara	タバラ
taberno	タベルノ
taboada	タボアダ
taboadela	タボアデラ
tabuenca	タブエンカ
tafalla	タファリャ
tahal	タアル
tahus	タウス
tal	タル
talamantes	タラマンテス
talarrubias	タラルビアス
talavan	タラバン
talayon	タラヨン
talayuela	タラユエラ
talayuelas	タラユエラス
talayuelo	タラユエロ
taliga	タリガ
talladell	タリャデル
tallante	タリャンテ
tamajon	タマホン
tamame	タマメ
tamames	タマメス
tamariu	タマリウ
tambre	タンブレ
tamurejo	タムレホ
tapioles	タピオレス
taracena	タラセナ
taradell	タラデル
taramundi	タラムンディ
tarancon	タランコン
taravilla	タラビリャ
tarazona	タラソナ
tarbena	タルベナ
tardajos	タルダホス
tardelcuende	タルデルクエンデ
tardienta	タルディエンタ
tarifa	タリファ
tarija	タリハ
tarna	タルナ
tarragona	タラゴナ
tarrasa	タラサ
tarrega	タレガ
tarrio	タリオ
tarroja	タロハ
tarros	タロス
tauste	タウステ
tavaruela	タバルエラ
tazones	タソネス
teba	テバ
tebar	テバル
tejadillos	テハディリョス
tejares	テハレス
tejeiro	テヘイロ
tejera	テヘラ
tembleque	テンブレケ
tempul	テンプル
tendilla	テンディリャ
tenebron	テネブロン
teo	テオ
termens	テルメンス
termino	テルミノ
terminon	テルミノン
terradas	テラダス
terriente	テリエンテ
terrinches	テリンチェス
terroba	テロバ
teruel	テルエル
teulada	テウラダ
teverga	テベルガ
tiana	ティアナ
tibi	ティビ
tibidabo	ティビダボ
tiebas	ティエバス
tiedra	ティエドラ
tielve	ティエルベ
tierga	ティエルガ
tiermas	ティエルマス
tierzo	ティエルソ
tiesa	ティエサ
tijola	ティホラ
tinajas	ティナハス
tineo	ティネオ
tiñosillos	ティニョシリョス
tirgo	ティルゴ
tirig	ティリグ
tirteafuera	ティルテアフエラ
titaguas	ティタグアス
tiurana	ティウラナ
tivenys	ティベニス
tivisa	ティビサ
tobarra	トバラ
tobia	トビア
tocina	トシナ
todellego	トデレゴ
todolella	トドレリャ
toledo	トレド
tolocirio	トロシリオ
tolosa	トロサ
tolox	トロクス
tolva	トルバ
tomelloso	トメリョソ
tomiño	トミニョ
tona	トナ
topares	トパレス
toques	トケス
tor	トル
tora	トラ
toras	トラス
tordehumos	トルデウモス
tordera	トルデラ
tordomar	トルドマル
tordoya	トルドヤ
torello	トレリョ
toreno	トレノ
torija	トリハ
toril	トリル
torla	トルラ
tormon	トルモン
tornavacas	トルナバカス
toro	トロ
torquemada	トルケマダ
torralba	トラルバ
torreadrada	トレアドラダ
torrebeleña	トレベレニャ
torrebeses	トレベセス
torrecaballeros	トレカバレロス
torrecampo	トレカンポ
torrecilla	トレシリャ
torredembarra	トレデンバラ
torredonjimeno	トレドンヒメノ
torrefarrera	トレファレラ
torregrosa	トレグロサ
torreiglesias	トレイグレシアス
torrejoncillo	トレホンシリョ
torrelaguna	トレラグナ
torrelapaja	トレラパハ
torrelavega	トレラベガ
torrellano	トレリャノ
torrellas	トレリャス
torrelobaton	トレロバトン
torrelodones	トレロドネス
torremanzanas	トレマンサナス
torremayor	トレマヨル
torremegia	トレメヒア
torremocha	トレモチャ
torremolinos	トレモリノス
torremontalbo	トレモンタルボ
torrente	トレンテ
torrenueva	トレヌエバ
torreorgaz	トレオルガス
torreperogil	トレペロヒル
torrequebradilla	トレケブラディリャ
torrequemada	トレケマダ
torres	トレス
torresandino	トレサンディノ
torresmenudas	トレスメヌダス
torrevelilla	トレベリリャ
torrevieja	トレビエハ
torrijas	トリハス
torrijo	トリホ
torrijos	トリホス
torronteras	トロンテラス
torrox	トロクス
tortajada	トルタハダ
tortella	トルテリャ
tortola	トルトラ
tortonda	トルトンダ
tortuera	トルトゥエラ
tortuero	トルトゥエロ
torviscon	トルビスコン
torviscoso	トルビスコソ
tosas	トサス
totana	トタナ
totanes	トタネス
touro	トウロ
tous	トウス
trabada	トラバダ
trabadelo	トラバデロ
trabanca	トラバンカ
trabazos	トラバソス
tragacete	トラガセテ
traiguera	トライグエラ
tramacastilla	トラマカスティリャ
trasierra	トラシエラ
traslavina	トラスラビナ
trasmiras	トラスミラス
trasobares	トラソバレス
traspinedo	トラスピネド
trazo	トラソ
trebujena	トレブヘナ
tredos	トレドス
tremp	トレンプ
tresjuncos	トレスフンコス
treto	トレト
trevelez	トレベレス
treviana	トレビアナ
trevias	トレビアス
treviño	トレビニョ
triacastela	トリアカステラ
trigueros	トリグエロス
trillo	トリリョ
triollo	トリオリョ
triste	トリステ
troncedo	トロンセド
tronchon	トロンチョン
trubia	トルビア
truchas	トルチャス
truchillas	トルチリャス
trujillanos	トルヒリャノス
trujillo	トルヒリョ
trujillos	トルヒリョス
tudanca	トゥダンカ
tudela	トゥデラ
tuejar	トゥエハル
tulebras	トゥレブラス
turcia	トゥルシア
turegano	トゥレガノ
turis	トゥリス
turleque	トゥルレケ
turon	トゥロン
turre	トゥレ
turrillas	トゥリリャス
turruncun	トゥルンクン
tuy	トゥイ
ubeda	ウベダ
ubidea	ウビデア
ubrique	ウブリケ
uceda	ウセダ
ucero	ウセロ
udias	ウディアス
ugijar	ウヒハル
ujo	ウホ
ujue	ウフエ
ulea	ウレア
ulldecona	ウルデコナ
ulldemolins	ウルデモリンス
umbrete	ウンブレテ
uña	ウニャ
uncastillo	ウンカスティリョ
unquera	ウンケラ
unzue	ウンスエ
urbies	ウルビエス
urda	ウルダ
urracal	ウラカル
urries	ウリエス
urroz	ウロス
urueña	ウルエニャ
urueñas	ウルエニャス
usagre	ウサグレ
used	ウセー
useras	ウセラス
utebo	ウテボ
utiel	ウティエル
utrera	ウトレラ
utrillas	ウトリリャス
uztarroz	ウスタロス
vadocondes	バドコンデス
vadollano	バドリャノ
valacloche	バラクロチェ
valcavadillo	バルカバディリョ
valdaracete	バルダラセテ
valdarachas	バルダラチャス
valdeajos	バルデアホス
valdeavero	バルデアベロ
valdeaveruelo	バルデアベルエロ
valdecaballeros	バルデカバレロス
valdecabras	バルデカブラス
valdecarros	バルデカロス
valdecebollas	バルデセボリャス
valdecebro	バルデセブロ
valdeconcha	バルデコンチャ
valdeconejos	バルデコネホス
valdecuenca	バルデクエンカ
valdedios	バルデディオス
valdefresno	バルデフレスノ
valdefuentes	バルデフエンテス
valdegamas	バルデガマス
valdeganga	バルデガンガ
valdegovia	バルデゴビア
valdehijaderos	バルデイハデロス
valdelagua	バルデラグア
valdelaguna	バルデラグナ
valdelcubo	バルデルクボ
valdelinares	バルデリナレス
valdelosa	バルデロサ
valdelugueros	バルデルグエロス
valdemaluque	バルデマルケ
valdemorillo	バルデモリリョ
valdemoro	バルデモロ
valdenoceda	バルデノセダ
valdenoches	バルデノチェス
valdeobispo	バルデオビスポ
valdeolivas	バルデオリバス
valdeorras	バルデオラス
valdepeñas	バルデペニャス
valdepielago	バルデピエラゴ
valdepolo	バルデポロ
valdeprados	バルデプラドス
valderas	バルデラス
valderrey	バルデレイ
valderrobres	バルデロブレス
valdesamario	バルデサマリオ
valdesaz	バルデサス
valdespina	バルデスピナ
valdespino	バルデスピノ
valdestillas	バルデスティリャス
valdeteja	バルデテハ
valdetorres	バルデトレス
valdevimbre	バルデビンブレ
valdezarza	バルデサルサ
valdihuelo	バルディウエロ
valdilecha	バルディレチャ
valdoviño	バルドビニョ
valdunquillo	バルドゥンキリョ
valencia	バレンシア
valenzuela	バレンスエラ
valeria	バレリア
valga	バルガ
valjunquera	バルフンケラ
vallada	バリャダ
valladolises	バリャドリセス
vallanca	バリャンカ
vallbona	バルボナ
valldemosa	バルデモサ
valle	バレ
vallecas	バレカス
vallelado	バレラド
vallfogona	バルフォゴナ
vallibona	バリボナ
vallirana	バリラナ
vallmoll	バルモル
vallromanas	バルロマナス
valls	バルス
valmala	バルマラ
valmaseda	バルマセダ
valmojado	バルモハド
valnera	バルネラ
valor	バロル
valronquillo	バルロンキリョ
valseca	バルセカ
valsequillo	バルセキリョ
valtajeros	バルタヘロス
vandellos	バンデリョス
vañes	バニェス
vascongadas	バスコンガダス
vecinos	ベシノス
vedra	ベドラ
vegadeo	ベガデオ
vegamian	ベガミアン
veganzones	ベガンソネス
vegapagar	ベガパガル
vegaquemada	ベガケマダ
vegarienza	ベガリエンサ
velada	ベラダ
velascalvaro	ベラスカルバロ
velefique	ベレフィケ
velilla	ベリリャ
vellisca	ベリスカ
vendrell	ベンドレル
venialbo	ベニアルボ
ventas	ベンタス
ventillas	ベンティリャス
venturada	ベントゥラダ
vera	ベラ
verdu	ベルドゥ
verea	ベレア
veredas	ベレダス
vergara	ベルガラ
vergel	ベルヘル
verges	ベルヘス
verin	ベリン
vezdemarban	ベスデマルバン
viacamp	ビアカンプ
viana	ビアナ
vianos	ビアノス
viascon	ビアスコン
viator	ビアトル
vicalvaro	ビカルバロ
vicar	ビカル
vicien	ビシエン
vicolozano	ビコロサノ
vidangoz	ビダンゴス
vidiago	ビディアゴ
vidreras	ビドレラス
viella	ビエリャ
viguera	ビグエラ
vilabella	ビラベリャ
vilaboa	ビラボア
vilada	ビラダ
vilademat	ビラデマト
vilademuls	ビラデムルス
viladrau	ビラドラウ
vilagrasa	ビラグラサ
vilaller	ビラレル
vilanova	ビラノバ
vilaplana	ビラプラナ
vilapouca	ビラポウカ
vilarrodona	ビラロドナ
vilaseca	ビラセカ
vilatan	ビラタン
vilches	ビルチェス
villabona	ビリャボナ
villacañas	ビリャカニャス
villacarriedo	ビリャカリエド
villacarrillo	ビリャカリリョ
villacastin	ビリャカスティン
villaconejos	ビリャコネホス
villada	ビリャダ
villadecanes	ビリャデカネス
villadepera	ビリャデペラ
villadiego	ビリャディエゴ
villaescusa	ビリャエスクサ
villafames	ビリャファメス
villaflores	ビリャフロレス
villafranca	ビリャフランカ
villafranqueza	ビリャフランケサ
villafrechos	ビリャフレチョス
villafruela	ビリャフルエラ
villagaton	ビリャガトン
villager	ビリャヘル
villagonzalo	ビリャゴンサロ
villahermosa	ビリャエルモサ
villahoz	ビリャオス
villajoyosa	ビリャホヨサ
villalba	ビリャルバ
villalengua	ビリャレングア
villalmanzo	ビリャルマンソ
villalonga	ビリャロンガ
villalpando	ビリャルパンド
villalube	ビリャルベ
villaluenga	ビリャルエンガ
villalumbroso	ビリャルンブロソ
villalvaro	ビリャルバロ
villamalea	ビリャマレア
villamalur	ビリャマルル
villamañan	ビリャマニャン
villamandos	ビリャマンドス
villamanrique	ビリャマンリケ
villamanta	ビリャマンタ
villamantilla	ビリャマンティリャ
villamarin	ビリャマリン
villamartin	ビリャマルティン
villamayor	ビリャマヨル
villamea	ビリャメア
villamediana	ビリャメディアナ
villamejil	ビリャメヒル
villamesias	ビリャメシアス
villamizar	ビリャミサル
villamol	ビリャモル
villamuelas	ビリャムエラス
villanúa	ビリャヌア
villanubla	ビリャヌブラ
villanueva	ビリャヌエバ
villaobispo	ビリャオビスポ
villapalacios	ビリャパラシオス
villaquejida	ビリャケヒダ
villaquilambre	ビリャキランブレ
villaralbo	ビリャラルボ
villaralto	ビリャラルト
villarejo	ビリャレホ
villarente	ビリャレンテ
villaricos	ビリャリコス
villarino	ビリャリノ
villarrabe	ビリャラベ
villarramiel	ビリャラミエル
villarrasa	ビリャラサ
villarreal	ビリャレアル
villarrobledo	ビリャロブレド
villarrodrigo	ビリャロドリゴ
villarroya	ビリャロヤ
villarrubia	ビリャルビア
villarrubio	ビリャルビオ
villasabariego	ビリャサバリエゴ
villasandino	ビリャサンディノ
villasante	ビリャサンテ
villasarracino	ビリャサラシノ
villasayas	ビリャサヤス
villaseca	ビリャセカ
villaselan	ビリャセラン
villasilos	ビリャシロス
villasrubias	ビリャスルビアス
villastar	ビリャスタル
villatobas	ビリャトバス
villatoro	ビリャトロ
villatoya	ビリャトヤ
villaturiel	ビリャトゥリエル
villava	ビリャバ
villavaquerin	ビリャバケリン
villavendimio	ビリャベンディミオ
villaviciosa	ビリャビシオサ
villaviudas	ビリャビウダス
villayon	ビリャヨン
villaza	ビリャサ
villegas	ビレガス
villel	ビレル
villena	ビレナ
villerias	ビレリアス
villodrigo	ビリョドリゴ
villoldo	ビリョルド
villora	ビリョラ
villores	ビリョレス
villoria	ビリョリア
vilvestre	ビルベストレ
vimianzo	ビミアンソ
vinaceite	ビナセイテ
vinaroz	ビナロス
vindel	ビンデル
vinebre	ビネブレ
viñuela	ビニュエラ
viñuelas	ビニュエラス
vinuesa	ビヌエサ
viruela	ビルエラ
visaurin	ビサウリン
visiedo	ビシエド
vitigudino	ビティグディノ
viver	ビベル
vivero	ビベロ
viveros	ビベロス
vizcaínos	ビスカイノス
vizmanos	ビスマノス
yanguas	ヤングアス
yatova	ヤトバ
yebes	イェベス
yebra	イェブラ
yecla	イェクラ
yegen	イェヘン
yela	イェラ
yepes	イェペス
yerga	イェルガ
yesa	イェサ
yeste	イェステ
yuncler	ユンクレル
yuncos	ユンコス
yunquera	ユンケラ
zafarraya	サファラヤ
zagra	サグラ
zahara	サアラ
zahinos	サイノス
zaidin	サイディン
zalla	サリャ
zamarramala	サマラマラ
zamayon	サマヨン
zambra	サンブラ
zambrana	サンブラナ
zamora	サモラ
zaorejas	サオレハス
zaragoza	サラゴサ
zaratan	サラタン
zarauz	サラウス
zarra	サラ
zarzalejo	サルサレホ
zas	サス
zizur	シスル
zorita	ソリタ
zubia	スビア
zubieta	スビエタ
zubiri	スビリ
zucaina	スカイナ
zudaire	スダイレ
zuera	スエラ
zuheros	スエロス
zujar	スハル
zumarraga	スマラガ
zumaya	スマヤ
zuniga	スニガ
zurgena	スルヘナ
zurzarren	スルサレン
