bee	peː
tʼáá	tʼɑ́ː
dóó	tóː
doo	toː
éí	éɪ́
Góneʼ	kóneʔ
Yisdzohígíí	jɪst͡sohɪ́kɪ́ː
áádóó	ɑ́ːtóː
Biyiʼ	pɪjɪʔ
yee	jeː
díí	tɪ́ː
há	hɑ́
kéyah	k͡xéjɑh
ajiłtsoh	ɑt͡ʃɪɬt͡sʰoh
diné	tɪné
baa	pɑː
bá	pɑ́
da	tɑ
ashdlaʼii	ɑʃtˡɑʔɪː
Naadiin	nɑːtɪːn
bílaʼ	pɪ́lɑʔ
dooleeł	toːleːɬ
naanish	nɑːnɪʃ
aheełtʼéego	ɑheːɬtʼéeko
bił	pɪɬ
dah	tɑh
doodaiiʼ	toːtɑɪːʔ
háhazʼą́	hɑ́hɑzʔɑ̃́
Hazʼaah	hɑzʔɑːh
Kótʼéego	k͡xótʼéeko
ájíłtsoh	ɑ́t͡ʃɪ́ɬt͡sʰoh
hó	hó
łaʼ	ɬɑʔ
tʼáadoo	tʼɑ́ɑtoː
yá	jɑ́
ałtsoní	ɑɬt͡sʰonɪ́
atah	ɑt͡xɑh
átʼé	ɑ́tʼé
bikʼehgo	pɪkʼehko
bilaʼ	pɪlɑʔ
iiná	ɪːnɑ́
lá	lɑ́
nahasdzáán	nɑhɑst͡sɑ́ːn
ndi	ntɪ
tʼááʼ	tʼɑ́ːʔ
ahootʼiʼ	ɑhoːtʼɪʔ
áłchíní	ɑ́ɬt͡ʃʰɪ́nɪ́
ałdóʼ	ɑɬtóʔ
átʼáo	ɑ́tʼɑ́o
binahjį́	pɪnɑht͡ʃɪ̃́
binahjįʼ	pɪnɑht͡ʃɪ̃ʔ
binahjį́ʼ	pɪnɑht͡ʃɪ̃́ʔ
biniinaa	pɪnɪːnɑː
dóoneʼé	tóoneʔé
hadeesdzih	hɑteːst͡sɪh
hazą́	hɑzɑ̃́
hazʼáanii	hɑzʔɑ́ɑnɪː
kodóó	k͡xotóː
Tsídí	t͡sʰɪ́tɪ́
tʼááhó	tʼɑ́ːhó
yaa	jɑː
aheeskéego	ɑheːsk͡xéeko
ahił	ɑhɪɬ
ahóótʼiʼ	ɑhóːtʼɪʔ
áhootʼiʼ	ɑ́hoːtʼɪʔ
ájítʼe	ɑ́t͡ʃɪ́tʼe
ájítʼé	ɑ́t͡ʃɪ́tʼé
aláahdi	ɑlɑ́ɑhtɪ
Ałchíní	ɑɬt͡ʃʰɪ́nɪ́
ałtsoh	ɑɬt͡sʰoh
ashdlaaʼii	ɑʃtˡɑːʔɪː
Ashdlaʼ	ɑʃtˡɑʔ
azhą́shį́į́	ɑʒɑ̃́ʃɪ̃́ː
bąąh	pɑ̃ːh
báhazą́	pɑ́hɑzɑ̃́
báʼ	pɑ́ʔ
bi	pɪ
bimá	pɪmɑ́
binááł	pɪnɑ́ːɬ
biniiyé	pɪnɪːjé
biniyé	pɪnɪjé
biniʼ	pɪnɪʔ
biwááshindoon	pɪwɑ́ːʃɪntoːn
bizhéʼé	pɪʒéʔé
dahólǫǫ	tɑhólõː
éíí	éɪ́ː
haahóchįʼgo	hɑːhót͡ʃʰɪ̃ʔko
hakéyah	hɑk͡xéjɑh
hazdoodzihgo	hɑztoːt͡sɪhko
hazʼánígíí	hɑzʔɑ́nɪ́kɪ́ː
haʼ	hɑʔ
héídah	héɪ́tɑh
heitʼáo	heɪtʼɑ́o
hóchįʼígíí	hót͡ʃʰɪ̃ʔɪ́kɪ́ː
hweʼiinaʼ	xʷeʔɪːnɑʔ
hweʼoodląʼígíí	xʷeʔoːtˡɑ̃ʔɪ́kɪ́ː
ílį́įgo	ɪ́lɪ̃́ɪ̃ko
ílį́į́go	ɪ́lɪ̃́ːko
jilį́į́go	t͡ʃɪlɪ̃́ːko
jílínígíí	t͡ʃɪ́lɪ́nɪ́kɪ́ː
Jó	t͡ʃó
kʼé	kʼé
kʼehgo	kʼehko
łahdóó	ɬɑhtóː
łaʼí	ɬɑʔɪ́
náánáłaʼ	nɑ́ːnɑ́ɬɑʔ
náás	nɑ́ːs
naʼníleʼdii	nɑʔnɪ́leʔtɪː
nihiwááshindoon	nɪhɪwɑ́ːʃɪntoːn
nííkʼeh	nɪ́ːkʼeh
níítʼéé	nɪ́ːtʼéː
sáanii	sɑ́ɑnɪː
sinilígíí	sɪnɪlɪ́kɪ́ː
Tseebíí	t͡sʰeːpɪ́ː
Tsíʼdí	t͡sʰɪ́ʔtɪ́
tʼáa	tʼɑ́ɑ
tʼáadooleʼé	tʼɑ́ɑtoːleʔé
yiníkʼehgo	jɪnɪ́kʼehko
aadóó	ɑːtóː
Áadóó	ɑ́ɑtóː
aahgo	ɑːhko
áájí	ɑ́ːt͡ʃɪ́
áájį́	ɑ́ːt͡ʃɪ̃́
aájítʼį́į́go	ɑɑ́t͡ʃɪ́tʼɪ̃́ːko
aanííʼ	ɑːnɪ́ːʔ
aashígíí	ɑːʃɪ́kɪ́ː
aaʼ	ɑːʔ
aaʼáháyánígíí	ɑːʔɑ́hɑ́jɑ́nɪ́kɪ́ː
aaʼáhyąągo	ɑːʔɑ́hjɑ̃ːko
ábiʼdilʼí	ɑ́pɪʔtɪlʔɪ́
achʼaah	ɑt͡ʃʼɑːh
achʼąąh	ɑt͡ʃʼɑ̃ːh
áchʼaaʼ	ɑ́t͡ʃʼɑːʔ
achʼíhjí	ɑt͡ʃʼɪ́ht͡ʃɪ́
achʼįholʼį́	ɑt͡ʃʼɪ̃holʔɪ̃́
adaanisįikéesgo	ɑtɑːnɪsɪ̃ɪk͡xéesko
ádaantsíkees	ɑ́tɑːnt͡sʰɪ́k͡xeːs
adaaʼáhojilyą́ą	ɑtɑːʔɑ́hot͡ʃɪljɑ̃́ɑ̃
ádáhadaasdzííh	ɑ́tɑ́hɑtɑːst͡sɪ́ːh
adahazłʼį	ɑtɑhɑzɬʔɪ̃
adahaztʼiʼígíí	ɑtɑhɑztʼɪʔɪ́kɪ́ː
adahaztʼíʼígíí	ɑtɑhɑztʼɪ́ʔɪ́kɪ́ː
adahnahatʼáada	ɑtɑhnɑhɑtʼɑ́ɑtɑ
adahnahojitʼáago	ɑtɑhnɑhot͡ʃɪtʼɑ́ɑko
ádahnahwiijitʼáhígíí	ɑ́tɑhnɑxʷɪːt͡ʃɪtʼɑ́hɪ́kɪ́ː
adahootʼéhígíí	ɑtɑhoːtʼéhɪ́kɪ́ː
adaʼ	ɑtɑʔ
ádaʼ	ɑ́tɑʔ
adeesdeeʼ	ɑteːsteːʔ
adę́ę́ʼ	ɑtẽ́ːʔ
adiighahágó	ɑtɪːɣɑhɑ́kó
ádííyóltąʼ	ɑ́tɪ́ːjólt͡xɑ̃ʔ
ádingo	ɑ́tɪnko
adinígíí	ɑtɪnɪ́kɪ́ː
adodzih	ɑtot͡sɪh
adoolniiłgo	ɑtoːlnɪːɬko
adoolwoł	ɑtoːlwoɬ
ádóoneʼé	ɑ́tóoneʔé
adooyehgo	ɑtoːjehko
ahaanitsáhakeesgo	ɑhɑːnɪt͡sʰɑ́hɑk͡xeːsko
ahantsiikeesda	ɑhɑnt͡sʰɪːk͡xeːstɑ
áhátʼį́	ɑ́hɑ́tʼɪ̃́
ahayą́ą́doo	ɑhɑjɑ̃́ːtoː
áháyánígíí	ɑ́hɑ́jɑ́nɪ́kɪ́ː
aheeł	ɑheːɬ
aheełtéego	ɑheːɬt͡xéeko
aheełtʼeego	ɑheːɬtʼeːko
aheeʼiikeedígíí	ɑheːʔɪːk͡xeːtɪ́kɪ́ː
ahejíłtʼé	ɑhet͡ʃɪ́ɬtʼé
áhéʼeskeh	ɑ́héʔesk͡xeh
Ahidiiʼ	ɑhɪtɪːʔ
ahidiníłnáhgo	ɑhɪtɪnɪ́ɬnɑ́hko
ahihodíneʼenah	ɑhɪhotɪ́neʔenɑh
áhoodzaa	ɑ́hoːt͡sɑː
ahootʼi	ɑhoːtʼɪ
ahootʼígíí	ɑhoːtʼɪ́kɪ́ː
ahóotʼiʼ	ɑhóotʼɪʔ
ahóótʼíʼ	ɑhóːtʼɪ́ʔ
ahóótʼiʼígíí	ɑhóːtʼɪʔɪ́kɪ́ː
áhootʼiʼígíí	ɑ́hoːtʼɪʔɪ́kɪ́ː
ahootʼįʼʼ	ɑhoːtʼɪ̃ʔʔ
áhótʼéédąąʼ	ɑ́hótʼéːtɑ̃ːʔ
ajį́dah	ɑt͡ʃɪ̃́tɑh
ájíílaago	ɑ́t͡ʃɪ́ːlɑːko
ajiitʼį́į́go	ɑt͡ʃɪːtʼɪ̃́ːko
ajiłtoh	ɑt͡ʃɪɬt͡xoh
ajiłtsho	ɑt͡ʃɪɬt͡sʰho
ajiłtsǫh	ɑt͡ʃɪɬt͡sʰõh
ájiłtsoh	ɑ́t͡ʃɪɬt͡sʰoh
ajitʼį́į́go	ɑt͡ʃɪtʼɪ̃́ːko
ájítʼį́į́go	ɑ́t͡ʃɪ́tʼɪ̃́ːko
ájósinį́	ɑ́t͡ʃósɪnɪ̃́
ákohoniidzíí	ɑ́k͡xohonɪːt͡sɪ́ː
akohwiindzingo	ɑk͡xoxʷɪːnt͡sɪnko
ákohwiinidzinígíí	ɑ́k͡xoxʷɪːnɪt͡sɪnɪ́kɪ́ː
ákohwiiniidzinígíí	ɑ́k͡xoxʷɪːnɪːt͡sɪnɪ́kɪ́ː
Ákondi	ɑ́k͡xontɪ
akonídzin	ɑk͡xonɪ́t͡sɪn
ákótʼéego	ɑ́k͡xótʼéeko
ákʼi	ɑ́kʼɪ
Ákʼihadaasdzíí	ɑ́kʼɪhɑtɑːst͡sɪ́ː
ákʼihwiizhdoodlííł	ɑ́kʼɪxʷɪːʒtoːtˡɪ́ːɬ
akʼiʼdiitą́ą́doo	ɑkʼɪʔtɪːt͡xɑ̃́ːtoː
ałąą	ɑɬɑ̃ː
áłą́ą́	ɑ́ɬɑ̃́ː
áláah	ɑ́lɑ́ɑh
alą́ą́jį́ʼ	ɑlɑ̃́ːt͡ʃɪ̃́ʔ
ałah	ɑɬɑh
áłahjįʼ	ɑ́ɬɑht͡ʃɪ̃ʔ
Áłahʼ	ɑ́ɬɑhʔ
áłchini	ɑ́ɬt͡ʃʰɪnɪ
áłchínííní	ɑ́ɬt͡ʃʰɪ́nɪ́ːnɪ́
ałdoʼ	ɑɬtoʔ
áłdoʼ	ɑ́ɬtoʔ
áłhaadootʼash	ɑ́ɬhɑːtoːtʼɑʃ
áłhiiʼ	ɑ́ɬhɪːʔ
ałhiiʼsiníłígíí	ɑɬhɪːʔsɪnɪ́ɬɪ́kɪ́ː
áłhiłdajidlį́į́go	ɑ́ɬhɪɬtɑt͡ʃɪtˡɪ̃́ːko
áłígíí	ɑ́ɬɪ́kɪ́ː
álį́į́nii	ɑ́lɪ̃́ːnɪː
álíleekʼehgo	ɑ́lɪ́leːkʼehko
alį́nígíí	ɑlɪ̃́nɪ́kɪ́ː
áłkáh	ɑ́ɬk͡xɑ́h
ałtáádoo	ɑɬt͡xɑ́ːtoː
áłtsé	ɑ́ɬt͡sʰé
ałtso	ɑɬt͡sʰo
áłtso	ɑ́ɬt͡sʰo
ałtsohjigo	ɑɬt͡sʰoht͡ʃɪko
ałtsohjįʼ	ɑɬt͡sʰoht͡ʃɪ̃ʔ
áłtsojíʼ	ɑ́ɬt͡sʰot͡ʃɪ́ʔ
áłtsoni	ɑ́ɬt͡sʰonɪ
ałtsoníbá	ɑɬt͡sʰonɪ́pɑ́
Ałtsʼą́ą́jí	ɑɬt͡sʼɑ̃́ːt͡ʃɪ́
áłtsʼąąji	ɑ́ɬt͡sʼɑ̃ːt͡ʃɪ
áłtsʼáʼítʼaashgo	ɑ́ɬt͡sʼɑ́ʔɪ́tʼɑːʃko
alyaa	ɑljɑː
ályaa	ɑ́ljɑː
ałyił	ɑɬjɪɬ
ałʼąąʼ	ɑɬʔɑ̃ːʔ
ałʼą́ąʼátʼéhégóó	ɑɬʔɑ̃́ɑ̃ʔɑ́tʼéhékóː
álʼį́į́jí	ɑ́lʔɪ̃́ːt͡ʃɪ́
Amá	ɑmɑ́
Ámá	ɑ́mɑ́
ánájahígíí	ɑ́nɑ́t͡ʃɑhɪ́kɪ́ː
ánájiʼah	ɑ́nɑ́t͡ʃɪʔɑh
anáʼáwoʼ	ɑnɑ́ʔɑ́woʔ
anaʼáwoʼdoo	ɑnɑʔɑ́woʔtoː
anaʼáwʼoʼ	ɑnɑʔɑ́wʔoʔ
anáʼáʼah	ɑnɑ́ʔɑ́ʔɑh
ánídaʼjiʼah	ɑ́nɪ́tɑʔt͡ʃɪʔɑh
áníłtsohgo	ɑ́nɪ́ɬt͡sʰohko
anoolninígíí	ɑnoːlnɪnɪ́kɪ́ː
anootįįłdoo	ɑnoːt͡xɪ̃ːɬtoː
ásdiingo	ɑ́stɪːnko
asdlaʼii	ɑstˡɑʔɪː
asdzání	ɑst͡sɑ́nɪ́
ashdlaʼiiʼ	ɑʃtˡɑʔɪːʔ
Ashdlaʼtsʼáadah	ɑʃtˡɑʔt͡sʼɑ́ɑtɑh
atahjílį́į́go	ɑt͡xɑht͡ʃɪ́lɪ̃́ːko
áté	ɑ́t͡xé
atídoolníiłda	ɑt͡xɪ́toːlnɪ́ɪɬtɑ
atihodooníiłgo	ɑt͡xɪhotoːnɪ́ɪɬko
átʼégo	ɑ́tʼéko
átʼéhą́gíí	ɑ́tʼéhɑ̃́kɪ́ː
atʼéhígíí	ɑtʼéhɪ́kɪ́ː
átʼehígíí	ɑ́tʼehɪ́kɪ́ː
átʼéhígíí	ɑ́tʼéhɪ́kɪ́ː
awáalyahji	ɑwɑ́ɑljɑht͡ʃɪ
awáalyahjí	ɑwɑ́ɑljɑht͡ʃɪ́
áyisį́	ɑ́jɪsɪ̃́
azaáshį́į́	ɑzɑɑ́ʃɪ̃́ː
azeeʼ	ɑzeːʔ
azhdoolííł	ɑʒtoːlɪ́ːɬ
azhdoołííłígíí	ɑʒtoːɬɪ́ːɬɪ́kɪ́ː
azhdoolwoł	ɑʒtoːlwoɬ
ázhdoolwoł	ɑ́ʒtoːlwoɬ
ázhéʼé	ɑ́ʒéʔé
azhoolííłgo	ɑʒoːlɪ́ːɬko
azláadooleeł	ɑzlɑ́ɑtoːleːɬ
Azlį́į́ʼígíí	ɑzlɪ̃́ːʔɪ́kɪ́ː
aʼdooníłígíí	ɑʔtoːnɪ́ɬɪ́kɪ́ː
aʼí	ɑʔɪ́
áʼłʼinígíí	ɑ́ʔɬʔɪnɪ́kɪ́ː
áʼtéedah	ɑ́ʔt͡xéetɑh
Baá	pɑɑ́
baahóchįʼ	pɑːhót͡ʃʰɪ̃ʔ
baahoochįʼgo	pɑːhoːt͡ʃʰɪ̃ʔko
baahwinitʼį́įgo	pɑːxʷɪnɪtʼɪ̃́ɪ̃ko
baanchįʼ	pɑːnt͡ʃʰɪ̃ʔ
baanitsínáhoodeeskééz	pɑːnɪt͡sʰɪ́nɑ́hoːteːsk͡xéːz
baaʼ	pɑːʔ
baʼahóótʼiʼ	pɑʔɑhóːtʼɪʔ
baʼakohwiidzin	pɑʔɑk͡xoxʷɪːt͡sɪn
baʼáłchiní	pɑʔɑ́ɬt͡ʃʰɪnɪ́
báʼatʼé	pɑ́ʔɑtʼé
be	pe
bée	pée
beebóholnííh	peːpóholnɪ́ːh
beehá	peːhɑ́
beeháhazą́	peːhɑ́hɑzɑ̃́
beeháhazʼą́	peːhɑ́hɑzʔɑ̃́
beeháhazʼąʼ	peːhɑ́hɑzʔɑ̃ʔ
Beehazą́ą	peːhɑzɑ̃́ɑ̃
béehazą́ąnígíí	péehɑzɑ̃́ɑ̃nɪ́kɪ́ː
beehazáanii	peːhɑzɑ́ɑnɪː
beehaząąnii	peːhɑzɑ̃ːnɪː
beehazą́ąnii	peːhɑzɑ̃́ɑ̃nɪː
beehazʼą́ą́nii	peːhɑzʔɑ̃́ːnɪː
beehwééhozingo	peːxʷéːhozɪnko
beehwiidooʼaał	peːxʷɪːtoːʔɑːɬ
beeiinaʼ	peːɪːnɑʔ
beełtʼeego	peːɬtʼeːko
béésh	péːʃ
béeso	péeso
beeʼ	peːʔ
beeʼaahóchįʼígíí	peːʔɑːhót͡ʃʰɪ̃ʔɪ́kɪ́ː
beeʼaká	peːʔɑk͡xɑ́
beeʼizhdidooʼgáałgo	peːʔɪʒtɪtoːʔkɑ́ɑɬko
beheehazą́ąnii	peheːhɑzɑ̃́ɑ̃nɪː
beʼoodląʼ	peʔoːtˡɑ̃ʔ
bí	pɪ́
bibeehazą́	pɪpeːhɑzɑ̃́
bibeehazáanii	pɪpeːhɑzɑ́ɑnɪː
bibehazą́ą́nii	pɪpehɑzɑ̃́ːnɪː
bichąʼ	pɪt͡ʃʰɑ̃ʔ
bichʼą́ąhgo	pɪt͡ʃʼɑ̃́ɑ̃hko
bidiljishgo	pɪtɪlt͡ʃɪʃko
bidineʼé	pɪtɪneʔé
bidizhchįh	pɪtɪʒt͡ʃʰɪ̃h
bidziildoo	pɪt͡sɪːltoː
bighah	pɪɣɑh
bighan	pɪɣɑn
biidootʼááł	pɪːtoːtʼɑ́ːɬ
bííghahgo	pɪ́ːɣɑhko
biish	pɪːʃ
biiʼ	pɪːʔ
bííʼ	pɪ́ːʔ
bijiníí	pɪt͡ʃɪnɪ́ː
bikáadoo	pɪk͡xɑ́ɑtoː
bikáagí	pɪk͡xɑ́ɑkɪ́
bikááʼ	pɪk͡xɑ́ːʔ
bikah	pɪk͡xɑh
bíkáh	pɪ́k͡xɑ́h
bíkaʼánawoʼ	pɪ́k͡xɑʔɑ́nɑwoʔ
bikʼeezhoochééłgo	pɪkʼeːʒoːt͡ʃʰéːɬko
bikʼeh	pɪkʼeh
bikʼehgoʼ	pɪkʼehkoʔ
bikʼéstiʼ	pɪkʼést͡xɪʔ
bíla	pɪ́lɑ
biláahgo	pɪlɑ́ɑhko
biłaszihgo	pɪɬɑszɪhko
biláʼ	pɪlɑ́ʔ
Bilaʼashdaʼii	pɪlɑʔɑʃtɑʔɪː
bílaʼashdlaʼii	pɪ́lɑʔɑʃtˡɑʔɪː
biłhazą́ąndi	pɪɬhɑzɑ̃́ɑ̃ntɪ
biłiisihgo	pɪɬɪːsɪhko
biłkeehojitʼį́inígíí	pɪɬk͡xeːhot͡ʃɪtʼɪ̃́ɪnɪ́kɪ́ː
biłkééhojitʼínígíí	pɪɬk͡xéːhot͡ʃɪtʼɪ́nɪ́kɪ́ː
bina	pɪnɑ
binahjiʼ	pɪnɑht͡ʃɪʔ
binahjíʼ	pɪnɑht͡ʃɪ́ʔ
binahjjįʼ	pɪnɑht͡ʃt͡ʃɪ̃ʔ
binaʼ	pɪnɑʔ
bíniikʼeh	pɪ́nɪːkʼeh
biniinaanígó	pɪnɪːnɑːnɪ́kó
biniinaanii	pɪnɪːnɑːnɪː
binizinjįʼ	pɪnɪzɪnt͡ʃɪ̃ʔ
bíniʼ	pɪ́nɪʔ
biniʼnilíidoo	pɪnɪʔnɪlɪ́ɪtoː
binyé	pɪnjé
bitah	pɪt͡xɑh
bitahgo	pɪt͡xɑhko
bitsʼąą	pɪt͡sʼɑ̃ː
bitsʼą́ą́doo	pɪt͡sʼɑ̃́ːtoː
biyiʼjį́ʼ	pɪjɪʔt͡ʃɪ̃́ʔ
bizhiʼ	pɪʒɪʔ
bizhneelą́	pɪʒneːlɑ̃́
biʼdidool	pɪʔtɪtoːl
biʼdizhchínígíí	pɪʔtɪʒt͡ʃʰɪ́nɪ́kɪ́ː
biʼdzhchínígíí	pɪʔt͡sht͡ʃʰɪ́nɪ́kɪ́ː
biʼoh	pɪʔoh
biʼóhjinéelánígíí	pɪʔóht͡ʃɪnéelɑ́nɪ́kɪ́ː
biʼyiʼdi	pɪʔjɪʔtɪ
bóhoneedzánígíí	póhoneːt͡sɑ́nɪ́kɪ́ː
bóhooʼaah	póhoːʔɑːh
cheeł	t͡ʃʰeːɬ
chiʼį́dį́	t͡ʃʰɪʔɪ̃́tɪ̃́
choidooʼį́į́ł	t͡ʃʰoɪtoːʔɪ̃́ːɬ
choiiʼ	t͡ʃʰoɪːʔ
Chʼétʼaah	t͡ʃʼétʼɑːh
chʼi	t͡ʃʼɪ
chʼiyáán	t͡ʃʼɪjɑ́ːn
dahjookahígíí	tɑht͡ʃoːk͡xɑhɪ́kɪ́ː
dahnidahaazʼą́ągo	tɑhnɪtɑhɑːzʔɑ̃́ɑ̃ko
dahsiʼánígíí	tɑhsɪʔɑ́nɪ́kɪ́ː
dajitsaah	tɑt͡ʃɪt͡sʰɑːh
dajótąʼgo	tɑt͡ʃót͡xɑ̃ʔko
dandlį́į́	tɑntˡɪ̃́ː
danilinígíí	tɑnɪlɪnɪ́kɪ́ː
dazlį́į́ʼ	tɑzlɪ̃́ːʔ
daʼahootą	tɑʔɑhoːt͡xɑ̃
daʼahótąʼígíí	tɑʔɑhót͡xɑ̃ʔɪ́kɪ́ː
daʼahótą́ʼígíí	tɑʔɑhót͡xɑ̃́ʔɪ́kɪ́ː
daʼóltaʼ	tɑʔólt͡xɑʔ
daʼołtaʼígíí	tɑʔoɬt͡xɑʔɪ́kɪ́ː
dę́ę́	tẽ́ː
deiyíłnííshígíí	teɪjɪ́ɬnɪ́ːʃɪ́kɪ́ː
Dį́į́	tɪ̃́ː
Dį́į́tsʼáadah	tɪ̃́ːt͡sʼɑ́ɑtɑh
Dííʼ	tɪ́ːʔ
díkwíjíltʼéegodah	tɪ́k͡xʷɪ́t͡ʃɪ́ltʼéekotɑh
dilyindoo	tɪljɪntoː
dilzin	tɪlzɪn
dine	tɪne
dinétahgí	tɪnét͡xɑhkɪ́
dinétahjį́	tɪnét͡xɑht͡ʃɪ̃́
Dinétahjį́	tɪnét͡xɑht͡ʃɪ̃́
dineʼé	tɪneʔé
dínóochéełgo	tɪ́nóot͡ʃʰéeɬko
dinóol	tɪnóol
doodai	toːtɑɪ
doodaiíʼ	toːtɑɪɪ́ʔ
doodaííʼ	toːtɑɪ́ːʔ
doohaadeetʼéégodah	toːhɑːteːtʼéːkotɑh
dooháida	toːhɑ́ɪtɑ
doolééł	toːléːɬ
dooleełda	toːleːɬtɑ
dooleełígíí	toːleːɬɪ́kɪ́ː
dooleʼé	toːleʔé
doolníiłgo	toːlnɪ́ɪɬko
dooltʼeełdah	toːltʼeːɬtɑh
dooneʼé	toːneʔé
dootʼááł	toːtʼɑ́ːɬ
dootʼah	toːtʼɑh
dootʼį́į́łdah	toːtʼɪ̃́ːɬtɑh
dooʼį́į́łda	toːʔɪ̃́ːɬtɑ
doʼahóótąʼígíí	toʔɑhóːt͡xɑ̃ʔɪ́kɪ́ː
éé	éː
ééʼ	éːʔ
eíí	eɪ́ː
Eíí	eɪ́ː
ęíí	ẽɪ́ː
Góné	kóné
góneʼ	kóneʔ
haa	hɑː
hąą	hɑ̃ː
háádaashzííh	hɑ́ːtɑːʃzɪ́ːh
háadidah	hɑ́ɑtɪtɑh
haahóchįʼ	hɑːhót͡ʃʰɪ̃ʔ
háájída	hɑ́ːt͡ʃɪ́tɑ
haazhdoolyįhgo	hɑːʒtoːljɪ̃hko
haazʼą́	hɑːzʔɑ̃́
haaʼ	hɑːʔ
haaʼahayą́ą	hɑːʔɑhɑjɑ̃́ɑ̃
haaʼakowhiindzingo	hɑːʔɑk͡xowhɪːnt͡sɪnko
habizhdiyooł	hɑpɪʒtɪjoːɬ
hachʼįʼ	hɑt͡ʃʼɪ̃ʔ
hachʼį́ʼ	hɑt͡ʃʼɪ̃́ʔ
hachʼįʼanáhootʼiʼ	hɑt͡ʃʼɪ̃ʔɑnɑ́hoːtʼɪʔ
hachʼįʼníʼiilyéedoo	hɑt͡ʃʼɪ̃ʔnɪ́ʔɪːljéetoː
hadahaaztʼiʼ	hɑtɑhɑːztʼɪʔ
hadidooníłíjiʼ	hɑtɪtoːnɪ́ɬɪ́t͡ʃɪʔ
hádidooʼnííł	hɑ́tɪtoːʔnɪ́ːɬ
hadoodzih	hɑtoːt͡sɪh
hadoozih	hɑtoːzɪh
haghan	hɑɣɑn
hahazʼą́	hɑhɑzʔɑ̃́
háhóchį́	hɑ́hót͡ʃʰɪ̃́
hahwinistʼiin	hɑxʷɪnɪstʼɪːn
háida	hɑ́ɪtɑ
háii	hɑ́ɪː
háiidah	hɑ́ɪːtɑh
hájinéehgo	hɑ́t͡ʃɪnéehko
háká	hɑ́k͡xɑ́
hakágí	hɑk͡xɑ́kɪ́
hakáh	hɑk͡xɑ́h
hakʼehástʼahígíí	hɑkʼehɑ́stʼɑhɪ́kɪ́ː
hakʼéhestʼahgo	hɑkʼéhestʼɑhko
hakʼéstiʼ	hɑkʼést͡xɪʔ
hakʼiho	hɑkʼɪho
hakʼihodiitʼánígíí	hɑkʼɪhotɪːtʼɑ́nɪ́kɪ́ː
halneʼé	hɑlneʔé
handitʼáago	hɑntɪtʼɑ́ɑko
hanitsáhákees	hɑnɪt͡sʰɑ́hɑ́k͡xeːs
hánítshakees	hɑ́nɪ́t͡sʰhɑk͡xeːs
hániʼ	hɑ́nɪʔ
háníʼ	hɑ́nɪ́ʔ
hasáanii	hɑsɑ́ɑnɪː
hasáníjíʼ	hɑsɑ́nɪ́t͡ʃɪ́ʔ
hashtʼe	hɑʃtʼe
Hastąą	hɑst͡xɑ̃ː
Hastą́ą́	hɑst͡xɑ̃́ː
Hastąątsʼáadah	hɑst͡xɑ̃ːt͡sʼɑ́ɑtɑh
hastihgo	hɑst͡xɪhko
hatsʼíís	hɑt͡sʼɪ́ːs
hazą́ą́doo	hɑzɑ̃́ːtoː
hazhdidooliiłgo	hɑʒtɪtoːlɪːɬko
hazhdidooniił	hɑʒtɪtoːnɪːɬ
hazhdoodzihígíí	hɑʒtoːt͡sɪhɪ́kɪ́ː
hazʼą́	hɑzʔɑ̃́
hazʼą́ą́	hɑzʔɑ̃́ː
hazʼą́ąda	hɑzʔɑ̃́ɑ̃tɑ
hazʼą́ądoo	hɑzʔɑ̃́ɑ̃toː
hazʼą́ąji	hɑzʔɑ̃́ɑ̃t͡ʃɪ
hazʼaanii	hɑzʔɑːnɪː
hazʼáánii	hɑzʔɑ́ːnɪː
hazʼą́ąnii	hɑzʔɑ̃́ɑ̃nɪː
haʼadziih	hɑʔɑt͡sɪːh
haʼahootʼiʼ	hɑʔɑhoːtʼɪʔ
háʼahootʼíʼ	hɑ́ʔɑhoːtʼɪ́ʔ
háʼahóótʼiʼ	hɑ́ʔɑhóːtʼɪʔ
háʼahóótʼíʼ	hɑ́ʔɑhóːtʼɪ́ʔ
háʼahóótʼį́ʼ	hɑ́ʔɑhóːtʼɪ̃́ʔ
háʼáhootʼiʼ	hɑ́ʔɑ́hoːtʼɪʔ
háʼahootʼiʼígíí	hɑ́ʔɑhoːtʼɪʔɪ́kɪ́ː
haʼáłchinį́	hɑʔɑ́ɬt͡ʃʰɪnɪ̃́
haʼátʼííshį́į́	hɑʔɑ́tʼɪ́ːʃɪ̃́ː
háʼatʼííshį́į́	hɑ́ʔɑtʼɪ́ːʃɪ̃́ː
haʼhazáánígíí	hɑʔhɑzɑ́ːnɪ́kɪ́ː
haʼjólníídoo	hɑʔt͡ʃólnɪ́ːtoː
haʼoodzígíí	hɑʔoːt͡sɪ́kɪ́ː
haʼoodzíhígíí	hɑʔoːt͡sɪ́hɪ́kɪ́ː
haʼoodzííh	hɑʔoːt͡sɪ́ːh
haʼoodziiʼígíí	hɑʔoːt͡sɪːʔɪ́kɪ́ː
haʼoodzíʼígíí	hɑʔoːt͡sɪ́ʔɪ́kɪ́ː
heíída	heɪ́ːtɑ
héiida	héɪːtɑ
Héíídah	héɪ́ːtɑh
Hę́íídah	hẽ́ɪ́ːtɑh
heishíí	heɪʃɪ́ː
hideeznáá	hɪteːznɑ́ː
hígíí	hɪ́kɪ́ː
hiinánánígíí	hɪːnɑ́nɑ́nɪ́kɪ́ː
hijiináanii	hɪt͡ʃɪːnɑ́ɑnɪː
hináadoo	hɪnɑ́ɑtoː
hjįʼ	ht͡ʃɪ̃ʔ
hóchʼįʼígíí	hót͡ʃʼɪ̃ʔɪ́kɪ́ː
hodahgo	hotɑhko
hódahgo	hótɑhko
hodílzindoo	hotɪ́lzɪntoː
hodisin	hotɪsɪn
hodísin	hotɪ́sɪn
hodoolchʼį́į́	hotoːlt͡ʃʼɪ̃́ː
hohakéyah	hohɑk͡xéjɑh
hóholnígíí	hóholnɪ́kɪ́ː
hóholnííh	hóholnɪ́ːh
hóhólnįįh	hóhólnɪ̃ːh
hójizínígí	hót͡ʃɪzɪ́nɪ́kɪ́
hoł	hoɬ
hołdzildoo	hoɬt͡sɪltoː
hołdzilgo	hoɬt͡sɪlko
hółdziłgo	hóɬt͡sɪɬko
hołhazʼą́ądoo	hoɬhɑzʔɑ̃́ɑ̃toː
hólonígíí	hólonɪ́kɪ́ː
hólóodoo	hólóotoː
hólǫ́ǫ́doo	hólṍːtoː
hólóogo	hólóoko
hoodoołeelgo	hoːtoːɬeːlko
hooghan	hoːɣɑn
Hooghan	hoːɣɑn
hooltąʼgo	hoːlt͡xɑ̃ʔko
hooʼ	hoːʔ
hooʼaʼígíí	hoːʔɑʔɪ́kɪ́ː
hozhdísin	hoʒtɪ́sɪn
hozhdoodlį́į́ł	hoʒtoːtˡɪ̃́ːɬ
hozhnizingóó	hoʒnɪzɪnkóː
hózhnizinjį́ʼ	hóʒnɪzɪnt͡ʃɪ̃́ʔ
hoʼaʼígíí	hoʔɑʔɪ́kɪ́ː
hoʼdiʼníigo	hoʔtɪʔnɪ́ɪko
hoʼdool	hoʔtoːl
hoʼdoolchʼį́į́h	hoʔtoːlt͡ʃʼɪ̃́ːh
hweehodooleełgo	xʷeːhotoːleːɬko
hwééhozín	xʷéːhozɪ́n
hweʼoodląʼ	xʷeʔoːtˡɑ̃ʔ
hwíidóoneʼ	xʷɪ́ɪtóoneʔ
hwiihdaasyaʼ	xʷɪːhtɑːsjɑʔ
hwozhnízíngo	xʷoʒnɪ́zɪ́nko
hwozhnizinjį́	xʷoʒnɪzɪnt͡ʃɪ̃́
idahwiidooʼ	ɪtɑxʷɪːtoːʔ
ídlį́hígíí	ɪ́tˡɪ̃́hɪ́kɪ́ː
ídlį́į́go	ɪ́tˡɪ̃́ːko
idlínígíí	ɪtˡɪ́nɪ́kɪ́ː
iidoolííłda	ɪːtoːlɪ́ːɬtɑ
íídoołtah	ɪ́ːtoːɬt͡xɑh
iidoołtahígíí	ɪːtoːɬt͡xɑhɪ́kɪ́ː
iináago	ɪːnɑ́ɑko
iináʼázhdoolííłgo	ɪːnɑ́ʔɑ́ʒtoːlɪ́ːɬko
íínízingo	ɪ́ːnɪ́zɪnko
ííshjáná	ɪ́ːʃt͡ʃɑ́nɑ́
iitsʼáʼí	ɪːt͡sʼɑ́ʔɪ́
ííyiilaaígíí	ɪ́ːjɪːlɑːɪ́kɪ́ː
iizhdoołtah	ɪːʒtoːɬt͡xɑh
íízhdoołtahgo	ɪ́ːʒtoːɬt͡xɑhko
Ił	ɪɬ
ílį́go	ɪ́lɪ̃́ko
iłííshjání	ɪɬɪ́ːʃt͡ʃɑ́nɪ́
ilinígíʼ	ɪlɪnɪ́kɪ́ʔ
indah	ɪntɑh
íyisí	ɪ́jɪsɪ́
jidooghááłgo	t͡ʃɪtoːɣɑ́ːɬko
jidoołchǫǫłda	t͡ʃɪtoːɬt͡ʃʰõːɬtɑ
jílį́įgo	t͡ʃɪ́lɪ̃́ɪ̃ko
jínítínígo	t͡ʃɪ́nɪ́t͡xɪ́nɪ́ko
jinizingo	t͡ʃɪnɪzɪnko
jinízínígíí	t͡ʃɪnɪ́zɪ́nɪ́kɪ́ː
jizhlįįgo	t͡ʃɪʒlɪ̃ːko
jizinígíí	t͡ʃɪzɪnɪ́kɪ́ː
kééhatʼį́į́nii	k͡xéːhɑtʼɪ̃́ːnɪː
kéhojitʼį́įgo	k͡xéhot͡ʃɪtʼɪ̃́ɪ̃ko
Kótʼe	k͡xótʼe
kweʼé	k͡xʷeʔé
Kweʼé	k͡xʷeʔé
kwéʼé	k͡xʷéʔé
Kʼad	kʼɑt
kʼeh	kʼeh
kʼizhnítiʼ	kʼɪʒnɪ́t͡xɪʔ
łaał	ɬɑːɬ
Łáaʼii	ɬɑ́ɑʔɪː
Łaʼdah	ɬɑʔtɑh
łaʼjizį́	ɬɑʔt͡ʃɪzɪ̃́
leʼé	leʔé
Naadíín	nɑːtɪ́ːn
Naaki	nɑːk͡xɪ
Naakí	nɑːk͡xɪ́
Naakitsʼáadah	nɑːk͡xɪt͡sʼɑ́ɑtɑh
naal	nɑːl
naalkidídah	nɑːlk͡xɪtɪ́tɑh
naalteehʼé	nɑːlt͡xeːhʔé
naaltehʼé	nɑːlt͡xehʔé
naaltsoos	nɑːlt͡sʰoːs
nááná	nɑ́ːnɑ́
náánałahjį́	nɑ́ːnɑɬɑht͡ʃɪ̃́
naanáłahjį́ʼ	nɑːnɑ́ɬɑht͡ʃɪ̃́ʔ
naanishígíí	nɑːnɪʃɪ́kɪ́ː
naas	nɑːs
náásgóó	nɑ́ːskóː
naatʼáanii	nɑːtʼɑ́ɑnɪː
naatʼą́ąnii	nɑːtʼɑ̃́ɑ̃nɪː
naaztʼiʼígíí	nɑːztʼɪʔɪ́kɪ́ː
nahasdzaan	nɑhɑst͡sɑːn
náhásdzáán	nɑ́hɑ́st͡sɑ́ːn
Náhastʼéí	nɑ́hɑstʼéɪ́
Náhástʼéí	nɑ́hɑ́stʼéɪ́
Nahastʼéítsʼáadah	nɑhɑstʼéɪ́t͡sʼɑ́ɑtɑh
náhooʼaa	nɑ́hoːʔɑː
nahwiizʼáandę́ę́ʼ	nɑxʷɪːzʔɑ́ɑntẽ́ːʔ
nanáłaʼbígó	nɑnɑ́ɬɑʔpɪ́kó
nasgóó	nɑskóː
nátʼą́ą́	nɑ́tʼɑ̃́ː
nazhnitáago	nɑʒnɪt͡xɑ́ɑko
nazhnitin	nɑʒnɪt͡xɪn
naʼadáhígíí	nɑʔɑtɑ́hɪ́kɪ́ː
naʼanishgo	nɑʔɑnɪʃko
ndahsiidzinígíí	ntɑhsɪːt͡sɪnɪ́kɪ́ː
ndajilnishígíí	ntɑt͡ʃɪlnɪʃɪ́kɪ́ː
ndazhdoolnishgo	ntɑʒtoːlnɪʃko
ndooʼnishgo	ntoːʔnɪʃko
neeyánígíí	neːjɑ́nɪ́kɪ́ː
Neeznáá	neːznɑ́ː
neeʼniʼjįʼ	neːʔnɪʔt͡ʃɪ̃ʔ
néididooléełgo	néɪtɪtoːléeɬko
nídáastʼįįdgo	nɪ́tɑ́ɑstʼɪ̃ːtko
nídaazínígíí	nɪ́tɑːzɪ́nɪ́kɪ́ː
nidahazʼą́ągo	nɪtɑhɑzʔɑ̃́ɑ̃ko
nidahodooʼááł	nɪtɑhotoːʔɑ́ːɬ
nideiilnishgo	nɪteɪːlnɪʃko
nídidoolyééł	nɪ́tɪtoːljéːɬ
nígi	nɪ́kɪ
nihaahóchiʼ	nɪhɑːhót͡ʃʰɪʔ
niháʼahootʼiʼígíí	nɪhɑ́ʔɑhoːtʼɪʔɪ́kɪ́ː
niheʼoodlaʼ	nɪheʔoːtˡɑʔ
nihiisílá	nɪhɪːsɪ́lɑ́
nihikéyah	nɪhɪk͡xéjɑh
nihił	nɪhɪɬ
nihizaad	nɪhɪzɑːt
nihiʼdizhchį́įhjį́ʼ	nɪhɪʔtɪʒt͡ʃʰɪ̃́ɪ̃ht͡ʃɪ̃́ʔ
nihodooʼáałígíí	nɪhotoːʔɑ́ɑɬɪ́kɪ́ː
niidlį́	nɪːtˡɪ̃́
nijídleehgo	nɪt͡ʃɪ́tˡeːhko
nijigháádę́ę́ʼ	nɪt͡ʃɪɣɑ́ːtẽ́ːʔ
nijigháago	nɪt͡ʃɪɣɑ́ɑko
nijigháo	nɪt͡ʃɪɣɑ́o
nijiłnishdoo	nɪt͡ʃɪɬnɪʃtoː
nilígíí	nɪlɪ́kɪ́ː
nilíígíí	nɪlɪ́ːkɪ́ː
nilínígíí	nɪlɪ́nɪ́kɪ́ː
ninádajiʼniłgo	nɪnɑ́tɑt͡ʃɪʔnɪɬko
ninánílʼą́ąjįʼ	nɪnɑ́nɪ́lʔɑ̃́ɑ̃t͡ʃɪ̃ʔ
nitsahakeesgo	nɪt͡sʰɑhɑk͡xeːsko
nitsáʼhákeesgo	nɪt͡sʰɑ́ʔhɑ́k͡xeːsko
nitsiikeesígíí	nɪt͡sʰɪːk͡xeːsɪ́kɪ́ː
nitsijikeesgo	nɪt͡sʰɪt͡ʃɪk͡xeːsko
nízhdiiláago	nɪ́ʒtɪːlɑ́ɑko
nizingo	nɪzɪnko
nízingo	nɪ́zɪnko
nízínígo	nɪ́zɪ́nɪ́ko
niʼhodooʼááł	nɪʔhotoːʔɑ́ːɬ
niʼhookááʼ	nɪʔhoːk͡xɑ́ːʔ
niʼiilyʼéego	nɪʔɪːljʔéeko
njigháadoo	nt͡ʃɪɣɑ́ɑtoː
nléí	nléɪ́
noosééł	noːséːɬ
ntsíjíkeesgo	nt͡sʰɪ́t͡ʃɪ́k͡xeːsko
ntsíjíkeesígíí	nt͡sʰɪ́t͡ʃɪ́k͡xeːsɪ́kɪ́ː
óltaígíí	ólt͡xɑɪ́kɪ́ː
Oltaʼ	olt͡xɑʔ
oochʼį́į́d	oːt͡ʃʼɪ̃́ːt
óodlání	óotˡɑ́nɪ́
oodziʼígíí	oːt͡sɪʔɪ́kɪ́ː
óʼhooʼąąhdoo	óʔhoːʔɑ̃ːhtoː
óʼoolʼííłdoo	óʔoːlʔɪ́ːɬtoː
preamble	preɑmple
są́	sɑ̃́
silįįgo	sɪlɪ̃ːko
silį́į́go	sɪlɪ̃́ːko
silį́į́goda	sɪlɪ̃́ːkotɑ
sizínígíí	sɪzɪ́nɪ́kɪ́ː
siʼą́ągo	sɪʔɑ̃́ɑ̃ko
siʼáándéé	sɪʔɑ́ːntéː
siʼą́níígíí	sɪʔɑ̃́nɪ́ːkɪ́ː
Táá	t͡xɑ́ː
Tááʼ	t͡xɑ́ːʔ
Taaʼtsʼadah	t͡xɑːʔt͡sʼɑtɑh
Tádíín	t͡xɑ́tɪ́ːn
tį́į́ʼdoodáałdah	t͡xɪ̃́ːʔtoːtɑ́ɑɬtɑh
tówánáanígóó	t͡xówɑ́nɑ́ɑnɪ́kóː
tówonanidí	t͡xówonɑnɪtɪ́
tówónanígóó	t͡xówónɑnɪ́kóː
Tseebíítsʼáadah	t͡sʰeːpɪ́ːt͡sʼɑ́ɑtɑh
tsehodidookosda	t͡sʰehotɪtoːk͡xostɑ
Tsída	t͡sʰɪ́tɑ
Tsiʼdí	t͡sʰɪʔtɪ́
Tsíʼdó	t͡sʰɪ́ʔtó
tsoołda	t͡sʰoːɬtɑ
Tsostsid	t͡sʰost͡sʰɪt
Tsostsʼid	t͡sʰost͡sʼɪt
Tsostsʼidtsʼáadah	t͡sʰost͡sʼɪtt͡sʼɑ́ɑtɑh
Tsʼáadah	t͡sʼɑ́ɑtɑh
tʼaa	tʼɑː
tʼáábiniikʼehgo	tʼɑ́ːpɪnɪːkʼehko
tʼáábiʼoh	tʼɑ́ːpɪʔoh
tʼaadoo	tʼɑːtoː
tʼáágéédda	tʼɑ́ːkéːttɑ
tʼaahójinízingo	tʼɑːhót͡ʃɪnɪ́zɪnko
tʼáájiikʼe	tʼɑ́ːt͡ʃɪːkʼe
tʼaałáʼíjinízínígo	tʼɑːɬɑ́ʔɪ́t͡ʃɪnɪ́zɪ́nɪ́ko
tʼáániikʼeh	tʼɑ́ːnɪːkʼeh
tʼáaodah	tʼɑ́ɑotɑh
tʼáásahdii	tʼɑ́ːsɑhtɪː
tʼaasiʼą́ą́ndę́ę́	tʼɑːsɪʔɑ̃́ːntẽ́ː
tʼááʼanííájítʼį́įgo	tʼɑ́ːʔɑnɪ́ːɑ́t͡ʃɪ́tʼɪ̃́ɪ̃ko
tʼéego	tʼéeko
tʼéí	tʼéɪ́
tʼóó	tʼóː
wááshindoon	wɑ́ːʃɪntoːn
wolyé	woljé
yáh	jɑ́h
yáhwiidoolʼaałígíí	jɑ́xʷɪːtoːlʔɑːɬɪ́kɪ́ː
yahʼadooltʼeeł	jɑhʔɑtoːltʼeːɬ
yahʼaníjíneehgo	jɑhʔɑnɪ́t͡ʃɪ́neːhko
yándaazínígíí	jɑ́ntɑːzɪ́nɪ́kɪ́ː
yásizínígíí	jɑ́sɪzɪ́nɪ́kɪ́ː
yázhí	jɑ́ʒɪ́
yáʼátʼę́ehéígíí	jɑ́ʔɑ́tʼẽ́ehéɪ́kɪ́ː
yáʼátʼéehii	jɑ́ʔɑ́tʼéehɪː
yę́ę	jẽ́ẽ
yę́ędą́ą́ʼ	jẽ́ẽtɑ̃́ːʔ
yeehasʼą́	jeːhɑsʔɑ̃́
yidiłdoo	jɪtɪɬtoː
yikʼéhgo	jɪkʼéhko
yił	jɪɬ
yináldzidgo	jɪnɑ́lt͡sɪtko
yineelą́nígíí	jɪneːlɑ̃́nɪ́kɪ́ː
yiní	jɪnɪ́
yíníkʼeh	jɪ́nɪ́kʼeh
yíníkʼehgo	jɪ́nɪ́kʼehko
Yisdohígíí	jɪstohɪ́kɪ́ː
yoodlą́nígíí	joːtˡɑ̃́nɪ́kɪ́ː
ʼádin	ʔɑ́tɪn
ʼákóhwiindzin	ʔɑ́k͡xóxʷɪːnt͡sɪn
ʼałdó	ʔɑɬtó
ʼałdóʼ	ʔɑɬtóʔ
ʼééhósinígíí	ʔéːhósɪnɪ́kɪ́ː
ʼééhozin	ʔéːhozɪn
ʼíidoołtah	ʔɪ́ɪtoːɬt͡xɑh
ʼiiná	ʔɪːnɑ́
