தமிழ்	t̪amiɻ
இந்தியா	ind̪ijaː
மும்பை	mumbaɪ̯
நன்றி	nantʳi
வணக்கம்	ʋaɳakkam
ஆமாம்	aːmaːm
ஃபேஸ்புக்	feːspuk
புரியவில்லை	purijaʋillaɪ̯
கால	kaːla
வணக்க	ʋaɳakka
மதிய	mat̪ija
நல்வாழ்த்துக்க	nalʋaːɻt̪t̪ukka
என	ena
பண	paɳa
அறிஞர்கள்	ariɲarkaɭ
இங்ஙன்னா	iŋŋannaː
பயணம்	pajaɳam
திரும்ப	t̪irumba
தத்தம்	t̪at̪t̪am
ஸ்ரீ	ʃriː
ஔவும்	aʊ̯ʋum
