تۆمۈر	tømyr
ئالما	ʔalma
ئۇيغۇرچە	ʔujʁurt͡ʃɛ
ياپونىيە	japonijɛ
كۈمۈش	kymyʃ
ئات	ʔat
ئىسپانىيە	ʔispanijɛ
ئافرىقا	ʔafriqa
ياۋروپا	jawropa
ئىت	ʔit
ئاندوررا	ʔandorːa
ھىندىستان	hindistan
پىشلاق	piʃlaq
بۈگۈن	byɡyn
ئالبانىيە	ʔalbanijɛ
بېلگىيە	belɡijɛ
مىس	mis
ئالتۇن	ʔaltun
ئاي	ʔaj
كالا	kala
ئەرمېنىيە	ʔɛrmenijɛ
ئاسىيا	ʔasija
لۇغەت	luʁɛt
لائوس	laʔos
ئىراق	ʔiraq
گېرمانىيە	ɡermanijɛ
بېلىز	beliz
بىرما	birma
بور	bor
تىل	til
يامغۇر	jamʁur
يۈرەك	jyrɛk
كۈن	kyn
ئۇران	ʔuran
ئاق	ʔaq
گۈل	ɡyl
كۆك	køk
چوڭ	t͡ʃoŋ
ئىنجىل	ʔind͡ʒil
قول	qol
ئامېرىكا	ʔamerika
ئافغانىستان	ʔafʁanistan
مىسىر	misir
بۇلغارىيە	bulʁarijɛ
مايمۇن	majmun
يىلان	jilan
فىنلاندىيە	finlandijɛ
ئارگېنتىنا	ʔarɡentina
مولدوۋا	moldowa
ئوت	ʔot
قۇم	qum
بازار	bazar
ئۆلۈم	ʔølym
دۇنيا	dunja
بۇرۇندى	burundi
بۇتان	butan
ۋاتىكان	watikan
قوي	qoj
چوشقا	t͡ʃoʃqa
سەيشەنبە	sɛjʃɛnbɛ
تۈنۈگۈن	tynyɡyn
پۇل	pul
يولۋاس	jolwas
سائەت	saʔɛt
يامايكا	jamajka
شياڭگاڭ	ʃjaŋɡaŋ
بېنىن	benin
قار	qar
سېرىق	seriq
يېشىل	jeʃil
پولات	polat
بۇغداي	buʁdaj
نان	nan
يۇلتۇز	jultuz
سۇ	su
تۇز	tuz
تارىخ	tarix
كۆز	køz
باش	baʃ
قىزىل	qizil
ئورمان	ʔorman
ئېيىق	ʔejiq
مۈشۈك	myʃyk
لىۋىيە	liwijɛ
ئامېرىكا قوشما شتاتلىرى	ʔamerika qoʃma ʃtatliri
ئاغرىق	ʔaʁriq
سىڭىل	siŋil
ئاپا	ʔapa
ياز	jaz
ئېغىز	ʔeʁiz
پىياز	pijaz
ئىسلاندىيە	ʔislandijɛ
ئوغۇل	ʔoʁul
ياش	jaʃ
فېۋرال	fewral
سۆز	søz
دادا	dada
گىلاس	ɡilas
پاكىستان	pakistan
تۆگە	tøɡɛ
قان	qan
پويىز	pojiz
ماي	maj
جۇڭگو	d͡ʒuŋɡo
ئەزەربەيجان	ʔɛzɛrbɛjd͡ʒan
كۆۋرۈك	køwryk
سىپرۇس	siprus
جۈمە	d͡ʒymɛ
چاشقان	t͡ʃaʃqan
ئاپرېل	ʔaprel
ئالجىرىيە	ʔald͡ʒirijɛ
يېڭى زېلاندىيە	jeŋi zelandijɛ
ئازەربەيجان	ʔazɛrbɛjd͡ʒan
جىبۇتى	d͡ʒibuti
رۇسچە	rust͡ʃɛ
غاز	ʁaz
قۇش	quʃ
چاي	t͡ʃaj
تۈلكە	tylkɛ
كۆل	køl
كالپۇك	kalpuk
چىش	t͡ʃiʃ
ئىشىك	ʔiʃik
ئۆي	ʔøj
سۈت	syt
بارماق	barmaq
كىنوخانا	kinoxana
پىچاق	pit͡ʃaq
بوتسۋانا	botswana
پەيشەنبە	pɛjʃɛnbɛ
دۈشەنبە	dyʃɛnbɛ
يەكشەنبە	jɛkʃɛnbɛ
چارشەنبە	t͡ʃarʃɛnbɛ
سۇدان	sudan
شەنبە	ʃɛnbɛ
مىنۇت	minut
خۇدا	xuda
تەيۋەن	tɛjwɛn
بولىۋىيە	boliwijɛ
ئارپا	ʔarpa
ۋېنېسۇئېلا	wenesuʔela
دانىيە	danijɛ
سىنك	sink
پىل	pil
پاقا	paqa
ئۈزۈم	ʔyzym
فىلىپپىن	filipːin
ھىدروگېن	hidroɡen
ئامۇت	ʔamut
لاتۋىيە	latwijɛ
نېپال	nepal
كېپىنەك	kepinɛk
قېيىق	qejiq
سوراق	soraq
ئوق	ʔoq
ئايال	ʔajal
كۈز	kyz
كوچا	kot͡ʃa
بۈركۈت	byrkyt
تۈركىيە	tyrkijɛ
پىۋا	piwa
ئانا	ʔana
ئاخشام	ʔaxʃam
قۇرئان	qurʔan
دوست	dost
تاش	taʃ
تۇخۇم	tuxum
دوختۇر	doxtur
قوشۇق	qoʃuq
دېڭىز	deŋiz
بىز	biz
دەريا	dɛrja
قىز	qiz
بۇلۇت	bulut
دەرەخ	dɛrɛx
قارا	qara
چۈش	t͡ʃyʃ
دىن	din
ئالەم	ʔalɛm
ۋە	wɛ
يۈز	jyz
چۆل	t͡ʃøl
موڭغۇلىيە	moŋʁulijɛ
يانار تاغ	janar taʁ
پولشا	polʃa
ماراكەش	marakɛʃ
يىل	jil
قاتار	qatar
ئىسرائىلىيە	ʔisraʔilijɛ
مالاۋى	malawi
كوستارىكا	kostarika
كېنىيە	kenijɛ
ياۋروپا ئىتتىپاقى	jawropa ʔitːipaqi
نىگېرىيە	niɡerijɛ
موناكو	monako
مېكسىكا	meksika
مالدىۋې	maldiwe
مالتا	malta
گانا	ɡana
كۇۋەيت	kuwɛjt
سېيشېل	sejʃel
قەلەي	qɛlɛj
قېرى	qeri
ھاۋا	hawa
تۈن	tyn
سېربىيە	serbijɛ
تاجىكىستان	tad͡ʒikistan
ھەپتە	hɛptɛ
سىنگاپور	sinɡapor
ئىسىم	ʔisim
كۇبا	kuba
ئىنسان	ʔinsan
ئۇرۇگۋاي	ʔuruɡwaj
ئۇكرائىنا	ʔukraʔina
يول	jol
يانۋار	janwar
ئاۋاز	ʔawaz
نومۇر	nomur
سەۋزە	sɛwzɛ
پاختا	paxta
تاۋۇز	tawuz
تېرە	terɛ
شىنجاڭ	ʃind͡ʒaŋ
تىيىن	tijin
دەپتەر	dɛptɛr
بانان	banan
چىلە	t͡ʃilɛ
بۆرە	børɛ
سېكۇنت	sekunt
ئەتە	ʔɛtɛ
ئەدەبىيات	ʔɛdɛbijat
ئېكۋاتور	ʔekwator
ئىيۇن	ʔijun
ئېستونىيە	ʔestonijɛ
توگو	toɡo
تەبىئەت	tɛbiʔɛt
قازاقىستان	qazaqistan
فرانسىيە	fransijɛ
ئۇيغۇر تىلى	ʔujʁur tili
سۆڭەك	søŋɛk
ئەرەب	ʔɛrɛb
ئۆمۈچۈك	ʔømyt͡ʃyk
بۈرگە	byrɡɛ
ھەسەل	hɛsɛl
يود	jod
گۈڭگۈرت	ɡyŋɡyrt
كومپيۇتېر	kompjuter
فىزىكا	fizika
تىز	tiz
زەھەر	zɛhɛr
پەمىدۇر	pɛmidur
ئۆسۈملۈك	ʔøsymlyk
ئەينەك	ʔɛjnɛk
يىڭنە	jiŋnɛ
قۇلاق	qulaq
پۇت	put
تاغ	taʁ
قاش	qaʃ
جۇغراپىيە	d͡ʒuʁrapijɛ
شەھەر	ʃɛhɛr
پادىشاھ	padiʃah
قانات	qanat
چاچ	t͡ʃat͡ʃ
قەغەز	qɛʁɛz
مۇز	muz
شىر	ʃir
ئاچقۇچ	ʔat͡ʃqut͡ʃ
ئۇكا	ʔuka
ئۇرۇش	ʔuruʃ
بالا	bala
كىت	kit
ئادەم	ʔadɛm
ئۇيغۇر	ʔujʁur
قاغا	qaʁa
بۇرۇن	burun
مەن	mɛn
ئاتا	ʔata
ئىككىنچى	ʔikːint͡ʃi
بىرىنچى	birint͡ʃi
سېررالېئون	serːaleʔon
تونگا	tonɡa
بريۇسسېل	brjusːel
ۋانۇئاتۇ	wanuʔatu
گوللاندىيە	ɡolːandijɛ
سەپەر	sɛpɛr
ئاۋغۇست	ʔawʁust
كىتاب	kitab
سان	san
گرۇزىيە	ɡruzijɛ
ئانگولا	ʔanɡola
ماكېدونىيە	makedonijɛ
بەھرەين	bɛhrɛjn
باربادوس	barbados
شام	ʃam
سومالى	somali
نىكېل	nikel
ماگنىي	maɡnij
كوبالت	kobalt
ئاليۇمىن	ʔaljumin
ناترىي	natrij
زامبىيە	zambijɛ
پىت	pit
پورتۇگالىيە	portuɡalijɛ
بېلىق	beliq
سۈرمە	syrmɛ
گۆش	ɡøʃ
كۆمۈر	kømyr
بروم	brom
زەيتۇن	zɛjtun
ساقال	saqal
شاپتۇل	ʃaptul
سوپۇن	sopun
دۇئا	duʔa
ماتېماتىكا	matematika
كىنو	kino
پالتا	palta
ئارال	ʔaral
ئىلىم	ʔilim
چاپان	t͡ʃapan
مەكتەپ	mɛktɛp
مۇنار	munar
تانزانىيە	tanzanijɛ
ياڭيۇ	jaŋju
ماشىنا	maʃina
تاماكا	tamaka
ھىندونېزىيە	hindonezijɛ
دەرس	dɛrs
قىش	qiʃ
ئۇن	ʔun
پەيغەمبەر	pɛjʁɛmbɛr
بۆرەك	børɛk
توپ	top
مۇسۇلمان	musulman
پەرىشتە	pɛriʃtɛ
ياكى	jaki
ئائىلە	ʔaʔilɛ
يېڭى	jeŋi
خەت	xɛt
يەمەن	jɛmɛn
ئۇگاندا	ʔuɡanda
يىپەك	jipɛk
تۈك	tyk
ھايات	hajat
زامان	zaman
ئاسمان	ʔasman
تەڭرى	tɛŋri
شامال	ʃamal
ياق	jaq
ئېرىترىيە	ʔeritrijɛ
ئاۋسترىيە	ʔawstrijɛ
ئىيۇل	ʔijul
لىۋان	liwan
نورۋېگىيە	norweɡijɛ
ئېشەك	ʔeʃɛk
لېسوتو	lesoto
كامېرون	kameron
چىلى	t͡ʃili
برازىلىيە	brazilijɛ
ئومان	ʔoman
ئوتتۇرا ئافرىقا جۇمھۇرىيىتى	ʔotːura ʔafriqa d͡ʒumhurijiti
مىكرونېزىيە	mikronezijɛ
گابون	ɡabon
غەربىي ساخارا	ʁɛrbij saxara
دومىنىكا	dominika
توققۇز	toqːuz
پاناما	panama
بېنگلا	benɡla
قازاقچە	qazaqt͡ʃɛ
نۇر	nur
مارت	mart
ۋاقىت	waqit
ئاقساقال	ʔaqsaqal
ئاياق	ʔajaq
سۇرىنام	surinam
پېرۇ	peru
ھايتى	hajti
زىمبابۋې	zimbabwe
تايلاند	tajland
ماۋرىتانىيە	mawritanijɛ
فىجى	fid͡ʒi
ئىتالىيە	ʔitalijɛ
ئاۋسترالىيە	ʔawstralijɛ
ئوكيانىيە	ʔokjanijɛ
ئۇنىۋېرسىتېت	ʔuniwersitet
سېنېگال	seneɡal
تۈركمەنىستان	tyrkmɛnistan
كانادا	kanada
لىبېرىيە	liberijɛ
رۇسىيە	rusijɛ
چاد	t͡ʃad
توشقان	toʃqan
ئوتتۇرا	ʔotːura
شەرقىي ياۋروپا	ʃɛrqij jawropa
يانپاش	janpaʃ
مالايسىيا	malajsija
كىسلاتا	kislata
چىلبۆرە	t͡ʃilbørɛ
شېئىر	ʃeʔir
كۆكتات	køktat
بەشىنچى	bɛʃint͡ʃi
تۈتۈن	tytyn
ئىس	ʔis
نورۇز	noruz
ئىملا	ʔimla
ئايروپىلان	ʔajropilan
ناشتا	naʃta
مىكروسكوپ	mikroskop
قۇددۇس	qudːus
باخشى	baxʃi
ئېلىپبە	ʔelipbɛ
كەش	kɛʃ
گېئولوگىيە	ɡeʔoloɡijɛ
بۇلبۇل	bulbul
زىلزىلە	zilzilɛ
قەلەم	qɛlɛm
دۆلەت	dølɛt
شىركەت	ʃirkɛt
رەڭ	rɛŋ
رەسىم	rɛsim
كۈچلۈك	kyt͡ʃlyk
ئەرزان	ʔɛrzan
كىچىك	kit͡ʃik
ئۈرۈمچى	ʔyrymt͡ʃi
لىفت	lift
ئۈچىنچى	ʔyt͡ʃint͡ʃi
سيۇرىخ	sjurix
سۈرىيە	syrijɛ
تاشپاقا	taʃpaqa
توخۇ	toxu
دىنسىزلىق	dinsizliq
مۇھەررەم	muhɛrːɛm
فۇت	fut
ئۆكتەبىر	ʔøktɛbir
كارىب دېڭىزى	karib deŋizi
بەلگە	bɛlɡɛ
قىرغىزىستان	qirʁizistan
يېرۇسالېم	jerusalem
كۆك ياقۇت	køk jaqut
شاڭخەي	ʃaŋxɛj
ياپونچە	japont͡ʃɛ
سېنتەبىر	sentɛbir
كارۋات	karwat
ئارسېن	ʔarsen
كەپتەر	kɛptɛr
بولكا	bolka
ئاخۇن	ʔaxun
ئارسلان	ʔarslan
لىتىي	litij
كالىي	kalij
پاللادىي	palːadij
ۋولفرام	wolfram
بارىي	barij
كالتسىي	kaltsij
پولونىي	polonij
ئاپتوبۇس	ʔaptobus
ئاناتومىيە	ʔanatomijɛ
قوڭۇر	qoŋur
چۈمۈلە	t͡ʃymylɛ
سۇلتان	sultan
ھۈجەيرە	hyd͡ʒɛjrɛ
فاكۇلتېت	fakultet
فوسفور	fosfor
چىنلىق	t͡ʃinliq
شېكەر	ʃekɛr
قىزىلچا	qizilt͡ʃa
كاربون	karbon
ياغ	jaʁ
نېفىت	nefit
شەرىئەت	ʃɛriʔɛt
پاراخوت	paraxot
كرىپتون	kripton
ئارگون	ʔarɡon
ئوكسىگېن	ʔoksiɡen
ھەج	hɛd͡ʒ
تەۋرات	tɛwrat
سالام	salam
سىياسەت	sijasɛt
ۋالىبول	walibol
سىلى	sili
سىز	siz
زالىملىق	zalimliq
بىناكارلىق	binakarliq
سەييارە	sɛjːarɛ
ئۆچكە	ʔøt͡ʃkɛ
ئۆگزە	ʔøɡzɛ
ئىدارە	ʔidarɛ
شەيتان	ʃɛjtan
رومان	roman
پاچاق	pat͡ʃaq
چېركاۋ	t͡ʃerkaw
ھەرپ	hɛrp
ئىنەك	ʔinɛk
مېڭە	meŋɛ
يۇپىتېر	jupiter
مەڭگۈلۈك	mɛŋɡylyk
شورپا	ʃorpa
دىپلومات	diplomat
ئۆلكە	ʔølkɛ
گىلەم	ɡilɛm
بويۇن	bojun
تىتان	titan
تۆت	tøt
قازان	qazan
چىراي	t͡ʃiraj
سۈپەت	sypɛt
قەھۋە	qɛhwɛ
تىنچلىق	tint͡ʃliq
خان	xan
تۇرپان	turpan
سوڭ	soŋ
ئۆكچە	ʔøkt͡ʃɛ
جوزا	d͡ʒoza
ئىستانسا	ʔistansa
كاۋاپ	kawap
ماڭلاي	maŋlaj
بىلەك	bilɛk
بەت	bɛt
تام	tam
كېچە	ket͡ʃɛ
دوپپا	dopːa
خوش	xoʃ
ھايۋان	hajwan
ئارمىيە	ʔarmijɛ
بۇقا	buqa
ھۆكۈمەت	høkymɛt
ئايغىر	ʔajʁir
باتۇر	batur
بىلىم	bilim
تاپشۇرۇق	tapʃuruq
كۈل	kyl
مېھمان	mehman
سۆھبەت	søhbɛt
مەجلىس	mɛd͡ʒlis
ئاشخانا	ʔaʃxana
ئاشپەز	ʔaʃpɛz
تاماق	tamaq
قانۇن	qanun
يىراق	jiraq
كىم	kim
ئەلچى	ʔɛlt͡ʃi
دۈشمەن	dyʃmɛn
ئون	ʔon
كېلىن	kelin
تۇمان	tuman
ماگىزىن	maɡizin
كەنت	kɛnt
يۇرت	jurt
ئادەت	ʔadɛt
مۇزىكا	muzika
قانداق	qandaq
ناماز	namaz
نەشپۈت	nɛʃpyt
خوجا	xod͡ʒa
ئاچا	ʔat͡ʃa
پېئىل	peʔil
ئىككى	ʔikːi
جاھان	d͡ʒahan
تىجارەت	tid͡ʒarɛt
بىلەن	bilɛn
بەك	bɛk
ئاستا	ʔasta
ياخشى	jaxʃi
ئاز	ʔaz
ئۇ	ʔu
ئىشتان	ʔiʃtan
ئۈچ	ʔyt͡ʃ
ئەر	ʔɛr
كۈچسىز	kyt͡ʃsiz
ئاجىز	ʔad͡ʒiz
بىر	bir
يېڭى كالېدونىيە	jeŋi kaledonijɛ
ئاۋمېن	ʔawmen
خەنزۇچە	xɛnzut͡ʃɛ
بىرلەشكەن دۆلەتلەر تەشكىلاتى	birlɛʃkɛn dølɛtlɛr tɛʃkilati
ئاق قۇ	ʔaq qu
جەنۇب	d͡ʒɛnub
ژۇرنال	ʒurnal
ۋېنگرىيە	wenɡrijɛ
بېيجىڭ	bejd͡ʒiŋ
كۇردچە	kurdt͡ʃɛ
ۋەھىمە	wɛhimɛ
ئەرەب بىرلەشمە خەلىپىلىكى	ʔɛrɛb birlɛʃmɛ xɛlipiliki
قوغۇشۇن	qoʁuʃun
پوچتا	pot͡ʃta
پۇتبول	putbol
تىلشۇناسلىق	tilʃunasliq
ساموئا	samoʔa
ئىمتىھان	ʔimtihan
قوزا	qoza
تۇنىس	tunis
ئاداش	ʔadaʃ
ئىلتىماس	ʔiltimas
كۆڭۈل	køŋyl
كىيىم	kijim
ئىشسىز	ʔiʃsiz
دەم	dɛm
باھار	bahar
كىر	kir
تۇر	tur
جابدۇق	d͡ʒabduq
ئىچ	ʔit͡ʃ
قارى	qari
پەلسەپە	pɛlsɛpɛ
خىل	xil
پۇرچاق	purt͡ʃaq
ھال	hal
سورۇن	sorun
ياغاچ	jaʁat͡ʃ
جىن	d͡ʒin
جەنۇبىي ئافرىقا	d͡ʒɛnubij ʔafriqa
دوختۇرخانا	doxturxana
يۇڭ	juŋ
ياردەم	jardɛm
قىزىق	qiziq
ئىشخانا	ʔiʃxana
دورا	dora
ئۆسۈم	ʔøsym
سالقىن	salqin
ھەقىقەت	hɛqiqɛt
باغ	baʁ
بوۋا	bowa
يانچۇق	jant͡ʃuq
خالتا	xalta
تۇرمۇش	turmuʃ
ئىنى	ʔini
ۋەدە	wɛdɛ
بەدەن	bɛdɛn
ئاكا	ʔaka
يىغىن	jiʁin
سىرت	sirt
راست	rast
خەلق	xɛlq
ئامراق	ʔamraq
قېرىنداش	qerindaʃ
ئورۇندۇق	ʔorunduq
ئورۇن	ʔorun
قىسىم	qisim
سودا	soda
شۇ	ʃu
يېزا	jeza
كېرەك	kerɛk
كېيىن	kejin
ئامال	ʔamal
پىكىر	pikir
ئارىلىق	ʔariliq
تال	tal
دۇكان	dukan
ئۆمۈر	ʔømyr
دائىم	daʔim
ناچار	nat͡ʃar
كونا	kona
ناھايىتى	nahajiti
بىرلىك	birlik
دولقۇن	dolqun
بوران	boran
ئامالسىز	ʔamalsiz
چوقۇم	t͡ʃoqum
خەنزۇ	xɛnzu
قۇيرۇقلۇق يۇلتۇز	qujruqluq jultuz
ئىنگلىزچە	ʔinɡlizt͡ʃɛ
سېرپچە	serpt͡ʃɛ
تەرجىمە	tɛrd͡ʒimɛ
ئۆردەك	ʔørdɛk
سىلىتسىي	silitsij
گېلىي	ɡelij
مەسچىت	mɛst͡ʃit
دېھقان	dehqan
ھەيكەل	hɛjkɛl
يالغان	jalʁan
سوغۇق	soʁuq
قارا دېڭىز	qara deŋiz
تانا	tana
برۇنېي	brunej
بۇخارېست	buxarest
ئاپريل	ʔaprjl
بايتال	bajtal
ماداغاسقار	madaʁasqar
مارتىنىكا	martinika
ئەجدىھا	ʔɛd͡ʒdiha
ئارۇبا	ʔaruba
پىل چىشى قىرغىقى	pil t͡ʃiʃi qirʁiqi
نورفولك ئارىلى	norfolk ʔarili
غەربىي ئافرىقا	ʁɛrbij ʔafriqa
غەربىي ياۋروپا	ʁɛrbij jawropa
مونتسېررات	montserːat
موزامبىك	mozambik
ئەنگلىيە	ʔɛnɡlijɛ
نامىبىيە	namibijɛ
لىتۋانىيە	litwanijɛ
كومورو	komoro
قاداق	qadaq
جەبىلتارىق	d͡ʒɛbiltariq
بېرمۇدا	bermuda
بېلارۇسىيە	belarusijɛ
ناۋرۇ	nawru
ئىرېلاندىيە	ʔirelandijɛ
ۋات	wat
مالى	mali
كامبودژا	kambodʒa
چېخ جۇمھۇرىيىتى	t͡ʃex d͡ʒumhurijiti
گىرادۇس	ɡiradus
جېرسېي	d͡ʒersej
پاراگۋاي	paraɡwaj
باھاما	bahama
پەلەستىن	pɛlɛstin
نىكاراگۇئا	nikaraɡuʔa
ئانگۋىللا	ʔanɡwilːa
ئاكادېمىك	ʔakademik
بېنگال	benɡal
دومىنىكا جۇمھۇرىيىتى	dominika d͡ʒumhurijiti
كىرىباتى	kiribati
يېرېۋان	jerewan
تۈركمەن تىلى	tyrkmɛn tili
تۇۋالۇ	tuwalu
ھىجرىيە	hid͡ʒrijɛ
مىل	mil
كولومبىيە	kolombijɛ
سانتىمېتىر	santimetir
يىلنامە	jilnamɛ
جەنۇبىي ئاسىيا	d͡ʒɛnubij ʔasija
كىلوۋات	kilowat
شىمالىي ئافرىقا	ʃimalij ʔafriqa
شىمالىي ئامېرىكا	ʃimalij ʔamerika
شىمالىي ياۋروپا	ʃimalij jawropa
جامى	d͡ʒami
گامبىيە	ɡambijɛ
گۇئام	ɡuʔam
كىلومېتىر	kilometir
مېتىر	metir
ئورتاق	ʔortaq
يېشىل تۇمشۇق	jeʃil tumʃuq
ئىران	ʔiran
ئۆزبېكىستان	ʔøzbekistan
ئوتتۇرا ئافرىقا	ʔotːura ʔafriqa
ئوتتۇرا ئامېرىكا	ʔotːura ʔamerika
ئاددىي	ʔadːij
شەرقىي تىمور	ʃɛrqij timor
شەرقىي جەنۇبىي ئاسىيا	ʃɛrqij d͡ʒɛnubij ʔasija
شەرقىي ئاسىيا	ʃɛrqij ʔasija
ئېكۋادور	ʔekwador
نىگېر	niɡer
بۇركىنا فاسو	burkina faso
ساينت لۇسىيە	sajnt lusijɛ
سالۋادور	salwador
زاگرېب	zaɡreb
مالايچە	malajt͡ʃɛ
ھوندۇراس	honduras
تاتارچە	tatart͡ʃɛ
ئوتتۇرا ئاسىيا	ʔotːura ʔasija
تەرخەمەك	tɛrxɛmɛk
تاتار	tatar
سائەتچىلىك	saʔɛtt͡ʃilik
يىلپىز	jilpiz
يالغانچى	jalʁant͡ʃi
يەڭ	jɛŋ
چىمەنلىك	t͡ʃimɛnlik
چەيزە	t͡ʃɛjzɛ
لىبېرال	liberal
ئۆپكە	ʔøpkɛ
رىم	rim
تۆتىنچى	tøtint͡ʃi
بېكەت	bekɛt
نۆل	nøl
مۇپتى	mupti
تېرىق	teriq
چۆپ	t͡ʃøp
سۈرە	syrɛ
ۋاكۇئۇم	wakuʔum
كەمەر	kɛmɛr
بەسەي	bɛsɛj
بىئولوگ	biʔoloɡ
مەرۋايىت	mɛrwajit
پەنجە	pɛnd͡ʒɛ
دەزمال	dɛzmal
كۈلدان	kyldan
بوستان	bostan
ماغزاپ	maʁzap
ھاياجان	hajad͡ʒan
ۋودورود	wodorod
ساقچى	saqt͡ʃi
مىللىمېتىر	milːimetir
كىندىك	kindik
جاڭگال	d͡ʒaŋɡal
قىمارخانا	qimarxana
شوخلا	ʃoxla
ئورمانلىق	ʔormanliq
تورت	tort
چوكا	t͡ʃoka
ئايرودروم	ʔajrodrom
ئاشىقلىق	ʔaʃiqliq
ئاتكىرىتكا	ʔatkiritka
قوتاز	qotaz
ھۆپىگەر	høpiɡɛr
سازلىق	sazliq
قالقان	qalqan
ئىمزا	ʔimza
گېزىت	ɡezit
تورغاي	torʁaj
بولقا	bolqa
جەڭچى	d͡ʒɛŋt͡ʃi
ئاشىق	ʔaʃiq
ئېرىنچەكلىك	ʔerint͡ʃɛklik
كېسەل	kesɛl
ئىبلىس	ʔiblis
نەپرەت	nɛprɛt
فىلىم	filim
مېتافىزىكا	metafizika
بومبا	bomba
ساماۋار	samawar
پەي	pɛj
ۋادى	wadi
سۈپۈرگە	sypyrɡɛ
باغىر	baʁir
بادام	badam
ئىشچى	ʔiʃt͡ʃi
كەسلەنچۈك	kɛslɛnt͡ʃyk
جەسەت	d͡ʒɛsɛt
ياتاقخانا	jataqxana
ئانار	ʔanar
زىرە	zirɛ
زەنجىۋىل	zɛnd͡ʒiwil
مۆجىزە	mød͡ʒizɛ
قولتۇق	qoltuq
گۈرۈچ	ɡyryt͡ʃ
مەرمەر	mɛrmɛr
پەلتو	pɛlto
شاھزادە	ʃahzadɛ
ۋەتەن	wɛtɛn
باغۋەنچىلىك	baʁwɛnt͡ʃilik
قادىر	qadir
قابىل	qabil
خارتۇم	xartum
مۇھەببەت	muhɛbːɛt
ناھەقچىلىك	nahɛqt͡ʃilik
ئاقسۆڭەك	ʔaqsøŋɛk
ناخشا	naxʃa
جۈملە	d͡ʒymlɛ
كۆپۈك	køpyk
بۆشۈك	bøʃyk
رۇبلى	rubli
دوكتور	doktor
كومپاس	kompas
ئاشقازان	ʔaʃqazan
خەرىتە	xɛritɛ
كاسىپ	kasip
جەسۇر	d͡ʒɛsur
جامال	d͡ʒamal
جاھانگىر	d͡ʒahanɡir
كىرپە	kirpɛ
رەندە	rɛndɛ
ئوغۇز	ʔoʁuz
ياقۇت	jaqut
چاقماق	t͡ʃaqmaq
تاكسى	taksi
قەشقەر	qɛʃqɛr
ئاپتوموبىل	ʔaptomobil
قەلب	qɛlb
ئالتە	ʔaltɛ
ئالتىنچى	ʔaltint͡ʃi
خوراز	xoraz
سەككىزىنچى	sɛkːizint͡ʃi
سەككىز	sɛkːiz
فوتو	foto
ئۆلۈك	ʔølyk
مۇردا	murda
چايدان	t͡ʃajdan
تېرموس	termos
رۇس	rus
مەسىلەن	mɛsilɛn
نەي	nɛj
يازغۇچى	jazʁut͡ʃi
ئىمام	ʔimam
ھۆر	hør
ئىسلام	ʔislam
ھىلال	hilal
سەن	sɛn
كۈلكىلىك	kylkilik
دەرۋىش	dɛrwiʃ
ئۇلار	ʔular
قوشۇن	qoʃun
ئىنسانىيەت	ʔinsanijɛt
مېتال	metal
بەش	bɛʃ
بار	bar
يىگىرمە	jiɡirmɛ
گۆدەك	ɡødɛk
بوۋاق	bowaq
مەزىن	mɛzin
كۇتۇپخانا	kutupxana
توققۇزىنچى	toqːuzint͡ʃi
خىزمەتچى	xizmɛtt͡ʃi
ھەقسىز	hɛqsiz
جۇمھۇرىيەت	d͡ʒumhurijɛt
نېمە	nemɛ
شەرق	ʃɛrq
ھەم	hɛm
ئەركىن	ʔɛrkin
بىلىمسىزلىك	bilimsizlik
قالتىس	qaltis
يەتتە	jɛtːɛ
ئۇرۇق	ʔuruq
ماھارەت	maharɛt
تېلېفون	telefon
چاڭجياڭ دەرياسى	t͡ʃaŋd͡ʒjaŋ dɛrjasi
ۋاسكېتبول	wasketbol
ئامستېردام	ʔamsterdam
سۋازىلاند	swaziland
تىنچ ئوكيان	tint͡ʃ ʔokjan
ھەدىس	hɛdis
ۋانادىي	wanadij
خەلىپىلىك	xɛlipilik
موسكۋا	moskwa
شوتلاندىيە	ʃotlandijɛ
ئايروپورت	ʔajroport
مەڭز	mɛŋz
ئۇزاتماق	ʔuzatmaq
ميۇنخېن	mjunxen
ئىدېئولوگىيە	ʔideʔoloɡijɛ
تۆش	tøʃ
پراگا	praɡa
باش سۆڭىكى	baʃ søŋiki
كەچۈرۈڭ	kɛt͡ʃyryŋ
تۈركىيە جۇمھۇرىيىتى	tyrkijɛ d͡ʒumhurijiti
تەيبېي	tɛjbej
ئانتاركتىدا	ʔantarktida
فوتوسىنتېز	fotosintez
روسىيە	rosijɛ
بۇددا دىنى	budːa dini
ئادمىرال	ʔadmiral
چېخوسلوۋاكىيىنىڭ	t͡ʃexoslowakijiniŋ
برىتانىيە	britanijɛ
بوگوتا	boɡota
بېلگراد	belɡrad
زۇلھەججە	zulhɛd͡ʒːɛ
دېكابىر	dekabir
نويابىر	nojabir
داپچى	dapt͡ʃi
تەخەي	tɛxɛj
ئارغىماق	ʔarʁimaq
چاما	t͡ʃama
قىيىنلىق	qijinliq
ئالتاي	ʔaltaj
ئافغان	ʔafʁan
ئاقار	ʔaqar
ئاسپىرىن	ʔaspirin
ياسانچۇقلۇق	jasant͡ʃuqluq
ئۆكۈز	ʔøkyz
سوئال	soʔal
رادىي	radij
ئامېرىتسىي	ʔameritsij
فېرمىي	fermij
ئاكتىنىي	ʔaktinij
بانكا	banka
ئىرىدىي	ʔiridij
تاللىي	talːij
پلاتىنا	platina
تۆمۈرچى	tømyrt͡ʃi
فرانسىي	fransij
كىلىت	kilit
ئوكۇل	ʔokul
مۇخبىرلىق	muxbirliq
ئاچچىقسۇ	ʔat͡ʃːiqsu
رەمچى	rɛmt͡ʃi
پوچتىخانا	pot͡ʃtixana
ئۇنچىلىك	ʔunt͡ʃilik
ۋەسىيەت	wɛsijɛt
ئوربىتا	ʔorbita
سالاھىيەت	salahijɛt
ماسسا	masːa
پارتا	parta
تىلشۇناس	tilʃunas
ئىنتوناتسىيە	ʔintonatsijɛ
سېمانتىكا	semantika
شىكايەتنامە	ʃikajɛtnamɛ
شۈكۈر	ʃykyr
ئاغ	ʔaʁ
كېپەن	kepɛn
پەشمەت	pɛʃmɛt
زەئىپلىك	zɛʔiplik
سۈلۈك	sylyk
سىركە	sirkɛ
ئوتياش	ʔotjaʃ
سوۋېت	sowet
خاسىڭ	xasiŋ
قومۇش	qomuʃ
مەۋسۈم	mɛwsym
ۋىنو	wino
ئۇسسۇل	ʔusːul
ئاپتونومىيە	ʔaptonomijɛ
قارىمۇچ	qarimut͡ʃ
ئەستەر	ʔɛstɛr
ئىشتىھا	ʔiʃtiha
بەل	bɛl
ئۈچەي	ʔyt͡ʃɛj
شەۋۋال	ʃɛwːal
سىرغا	sirʁa
كەۋسەر	kɛwsɛr
ھاماقەتلىك	hamaqɛtlik
كەمپىر	kɛmpir
ھېچ	het͡ʃ
مىراس	miras
پوپايكا	popajka
تىزگىن	tizɡin
توقۇمىچىلىق	toqumit͡ʃiliq
ناۋاي	nawaj
بال	bal
ئەش	ʔɛʃ
مۇسكۇل	muskul
تەڭلىك	tɛŋlik
قاتارلىق	qatarliq
كۈلكە	kylkɛ
ئۆرە	ʔørɛ
ئۇچقۇچى	ʔut͡ʃqut͡ʃi
پەن-تېخنىكا	pɛn-texnika
كۈزلۈك	kyzlyk
ئىنئام	ʔinʔam
جەز	d͡ʒɛz
ئاستاتىن	ʔastatin
مەدەن	mɛdɛn
سېزىم	sezim
كىرپىك	kirpik
راي	raj
تاۋاق	tawaq
قېرىن	qerin
توسقۇنلۇق	tosqunluq
رەسسام	rɛsːam
ئوقەت	ʔoqɛt
قوغۇن	qoʁun
گازىر	ɡazir
بوتۇلكا	botulka
شېشە	ʃeʃɛ
ئويۇنچۇق	ʔojunt͡ʃuq
سۆسەر	søsɛr
ئاش	ʔaʃ
مۈڭگۈز	myŋɡyz
قۇربانلىق	qurbanliq
قۇلۇپ	qulup
رەجەپ	rɛd͡ʒɛp
رەنا	rɛna
رەھمان	rɛhman
قۇرۇم	qurum
ئاچارچىلىق	ʔat͡ʃart͡ʃiliq
مەقبەرە	mɛqbɛrɛ
مارس	mars
چاڭغا	t͡ʃaŋʁa
چارۋىچىلىق	t͡ʃarwit͡ʃiliq
ياغسىز	jaʁsiz
يوقسۇل	joqsul
تۇزسىز	tuzsiz
چەبدەس	t͡ʃɛbdɛs
مۆلچەر	mølt͡ʃɛr
تاغا	taʁa
رېنتگېن	rentɡen
تەرتىپ	tɛrtip
مېيىپ	mejip
جاراھەت	d͡ʒarahɛt
بەئەينى	bɛʔɛjni
يۇقۇملۇق	juqumluq
كۈنلۈك	kynlyk
بوغالتىر	boʁaltir
ئەزا	ʔɛza
غەمسىز	ʁɛmsiz
جىق	d͡ʒiq
كۆپچىلىك	køpt͡ʃilik
نەيرەڭۋازلىق	nɛjrɛŋwazliq
سەپ	sɛp
جۈپ	d͡ʒyp
ئىمان	ʔiman
ئىبادەت	ʔibadɛt
غۇلجا	ʁuld͡ʒa
ئىخلاس	ʔixlas
تىلەك	tilɛk
مەقسەت	mɛqsɛt
گويا	ɡoja
ئۈلگە	ʔylɡɛ
شەرتسىز	ʃɛrtsiz
يۈك	jyk
نۆۋەت	nøwɛt
قېتىم	qetim
ھۆججەت	hød͡ʒːɛt
مۇراسىم	murasim
تارتىپ	tartip
بۇيان	bujan
پەسىل	pɛsil
مەزگىل	mɛzɡil
شەرت	ʃɛrt
بۇيرۇق	bujruq
چەك	t͡ʃɛk
دەرمان	dɛrman
باھا	baha
جادۇگەر	d͡ʒaduɡɛr
يات	jat
پىششىق	piʃːiq
ساڭ	saŋ
ئامبار	ʔambar
تىن	tin
ئارقىلىق	ʔarqiliq
پوست	post
ساۋۇت	sawut
كەلگۈسى	kɛlɡysi
ھازىرقى	hazirqi
بۇ	bu
يولداش	joldaʃ
ئاداۋەت	ʔadawɛt
چاكار	t͡ʃakar
مالاي	malaj
قۇل	qul
مېغىز	meʁiz
قايسى	qajsi
تۇتقۇن	tutqun
ئادەمزات	ʔadɛmzat
ئابروي	ʔabroj
نوپۇز	nopuz
ئارزۇ	ʔarzu
تالانت	talant
تىرىكچىلىك	tirikt͡ʃilik
ئىلتىپات	ʔiltipat
ۋىجدان	wid͡ʒdan
سايە	sajɛ
خۇن	xun
خادىم	xadim
ئاھالە	ʔahalɛ
كەيپىيات	kɛjpijat
ئۈلۈش	ʔylyʃ
كىشى	kiʃi
توي	toj
ئاتا-ئانا	ʔata-ʔana
يورۇقلۇق	joruqluq
تىك	tik
پايتەخت	pajtɛxt
تەڭ	tɛŋ
سپورا	spora
مەھسۇلات	mɛhsulat
تانسا	tansa
مۇناسىۋەت	munasiwɛt
روھ	roh
ئەجەل	ʔɛd͡ʒɛl
مەرھۇم	mɛrhum
چوڭقۇر	t͡ʃoŋqur
قۇدۇق	quduq
پاكار	pakar
قەرز	qɛrz
چىقىم	t͡ʃiqim
زىيان	zijan
ئۈنۈم	ʔynym
نۇقتا	nuqta
ۋەزىيەت	wɛzijɛt
ئەھۋال	ʔɛhwal
مەسىلە	mɛsilɛ
مەھكىمە	mɛhkimɛ
مىسال	misal
ۋەقە	wɛqɛ
دەۋا	dɛwa
سىيىر	sijir
چاتاق	t͡ʃataq
ئوبزورچى	ʔobzort͡ʃi
پۈتۈكچى	pytykt͡ʃi
سومكا	somka
توقسان	toqsan
دەرىجە	dɛrid͡ʒɛ
يولۇچى	jolut͡ʃi
تون	ton
نوتا	nota
بىغەم	biʁɛm
ساز	saz
قۇياش	qujaʃ
ئالماش	ʔalmaʃ
ئاشۇ	ʔaʃu
مەجبۇرىيەت	mɛd͡ʒburijɛt
بۇرچ	burt͡ʃ
ھەققانىيەت	hɛqːanijɛt
مەنە	mɛnɛ
ئادالەت	ʔadalɛt
ئۇزۇن	ʔuzun
نەسىر	nɛsir
نەۋرە	nɛwrɛ
تېما	tema
ھاكىمىيەت	hakimijɛt
چارە	t͡ʃarɛ
كېڭەش	keŋɛʃ
تەدبىر	tɛdbir
مۇدىر	mudir
يېقىن	jeqin
باي	baj
چىرايلىق	t͡ʃirajliq
يۇمشاق	jumʃaq
قېلىن	qelin
ئازادە	ʔazadɛ
ئادىل	ʔadil
چاك	t͡ʃak
ئاساس	ʔasas
ئۆت	ʔøt
فورما	forma
مۇھىم	muhim
مەركەز	mɛrkɛz
دەل	dɛl
مىجەز	mid͡ʒɛz
قامەت	qamɛt
يالغۇز	jalʁuz
بوي	boj
رەھىمسىز	rɛhimsiz
يىپ	jip
سىم	sim
تور	tor
مەجمۇئە	mɛd͡ʒmuʔɛ
تىجارەتچى	tid͡ʒarɛtt͡ʃi
ئىش	ʔiʃ
خوجايىن	xod͡ʒajin
مۈلۈك	mylyk
سانائەت	sanaʔɛt
ئىگىلىك	ʔiɡilik
ئېدىر	ʔedir
ئەسىر	ʔɛsir
مۇئامىلە	muʔamilɛ
ئۆرپ-ئادەت	ʔørp-ʔadɛt
دەۋر	dɛwr
ئالاھىدىلىك	ʔalahidilik
زورلۇق	zorluq
زالىم	zalim
دىكتاتۇرا	diktatura
ئالىم	ʔalim
ۋىلايەت	wilajɛt
تەلەت	tɛlɛt
بەتبەشىرە	bɛtbɛʃirɛ
شەرمەندە	ʃɛrmɛndɛ
دوستلۇق	dostluq
توغرا	toʁra
بىراق	biraq
ئىمزاسىز	ʔimzasiz
ئاساسسىز	ʔasasːiz
نومۇسسىز	nomusːiz
ئارسىز	ʔarsiz
رەتسىز	rɛtsiz
شۇملۇق	ʃumluq
مۇناسىۋەتسىز	munasiwɛtsiz
قانۇنسىز	qanunsiz
يېقىندا	jeqinda
كەيپسىز	kɛjpsiz
چارىسىز	t͡ʃarisiz
ماغدۇرسىز	maʁdursiz
دەرمانسىز	dɛrmansiz
تەڭسىز	tɛŋsiz
بىلىمسىز	bilimsiz
ۋاپاسىز	wapasiz
ئوبدان	ʔobdan
رەسۋا	rɛswa
ئۇياتسىز	ʔujatsiz
كارامەت	karamɛt
يوشۇرۇن	joʃurun
خۇپىيانە	xupijanɛ
پايدىسىز	pajdisiz
يامان	jaman
مەنىسىز	mɛnisiz
رەھىمسىزلىك	rɛhimsizlik
نارازىلىق	naraziliq
ئادالەتسىزلىك	ʔadalɛtsizlik
ئادالەتسىز	ʔadalɛtsiz
ئىپلاس	ʔiplas
ماكان	makan
خەۋەر	xɛwɛr
نەتىجە	nɛtid͡ʒɛ
ياردەمچى	jardɛmt͡ʃi
ئاست	ʔast
چۈشتىن كېيىن	t͡ʃyʃtin kejin
چاكىنا	t͡ʃakina
يەر	jɛr
تۆۋەن	tøwɛn
ئۈستۈنلۈك	ʔystynlyk
ئەرز	ʔɛrz
پايدا	pajda
مەنپەئەت	mɛnpɛʔɛt
تۆر	tør
بۇلتۇر	bultur
ئاللا	ʔalːa
لېنتا	lenta
چۈشتىن بۇرۇن	t͡ʃyʃtin burun
ئوتتۇز	ʔotːuz
نۇرغۇن	nurʁun
كۆپ	køp
يىگىت	jiɡit
ئەركەك	ʔɛrkɛk
بوۋاي	bowaj
ئەرۋاھ	ʔɛrwah
قاتتىق	qatːiq
سۆزسىز	søzsiz
تەرتىپسىز	tɛrtipsiz
جان	d͡ʒan
رەت	rɛt
جەمەت	d͡ʒɛmɛt
ئۇدۇل	ʔudul
چەكسىز	t͡ʃɛksiz
ھازىر	hazir
ماھىر	mahir
تولۇق	toluq
گۇرۇپپا	ɡurupːa
ئۆز	ʔøz
شۈبھىسىز	ʃybhisiz
خېلى	xeli
ئېنىق	ʔeniq
ئۇچ	ʔut͡ʃ
بىرگە	birɡɛ
ساپ	sap
تېخىمۇ	teximu
يېرىم	jerim
مىڭ	miŋ
ئاتوم	ʔatom
مۇناسىۋەتلىك	munasiwɛtlik
تېز	tez
باشقا	baʃqa
تېلېۋىزور	telewizor
دېڭىزچى	deŋizt͡ʃi
چىنە	t͡ʃinɛ
كۆينەك	køjnɛk
تەر	tɛr
خلور	xlor
ئازوت	ʔazot
رادون	radon
نېئون	neʔon
شار	ʃar
ئوغا	ʔoʁa
مارال	maral
ماۋۇ	mawu
ئاچ	ʔat͡ʃ
ياۋرو	jawro
ئاراچ	ʔarat͡ʃ
ئۇقۇم	ʔuqum
يوتقان	jotqan
تۇت	tut
تومۇر	tomur
ياڭاق	jaŋaq
ئىشكاپ	ʔiʃkap
ئاپېلسىن	ʔapelsin
لىمون	limon
چىغ	t͡ʃiʁ
مېۋە-چېۋە	mewɛ-t͡ʃewɛ
ياستۇق	jastuq
دېۋىرقاي	dewirqaj
ئىستاكان	ʔistakan
تېرەك	terɛk
ماددا	madːa
سىزىق	siziq
ئەينۇلا	ʔɛjnula
سۈپەتسىز	sypɛtsiz
پىلىموت	pilimot
مۇشۇ	muʃu
ياغاچچىلىق	jaʁat͡ʃːiliq
ئەتىرگۈل	ʔɛtirɡyl
چۈچۈك	t͡ʃyt͡ʃyk
گۈگۈم	ɡyɡym
ئىسسىق	ʔisːiq
راك	rak
ھاراق	haraq
سانجى	sand͡ʒi
تېخى	texi
مۇددەتسىز	mudːɛtsiz
قائىدىسىز	qaʔidisiz
گۇناھسىز	ɡunahsiz
ياراقسىز	jaraqsiz
مەزمۇنسىز	mɛzmunsiz
سانسىز	sansiz
نەتىجىسىز	nɛtid͡ʒisiz
ئۈنۈمسىز	ʔynymsiz
شەكىلسىز	ʃɛkilsiz
تۇغماسلىق	tuʁmasliq
تاۋۇشسىز	tawuʃsiz
نامسىز	namsiz
ھېچكىم	het͡ʃkim
ساياھەتچى	sajahɛtt͡ʃi
ساياھەت	sajahɛt
يىلتىز	jiltiz
ئىچىملىك	ʔit͡ʃimlik
توما	toma
يادنامە	jadnamɛ
ماقالە	maqalɛ
تېكىست	tekist
قامچا	qamt͡ʃa
دەرسلىك	dɛrslik
مائارىپ	maʔarip
دىكتور	diktor
ماتور	mator
كېمە	kemɛ
ئىسراپخورلۇق	ʔisrapxorluq
يەكۈن	jɛkyn
ئال	ʔal
تولۇقسىز	toluqsiz
مۇشت	muʃt
لاتىن	latin
سېلىق	seliq
پاسپورت	pasport
ئۇيات	ʔujat
تېخنىكا	texnika
كۇلۇچ	kulut͡ʃ
بىلەيزۈك	bilɛjzyk
ئامبۇر	ʔambur
تاياق	tajaq
چامادان	t͡ʃamadan
تىرناق	tirnaq
قولقاپ	qolqap
مۈلۈكچىلىك	mylykt͡ʃilik
ھۇجۇم	hud͡ʒum
ئۈزۈك	ʔyzyk
كۆزقاراش	køzqaraʃ
توغرىلىق	toʁriliq
سەزگۈ	sɛzɡy
سۆيگۈ	søjɡy
بىكارچىلىق	bikart͡ʃiliq
كېسەللىك	kesɛlːik
قۇچاق	qut͡ʃaq
قىمىز	qimiz
سۈرئەت	syrʔɛt
ئەندىشە	ʔɛndiʃɛ
قايغۇ	qajʁu
غەزەپ	ʁɛzɛp
تۇيغۇ	tujʁu
مەيدە	mɛjdɛ
ئېقىن	ʔeqin
ئاۋۇ	ʔawu
ئەستىلىك	ʔɛstilik
سىجىللىق	sid͡ʒilːiq
خوردا	xorda
راسخوت	rasxot
خىراجەت	xirad͡ʒɛt
جۈمەك	d͡ʒymɛk
مېيىپلىك	mejiplik
كېرەكسىز	kerɛksiz
قۇربان	qurban
قۇلان	qulan
كۇلون	kulon
تېرىقچى	teriqt͡ʃi
ئېكىن	ʔekin
يۇمۇر	jumur
ئېڭىز	ʔeŋiz
ئوزۇق	ʔozuq
ئوتۇن	ʔotun
قاق	qaq
زەنجىر	zɛnd͡ʒir
پاراسەت	parasɛt
پارا	para
پاشا	paʃa
چېدىر	t͡ʃedir
سەدىقە	sɛdiqɛ
چاقىرىم	t͡ʃaqirim
ئاقچا	ʔaqt͡ʃa
مەڭىز	mɛŋiz
سول	sol
راۋان	rawan
گۇمپا	ɡumpa
قۇرۇلۇش	quruluʃ
ئايلىق	ʔajliq
تاشلىق	taʃliq
ئوغلاق	ʔoʁlaq
مەنسۇپ	mɛnsup
تارتما	tartma
يولسىز	jolsiz
قات	qat
كاسا	kasa
تاپ	tap
ئازچىلىق	ʔazt͡ʃiliq
پروزا	proza
خەمەك	xɛmɛk
مارجان	mard͡ʒan
كۈچۈك	kyt͡ʃyk
موزاي	mozaj
كەپسىز	kɛpsiz
يۈزە	jyzɛ
مېھىرسىز	mehirsiz
مىسقال	misqal
زىچلىق	zit͡ʃliq
تەييارتاپ	tɛjːartap
ئىدىش	ʔidiʃ
چېھرە	t͡ʃehrɛ
قۇشقاچ	quʃqat͡ʃ
ئۇرۇقداشلىق	ʔuruqdaʃliq
ئوردا	ʔorda
سوتچى	sott͡ʃi
سوت	sot
تەجرىبە	tɛd͡ʒribɛ
چىۋىن	t͡ʃiwin
ئەمەلدار	ʔɛmɛldar
پارازىت	parazit
كائىنات	kaʔinat
تەلىمات	tɛlimat
ئوقۇغۇچى	ʔoquʁut͡ʃi
كۆرسەتكۈچ	kørsɛtkyt͡ʃ
پەن	pɛn
توز	toz
دان	dan
ئارازلىق	ʔarazliq
گۇمان	ɡuman
يالپۇز	jalpuz
جەرىمانە	d͡ʒɛrimanɛ
ئەلەم	ʔɛlɛm
روھسىز	rohsiz
فامىلە	familɛ
قىزچاق	qizt͡ʃaq
موماي	momaj
شۇنداق	ʃundaq
تاماشا	tamaʃa
پاھىشە	pahiʃɛ
ئىرىمچىك	ʔirimt͡ʃik
ئارقان	ʔarqan
مۇكاپات	mukapat
ئويمانلىق	ʔojmanliq
ئەقىل	ʔɛqil
ئاپتاپ	ʔaptap
خاتىرجەملىك	xatird͡ʒɛmlik
رەپىقە	rɛpiqɛ
قاراڭغۇلۇق	qaraŋʁuluq
كىلىمات	kilimat
مەھەل	mɛhɛl
كونسىپىك	konsipik
مىلتىق	miltiq
ئۇۋا	ʔuwa
ئەتىياز	ʔɛtijaz
خام	xam
شۇنچىلىك	ʃunt͡ʃilik
موما	moma
مۇخبىر	muxbir
چەينەك	t͡ʃɛjnɛk
چۆگۈن	t͡ʃøɡyn
شاكال	ʃakal
داڭق	daŋq
تەكچە	tɛkt͡ʃɛ
تاشقىن	taʃqin
دۇمباق	dumbaq
خوتۇن	xotun
نېگىز	neɡiz
تەگ	tɛɡ
بازا	baza
نومۇس	nomus
يېرىق	jeriq
تەڭگە	tɛŋɡɛ
كوي	koj
سوم	som
كۆلەم	kølɛm
شارائىت	ʃaraʔit
خامان	xaman
لەڭگەر	lɛŋɡɛr
ئېرىق	ʔeriq
مەرتىۋە	mɛrtiwɛ
تامچى	tamt͡ʃi
ئورا	ʔora
سۇغۇر	suʁur
تۇپراق	tupraq
تامچە	tamt͡ʃɛ
دائىرە	daʔirɛ
ئاتلاس	ʔatlas
تۇلپار	tulpar
ئوي	ʔoj
مىللەت	milːɛt
مىللىي	milːij
مەملىكەت	mɛmlikɛt
ئەل	ʔɛl
قىيىن	qijin
ئۇيقۇ	ʔujqu
ئىتتىپاقلىق	ʔitːipaqliq
كاللەك	kalːɛk
تەشكىلات	tɛʃkilat
شۇڭا	ʃuŋa
چۈنكى	t͡ʃynki
كان	kan
گۇندىخانا	ɡundixana
پەرمان	pɛrman
فونتان	fontan
ئاياغ	ʔajaʁ
مەرىكە	mɛrikɛ
بەختلىك	bɛxtlik
مەرگەن	mɛrɡɛn
تونۇش	tonuʃ
يەرمەنكە	jɛrmɛnkɛ
تاۋار	tawar
كۈچ	kyt͡ʃ
سېرىق دېڭىز	seriq deŋiz
ھاك تېشى	hak teʃi
لاتىنچە	latint͡ʃɛ
تۈركمەنچە	tyrkmɛnt͡ʃɛ
تۈركچە	tyrkt͡ʃɛ
پولەكچە	polɛkt͡ʃɛ
پارسچە	parst͡ʃɛ
ناخشىچى	naxʃit͡ʃi
ناسوس	nasos
ئورۇنسىز	ʔorunsiz
پەيلاسوپ	pɛjlasop
ۋوي	woj
تىلسىز	tilsiz
ئاققۇ	ʔaqːu
قوڭغۇراق	qoŋʁuraq
تاۋۇش	tawuʃ
ئۈن	ʔyn
تىۋىش	tiwiʃ
قۇمۇل	qumul
شال	ʃal
قېنى	qeni
سورت	sort
يۆتەل	jøtɛl
مەدھىيە	mɛdhijɛ
خېمىر	xemir
ئىللىق	ʔilːiq
تەشۋىش	tɛʃwiʃ
قۇلۇن	qulun
چەمبەر	t͡ʃɛmbɛr
ھوي	hoj
پوچى	pot͡ʃi
ئارمان	ʔarman
پاھ	pah
يېتەكچى	jetɛkt͡ʃi
ئويدۇرما	ʔojdurma
نۇقسان	nuqsan
مېۋە	mewɛ
كەچ	kɛt͡ʃ
قۇيرۇق	qujruq
ئارقا	ʔarqa
يېزىق	jeziq
زامانداش	zamandaʃ
ساۋاقداش	sawaqdaʃ
پەرۋاسىزلىق	pɛrwasizliq
جىنايەت	d͡ʒinajɛt
جىپ	d͡ʒip
قۇتلۇق	qutluq
قىرغىز	qirʁiz
ياخشىلىق	jaxʃiliq
خور	xor
قوماندان	qomandan
ئۈست	ʔyst
تاختا	taxta
سەھنە	sɛhnɛ
قىزىقارلىق	qiziqarliq
ماقۇل	maqul
قۇر	qur
بىخ	bix
تاغار	taʁar
نېسىۋە	nesiwɛ
تۇمشۇق	tumʃuq
ئېچىتقۇ	ʔet͡ʃitqu
فاكتور	faktor
ئارچا	ʔart͡ʃa
مەسلىھەت	mɛslihɛt
ھاكىم	hakim
نور	nor
ساندۇق	sanduq
بىنا	bina
ئىمارەت	ʔimarɛt
دالا	dala
تۈزلەڭلىك	tyzlɛŋlik
بايلىق	bajliq
بېسىم	besim
مۇساپە	musapɛ
جەريان	d͡ʒɛrjan
زال	zal
بۆلۈم	bølym
ئىز	ʔiz
سەھىيە	sɛhijɛ
تازىلىق	taziliq
ياتاق	jataq
شور	ʃor
چامغۇر	t͡ʃamʁur
قالۇن	qalun
قاراۋۇل	qarawul
مۇزېي	muzej
سالتاڭ	saltaŋ
نېپىز	nepiz
داستىخان	dastixan
مىسلىسىز	mislisiz
يايى	jaji
كېلىشىم	keliʃim
ئىتتىپاق	ʔitːipaq
قىرىق	qiriq
مەيدان	mɛjdan
ياي	jaj
چۈشلۈك	t͡ʃyʃlyk
كىلو	kilo
شىپاخانا	ʃipaxana
مېدىتسىنا	meditsina
رايون	rajon
تۈرداش	tyrdaʃ
تۇياق	tujaq
قاراقچى	qaraqt͡ʃi
ياغاچچى	jaʁat͡ʃːi
ئارقار	ʔarqar
شىمالىي	ʃimalij
شىمال	ʃimal
خىمىيە	ximijɛ
قاپاق	qapaq
رومال	romal
مانتا	manta
تاي	taj
قىلمىش	qilmiʃ
چىن	t͡ʃin
تىرىشچان	tiriʃt͡ʃan
ئۇل	ʔul
قوۋۇرغا	qowurʁa
دادىل	dadil
ھەيۋە	hɛjwɛ
توسالغۇسىز	tosalʁusiz
ئىشارەت	ʔiʃarɛt
زېھىن	zehin
جاپا	d͡ʒapa
تەقدىر	tɛqdir
شاگىرت	ʃaɡirt
كۈرەك	kyrɛk
زۆرۈر	zøryr
ئىتتىپاقداش	ʔitːipaqdaʃ
ساۋاق	sawaq
ئاتاق	ʔataq
قۇۋۋەت	quwːɛt
ئىقتىدار	ʔiqtidar
قايچا	qajt͡ʃa
قوشۇمچە	qoʃumt͡ʃɛ
تىياتىرخانا	tijatirxana
تىياتىر	tijatir
مەنزىل	mɛnzil
زاۋۇت	zawut
بۇلاپكا	bulapka
چۈشىنىكسىز	t͡ʃyʃiniksiz
لەقەم	lɛqɛm
ئاران	ʔaran
پىلان	pilan
شىڭ	ʃiŋ
ئاپەت	ʔapɛt
چالغا	t͡ʃalʁa
تارماق	tarmaq
شەمشەر	ʃɛmʃɛr
ئىستىقبال	ʔistiqbal
پورت	port
بۇلۇڭ	buluŋ
يوچۇق	jot͡ʃuq
يامانلىق	jamanliq
قەمەر	qɛmɛr
قەھرىمان	qɛhriman
قەدەم	qɛdɛm
قانچىلىك	qant͡ʃilik
قاچان	qat͡ʃan
جانسىز	d͡ʒansiz
نورما	norma
شىۋاق	ʃiwaq
ئۈششۈك	ʔyʃːyk
ھۆكۈم	høkym
نىيەت	nijɛt
بازغان	bazʁan
ئاپتومات	ʔaptomat
تۆشۈك	tøʃyk
ماروژنى	maroʒni
تېرىقچىلىق	teriqt͡ʃiliq
ئالدىراش	ʔaldiraʃ
تىزىم	tizim
تېزىس	tezis
مەزمۇن	mɛzmun
بېلىقچىلىق	beliqt͡ʃiliq
سۆزلۈك	søzlyk
ئۇنداق	ʔundaq
پىيادە	pijadɛ
غەيرەت	ʁɛjrɛt
خۇمار	xumar
توسالغۇ	tosalʁu
پەيت	pɛjt
توغرىسىدا	toʁrisida
جامائەتچىلىك	d͡ʒamaʔɛtt͡ʃilik
ئۈستەل	ʔystɛl
فورمۇلا	formula
ساراي	saraj
توننا	tonːa
مىنىستىر	ministir
ئاۋام	ʔawam
ئار	ʔar
جامائەت	d͡ʒamaʔɛt
بۇرۇت	burut
ئاپتوماتىك	ʔaptomatik
ئومۇم	ʔomum
پارتىيە	partijɛ
كىشمىش	kiʃmiʃ
گرام	ɡram
تاقىر	taqir
شەرەپ	ʃɛrɛp
يورۇقلۇق يىلى	joruqluq jili
تەقسىر	tɛqsir
ئوقۇتقۇچى	ʔoqutqut͡ʃi
بالدۇر	baldur
ئالدىن	ʔaldin
ئالدى	ʔaldi
مارشال	marʃal
دوللار	dolːar
تۈپ	typ
ئەسكەر	ʔɛskɛr
ئويۇن	ʔojun
ئۆلىما	ʔølima
سۈرەت	syrɛt
ئوبراز	ʔobraz
ئەخمەق	ʔɛxmɛq
تاڭ	taŋ
ئۇستاز	ʔustaz
غارايىپ	ʁarajip
چاڭ	t͡ʃaŋ
ئوغرى	ʔoʁri
ئەزىمەت	ʔɛzimɛt
چەت	t͡ʃɛt
سۆلەت	sølɛt
يۈزلىنىش	jyzliniʃ
كىرىم	kirim
ئولجا	ʔold͡ʒa
رېمونت	remont
دانا	dana
سەۋىيە	sɛwijɛ
تەربىيە	tɛrbijɛ
پوپ	pop
مەلۇمات	mɛlumat
ئاخبارات	ʔaxbarat
يېڭىلىق	jeŋiliq
لەۋز	lɛwz
ئىشەنچ	ʔiʃɛnt͡ʃ
كاپالەتنامە	kapalɛtnamɛ
كېپىل	kepil
ئىشەنچسىز	ʔiʃɛnt͡ʃsiz
پاكىز	pakiz
ئوڭاي	ʔoŋaj
ئاسان	ʔasan
يان	jan
پۇتاق	putaq
قائىدە	qaʔidɛ
جىيەن	d͡ʒijɛn
ئوڭ	ʔoŋ
كادىر	kadir
مانا	mana
ئاپتور	ʔaptor
ئەمگەك	ʔɛmɡɛk
مەشغۇلات	mɛʃʁulat
تەسىر	tɛsir
داشقال	daʃqal
ئېغىرلىق	ʔeʁirliq
گىمناستىكا	ɡimnastika
جۇغ	d͡ʒuʁ
چۈشەنچە	t͡ʃyʃɛnt͡ʃɛ
تەسىرات	tɛsirat
ژانىر	ʒanir
تەن	tɛn
تۈر	tyr
جىلغا	d͡ʒilʁa
جاي	d͡ʒaj
ئىزاھ	ʔizah
لېكىن	lekin
ئەمما	ʔɛmːa
ئا ق ش	ʔa q ʃ
توكېلاۋ	tokelaw
نېگىر	neɡir
رامزان	ramzan
قازاق	qazaq
كسېنون	ksenon
ئىتتېربىي	ʔitːerbij
پرازېئودىمىي	prazeʔodimij
لانتان	lantan
پروتاكتىنىي	protaktinij
دىسپروزىي	disprozij
كادمىي	kadmij
ئېينشتېينىي	ʔejnʃtejnij
مانگان	manɡan
تېخېتىسىي	texetisij
گېرمانىي	ɡermanij
سىركونىي	sirkonij
رېنىي	renij
لاۋرېنسىي	lawrensij
رۇبىدىي	rubidij
سېزىي	sezij
گافنىي	ɡafnij
ئىندىي	ʔindij
يېۋروپىي	jewropij
ئېربىي	ʔerbij
رودىي	rodij
بېرىللىي	berilːij
نىئوبىي	niʔobij
سېرىي	serij
سكاندىي	skandij
كالتىسىي	kaltisij
رۇتېنىي	rutenij
قۇرت	qurt
ئىنگلىز	ʔinɡliz
پاقلان	paqlan
ئىقتىساد	ʔiqtisad
تېللۇر	telːur
سېلېن	selen
قەنت	qɛnt
ئەر كىشى	ʔɛr kiʃi
خلور گازى	xlor ɡazi
ياخشىمۇسىز	jaxʃimusiz
مەدەنىيەت	mɛdɛnijɛt
پلانېتا	planeta
قۇياش سىستېمىسى	qujaʃ sistemisi
سان تومې ۋە پرىنسىپې	san tome wɛ prinsipe
ساتۇرن	saturn
ۋېلىسىپىت	welisipit
ئون ئىككى	ʔon ʔikːi
ئون بىر	ʔon bir
خروم	xrom
جۈي	d͡ʒyj
سوۋغات	sowʁat
يېلىن	jelin
كىتابخانا	kitabxana
ئاۋۋال	ʔawːal
ئېڭەك	ʔeŋɛk
ليۇكسېمبۇرگ	ljuksemburɡ
ئىسپانچە	ʔispant͡ʃɛ
چېلىش	t͡ʃeliʃ
ئامبال	ʔambal
سائەتچى	saʔɛtt͡ʃi
قۇلاي	qulaj
پولەك	polɛk
ئاتەش	ʔatɛʃ
ساداقەتسىز	sadaqɛtsiz
ھارام	haram
پارس	pars
ئەيسا مەسىھ	ʔɛjsa mɛsih
بارس	bars
سوئلا	soʔla
ئىقبال	ʔiqbal
تانكا	tanka
زاكات	zakat
كورىيە	korijɛ
ئىشقارلىق	ʔiʃqarliq
ئالەم ئايرۇپىلانى	ʔalɛm ʔajrupilani
ئاپتوبوس	ʔaptobos
ئۆيدە	ʔøjdɛ
خىتاي	xitaj
ئايگۈل	ʔajɡyl
ۋىتامىن	witamin
دېرىزە	derizɛ
ئاق ئالتۇن	ʔaq ʔaltun
تەخسە	tɛxsɛ
مېركۇرىي	merkurij
ۋاتىكان شەھىرى	watikan ʃɛhiri
گرېتسىيە	ɡretsijɛ
مائاش	maʔaʃ
ئۈمىد	ʔymid
ئاسترونومىيە	ʔastronomijɛ
سىياھ	sijah
شاھمات	ʃahmat
جاۋاب	d͡ʒawab
دراما	drama
باغچا	baʁt͡ʃa
قوشنا	qoʃna
سەمەرقەند	sɛmɛrqɛnd
تەڭرىتاغ	tɛŋritaʁ
ئىقتىسادشۇناسلىق	ʔiqtisadʃunasliq
كەشمىر	kɛʃmir
سامان يولى سىستىمېسى	saman joli sistimesi
زايىر	zajir
شۇنداقتىمۇ	ʃundaqtimu
كۈزگى	kyzɡi
ئىجارە	ʔid͡ʒarɛ
دە-	dɛ-
ئاتمىش	ʔatmiʃ
ئامېرىكىلىق	ʔamerikiliq
مۇھەممەد	muhɛmːɛd
-	-
ئاسايىش	ʔasajiʃ
خاتىر	xatir
تېتىر	tetir
تۈگۈچ	tyɡyt͡ʃ
ئەيىپسىز	ʔɛjipsiz
ئالبان	ʔalban
بىيە	bijɛ
سىزىقسىز	siziqsiz
تىككۈچى	tikːyt͡ʃi
سوقا	soqa
غوللۇق	ʁolːuq
ئىنتىزامسىزلىق	ʔintizamsizliq
چۇۋاش تىلى	t͡ʃuwaʃ tili
سكوپليې	skoplje
ئوسمان ئىمپېرىيىسى	ʔosman ʔimperijisi
دەمەشىق	dɛmɛʃiq
قاڭشارلىق بۆكەن	qaŋʃarliq bøkɛn
تاللىن	talːin
كرودىيە	krodijɛ
ھېكايە	hekajɛ
ئەرمەن تىلى	ʔɛrmɛn tili
ئوردو تىلى	ʔordo tili
جۇڭخۇا خەلق جۇمھۇرىيىتى	d͡ʒuŋxua xɛlq d͡ʒumhurijiti
رومىنىيە	rominijɛ
ئالبانچە	ʔalbant͡ʃɛ
دۇنيا تىلى	dunja tili
چېخچە	t͡ʃext͡ʃɛ
جەنۇبىي ئامېرىكا	d͡ʒɛnubij ʔamerika
چام	t͡ʃam
ئەرمەن	ʔɛrmɛn
مانجۇچە	mand͡ʒut͡ʃɛ
كۈركۈم گۈلى	kyrkym ɡyli
سوغۇق ئۇرۇش	soʁuq ʔuruʃ
ئۈزۈم ھارىقى	ʔyzym hariqi
قورقۇش	qorquʃ
ﺑﯧﻴﺠﯩﯔ	ﺑﯧﻴﺠﯩﯔ
مېھراپ	mehrap
مۈشك	myʃk
چىمەن	t͡ʃimɛn
زىپ	zip
قاڭشارلىق	qaŋʃarliq
پوتلا	potla
ناغرىچى	naʁrit͡ʃi
تەرغىباتچى	tɛrʁibatt͡ʃi
كەشتىچىلىك	kɛʃtit͡ʃilik
ئۇرۇشقاق	ʔuruʃqaq
تادان	tadan
دوسكا	doska
جۇت	d͡ʒut
