# Baby names
अनिया	ਅਨਿਯਾ
आकर्षक	ਆਕਰ੍ਸ਼ਕ
आघोश	ਆਘੋਸ਼
आदम्य	ਆਦਮ੍ਯ
आदर्श	ਆਦਰ੍ਸ਼
आदित्व	ਆਦਿਤ੍ਵ
आदिया	ਆਦਿਯਾ
आदीजय	ਆਦੀਜਯ
आधाव	ਆਧਾਵ
आधीरेन	ਆਧੀਰੇਨ
आध्या	ਆਧ੍ਯਾ
आन	ਆਨ
आनंत्या	ਆਨੰਤ੍ਯਾ
आनंदित	ਆਨੰਦਿਤ
आनाधीता	ਆਨਾਧੀਤਾ
आनाया	ਆਨਾਯਾ
आन्वी	ਆਨ੍ਵੀ
आभात	ਆਭਾਤ
आमोघ	ਆਮੋਘ
आमोदीन	ਆਮੋਦੀਨ
आर	ਆਰ
आराड्या	ਆਰਾਡ੍ਯਾ
आराधक	ਆਰਾਧਕ
आराधना	ਆਰਾਧਨਾ
आराध्य	ਆਰਾਧ੍ਯ
आरीन	ਆਰੀਨ
आर्ना	ਆਰ੍ਨਾ
आल्या	ਆਲ੍ਯਾ
आहलादिता	ਆਹਲਾਦਿਤਾ
इंदिरा	ਇਂਦਿਰਾ
इंदुकला	ਇਂਦੁਕਲਾ
इंदुजा	ਇਂਦੁਜਾ
इंदुभूषण	ਇਂਦੁਭੂਸ਼ਣ
इंदुलाला	ਇਂਦੁਲਾਲਾ
इकंश	ਇਕੰਸ਼
इक्शु	ਇਕ੍ਸ਼ੁ
इक्षित	ਇਕ੍ਸ਼ਿਤ
इक्सुरा	ਇਕ੍ਸੁਰਾ
इदित्री	ਇਦਿਤ੍ਰੀ
इधित्री	ਇਧਿਤ੍ਰੀ
इन्गनाम	ਇਨ੍ਗਨਾਮ
इन्दिवारस	ਇਨ੍ਦਿਵਾਰਸ
इन्दुप्रभा	ਇਨ੍ਦੁਪ੍ਰਭਾ
इन्दुमत	ਇਨ੍ਦੁਮਤ
इन्दुमांथी	ਇਨ੍ਦੁਮਾਂਥੀ
इन्द्रदयुम्न	ਇਨ੍ਦ੍ਰਦਯੁਮ੍ਨ
इन्द्रसेन	ਇਨ੍ਦ੍ਰਸੇਨ
इरावत	ਇਰਾਵਤ
इरित	ਇਰਿਤ
इलंपीरई	ਇਲੰਪੀਰਈ
इलावेनिल	ਇਲਾਵੇਨਿਲ
इष्टा	ਇਸ਼੍ਟਾ
इसार	ਇਸਾਰ
इह्सान	ਇਹ੍ਸਾਨ
ईज्या	ਈਜ੍ਯਾ
ईझ्रीने	ਈਝ੍ਰੀਨੇ
ईदी	ਈਦੀ
ईम्पाल	ਈਮ੍ਪਾਲ
ईरीन	ਈਰੀਨ
ईरीश	ਈਰੀਸ਼
ईलापताये	ਈਲਾਪਤਾਯੇ
ईल्लीशा	ਈਲ੍ਲੀਸ਼ਾ
ईशान	ਈਸ਼ਾਨ
ईशानी	ਈਸ਼ਾਨੀ
ईश्वर	ਈਸ਼੍ਵਰ
ईसैवलन	ਈਸੈਵਲਨ
उग्रस्रवास	ਉਗ੍ਰਸ੍ਰਵਾਸ
उग्रेश	ਉਗ੍ਰੇਸ਼
उच्चल	ਉਚ੍ਚਲ
उजाला	ਉਜਾਲਾ
उज्जवल	ਉਜ੍ਜਵਲ
उज्ज्वला /उज्वला	ਉਜ੍ਜ੍ਵਲਾ /ਉਜ੍ਵਲਾ
उज्वल	ਉਜ੍ਵਲ
उदय कुमार	ਉਦਯ ਕੁਮਾਰ
उदयसूरियाँ	ਉਦਯਸੂਰਿਯਾਁ
उदीता	ਉਦੀਤਾ
उद्गिता	ਉਦ੍ਗਿਤਾ
उद्दीप्ता	ਉਦ੍ਦੀਪ੍ਤਾ
उद्वंश	ਉਦ੍ਵੰਸ਼
उननीका	ਉਨਨੀਕਾ
उन्जली	ਉਨ੍ਜਲੀ
उन्नाथी	ਉਨ੍ਨਾਥੀ
उन्न्य	ਉਨ੍ਨ੍ਯ
उन्मा	ਉਨ੍ਮਾ
उपदा	ਉਪਦਾ
उमरानी	ਉਮਰਾਨੀ
उमा शंकर	ਉਮਾ ਸ਼ੰਕਰ
उमांमांहेश्वर	ਉਮਾਂਮਾਂਹੇਸ਼੍ਵਰ
उम्सीहा	ਉਮ੍ਸੀਹਾ
उरवशी	ਉਰਵਸ਼ੀ
उर्मिला	ਉਰ੍ਮਿਲਾ
उर्वरा	ਉਰ੍ਵਰਾ
उर्वशी	ਉਰ੍ਵਸ਼ੀ
उर्वा	ਉਰ੍ਵਾ
उर्वी	ਉਰ੍ਵੀ
उल्केश	ਉਲ੍ਕੇਸ਼
उषाकिरण	ਉਸ਼ਾਕਿਰਣ
ऊर्जा	ਊਰ੍ਜਾ
एअस्वरण	ਏਅਸ੍ਵਰਣ
एकक्षरपरा	ਏਕਕ੍ਸ਼ਰਪਰਾ
एकत्र	ਏਕਤ੍ਰ
एकना	ਏਕਨਾ
एकयावन	ਏਕਯਾਵਨ
एकलव्य	ਏਕਲਵ੍ਯ
एकलव्या	ਏਕਲਵ੍ਯਾ
एकांश	ਏਕਾਂਸ਼
एकाक्षा	ਏਕਾਕ੍ਸ਼ਾ
एकाग्रह	ਏਕਾਗ੍ਰਹ
एकाचक्र	ਏਕਾਚਕ੍ਰ
एकाधना	ਏਕਾਧਨਾ
एकेस्वार	ਏਕੇਸ੍ਵਾਰ
एच्चुमति	ਏਚ੍ਚੁਮਤਿ
एधा	ਏਧਾ
एलान्द्र	ਏਲਾਨ੍ਦ੍ਰ
एलीना	ਏਲੀਨਾ
एलीशा	ਏਲੀਸ਼ਾ
एवान्गेलीन	ਏਵਾਨ੍ਗੇਲੀਨ
एवोन	ਏਵੋਨ
एशांश	ਏਸ਼ਾਂਸ਼
एशान्य	ਏਸ਼ਾਨ੍ਯ
एशिका	ਏਸ਼ਿਕਾ
एश्वर	ਏਸ਼੍ਵਰ
एहीत	ਏਹੀਤ
ऑरी	ਓਰੀ
ओजस्वानी	ਓਜਸ੍ਵਾਨੀ
ओजस्वीत	ਓਜਸ੍ਵੀਤ
ओदथी	ਓਦਥੀ
ओनिश	ਓਨਿਸ਼
ओन्नेशा	ਓਨ੍ਨੇਸ਼ਾ
ओप्पिलमणि	ਓਪ੍ਪਿਲਮਣਿ
ओय्शी	ਓਯ੍ਸ਼ੀ
ओवियान	ਓਵਿਯਾਨ
ओशमां	ਓਸ਼ਮਾਂ
ओशि	ਓਸ਼ਿ
ओश्मी	ਓਸ਼੍ਮੀ
कक्षक	ਕਕ੍ਸ਼ਕ
कक्षाप	ਕਕ੍ਸ਼ਾਪ
कदंबन	ਕਦੰਬਨ
कबीलाश	ਕਬੀਲਾਸ਼
कल-हंस	ਕਲ-ਹੰਸ
कलाकांती	ਕਲਾਕਾਂਤੀ
कलाधर	ਕਲਾਧਰ
कलाप	ਕਲਾਪ
कलासावेरी	ਕਲਾਸਾਵੇਰੀ
कलिंग	ਕਲਿਂਗ
कलीयाह	ਕਲੀਯਾਹ
कलैवानी	ਕਲੈਵਾਨੀ
कल्पना	ਕਲ੍ਪਨਾ
कल्पिनी	ਕਲ੍ਪਿਨੀ
कल्मेश	ਕਲ੍ਮੇਸ਼
कल्याणी	ਕਲ੍ਯਾਣੀ
कल्लोला	ਕਲ੍ਲੋਲਾ
कहेर	ਕਹੇਰ
काजल	ਕਾਜਲ
काजाल्सरी	ਕਾਜਾਲ੍ਸਰੀ
कान्चानाध्वाजा	ਕਾਨ੍ਚਾਨਾਧ੍ਵਾਜਾ
कान्हा	ਕਾਨ੍ਹਾ
कामज	ਕਾਮਜ
कामना	ਕਾਮਨਾ
कामित	ਕਾਮਿਤ
कामोदी	ਕਾਮੋਦੀ
कारुं	ਕਾਰੁਂ
कार्तिक	ਕਾਰ੍ਤਿਕ
कार्तीकी	ਕਾਰ੍ਤੀਕੀ
काल	ਕਾਲ
कालिनी	ਕਾਲਿਨੀ
कालिमोहन	ਕਾਲਿਮੋਹਨ
काश्य	ਕਾਸ਼੍ਯ
काहीनी	ਕਾਹੀਨੀ
कुँर्र्तुलें	ਕੁਁਰ੍ਰ੍ਤੁਲੇਂ
कैकाई	ਕੈਕਾਈ
कैकेयी	ਕੈਕੇਯੀ
कैतक	ਕੈਤਕ
कैरवी	ਕੈਰਵੀ
कैषा	ਕੈਸ਼ਾ
गंगवार	ਗੰਗਵਾਰ
गंगाधरा	ਗੰਗਾਧਰਾ
गंगाह	ਗੰਗਾਹ
गंगेश	ਗੰਗੇਸ਼
गंदिवा	ਗੰਦਿਵਾ
गंधरज	ਗੰਧਰਜ
गंधा	ਗੰਧਾ
गग्नेश	ਗਗ੍ਨੇਸ਼
गजगामिनी	ਗਜਗਾਮਿਨੀ
गजबाहू	ਗਜਬਾਹੂ
गजानंद	ਗਜਾਨੰਦ
गणपत	ਗਣਪਤ
गणावी	ਗਣਾਵੀ
गति	ਗਤਿ
गनेसा	ਗਨੇਸਾ
गन्नों	ਗਨ੍ਨੋਂ
गम्या	ਗਮ੍ਯਾ
गरिमान	ਗਰਿਮਾਨ
गरिष्ट	ਗਰਿਸ਼੍ਟ
गर्विक	ਗਰ੍ਵਿਕ
गहना	ਗਹਨਾ
गांगी	ਗਾਂਗੀ
गांधिनी	ਗਾਂਧਿਨੀ
गांधी	ਗਾਂਧੀ
गान्धरिका	ਗਾਨ੍ਧਰਿਕਾ
गान्धर्व	ਗਾਨ੍ਧਰ੍ਵ
गायकाप्रिया	ਗਾਯਕਾਪ੍ਰਿਯਾ
गायले	ਗਾਯਲੇ
गारीन	ਗਾਰੀਨ
गावी	ਗਾਵੀ
गीतासरी	ਗੀਤਾਸਰੀ
गीथीका	ਗੀਥੀਕਾ
गौरीमनोहरी	ਗੌਰੀਮਨੋਹਰੀ
चंदन	ਚੰਦਨ
चंदर	ਚੰਦਰ
चंदा	ਚੰਦਾ
चंदालिनी	ਚੰਦਾਲਿਨੀ
चंद्र भान	ਚੰਦ੍ਰ ਭਾਨ
चंद्रक	ਚੰਦ੍ਰਕ
चंद्रकान्ता	ਚੰਦ੍ਰਕਾਨ੍ਤਾ
चंद्रदेव	ਚੰਦ੍ਰਦੇਵ
चंद्रन्शुं	ਚੰਦ੍ਰਨ੍ਸ਼ੁਂ
चंद्रबिंदु	ਚੰਦ੍ਰਬਿਂਦੁ
चंद्रमाधाव	ਚੰਦ੍ਰਮਾਧਾਵ
चंद्रलेक्षा	ਚੰਦ੍ਰਲੇਕ੍ਸ਼ਾ
चंद्रानन	ਚੰਦ੍ਰਾਨਨ
चंपक	ਚੰਪਕ
चंपा	ਚੰਪਾ
चकोर	ਚਕੋਰ
चक्रदेव	ਚਕ੍ਰਦੇਵ
चक्रधारीनी	ਚਕ੍ਰਧਾਰੀਨੀ
चक्रेश	ਚਕ੍ਰੇਸ਼
चक्शन	ਚਕ੍ਸ਼ਨ
चनक	ਚਨਕ
चन्द्रवादना	ਚਨ੍ਦ੍ਰਵਾਦਨਾ
चमेली	ਚਮੇਲੀ
चानक्य	ਚਾਨਕ੍ਯ
चानाक्षी	ਚਾਨਾਕ੍ਸ਼ੀ
चानास्या	ਚਾਨਾਸ੍ਯਾ
चारन	ਚਾਰਨ
चाहना	ਚਾਹਨਾ
चैन	ਚੈਨ
चैनीका	ਚੈਨੀਕਾ
छाया	ਛਾਯਾ
छायावती	ਛਾਯਾਵਤੀ
जगजीवन	ਜਗਜੀਵਨ
जगतगुरु	ਜਗਤਗੁਰੁ
जगतप्रभु	ਜਗਤਪ੍ਰਭੁ
जगदम्बा	ਜਗਦਮ੍ਬਾ
जगनमाता	ਜਗਨਮਾਤਾ
जगन्नाथ	ਜਗਨ੍ਨਾਥ
जगाती	ਜਗਾਤੀ
जग्रवी	ਜਗ੍ਰਵੀ
जनकनंदिनी	ਜਨਕਨੰਦਿਨੀ
जनिता	ਜਨਿਤਾ
जनीशा	ਜਨੀਸ਼ਾ
जबिने	ਜਬਿਨੇ
जलधि	ਜਲਧਿ
जलधीजा	ਜਲਧੀਜਾ
जल्पा	ਜਲ੍ਪਾ
ज़ैलेखा	ਜ਼ੈਲੇਖਾ
जागती	ਜਾਗਤੀ
जागवी	ਜਾਗਵੀ
जाननी	ਜਾਨਨੀ
जाह्नवी	ਜਾਹ੍ਨਵੀ
जिअना	ਜਿਅਨਾ
जैकापिश	ਜੈਕਾਪਿਸ਼
जैदेव	ਜੈਦੇਵ
जैमिल	ਜੈਮਿਲ
जैलेण	ਜੈਲੇਣ
जैलेश	ਜੈਲੇਸ਼
जैहासीनी	ਜੈਹਾਸੀਨੀ
झांजर	ਝਾਂਜਰ
झानीशा	ਝਾਨੀਸ਼ਾ
झीतीएन	ਝੀਤੀਏਨ
झीहान	ਝੀਹਾਨ
झेव	ਝੇਵ
टागोर	ਟਾਗੋਰ
डाली	ਡਾਲੀ
तंगी	ਤੰਗੀ
तंबूरा	ਤੰਬੂਰਾ
तनय	ਤਨਯ
तनाव	ਤਨਾਵ
तनिश्क	ਤਨਿਸ਼੍ਕ
तनिसी	ਤਨਿਸੀ
तनुं प्रिया	ਤਨੁਂ ਪ੍ਰਿਯਾ
तनुश्री	ਤਨੁਸ਼੍ਰੀ
तन्निष्ठा	ਤਨ੍ਨਿਸ਼੍ਠਾ
तन्मयी	ਤਨ੍ਮਯੀ
तन्वीश्री	ਤਨ੍ਵੀਸ਼੍ਰੀ
तपीश	ਤਪੀਸ਼
तपेन्द्र	ਤਪੇਨ੍ਦ੍ਰ
तप्त	ਤਪ੍ਤ
तमन	ਤਮਨ
तमसा	ਤਮਸਾ
तमाली	ਤਮਾਲੀ
तमिला	ਤਮਿਲਾ
तम्मना	ਤਮ੍ਮਨਾ
तरंत	ਤਰੰਤ
तलंक	ਤਲੰਕ
तलाव	ਤਲਾਵ
तहान	ਤਹਾਨ
तहास्वीनी	ਤਹਾਸ੍ਵੀਨੀ
ताजेन्दर	ਤਾਜੇਨ੍ਦਰ
तानाय्मी	ਤਾਨਾਯ੍ਮੀ
तानाश्वी	ਤਾਨਾਸ਼੍ਵੀ
तानीसका	ਤਾਨੀਸਕਾ
तानीस्क	ਤਾਨੀਸ੍ਕ
तानुंश्सी	ਤਾਨੁਂਸ਼੍ਸੀ
तानेश्वर	ਤਾਨੇਸ਼੍ਵਰ
तान्तव	ਤਾਨ੍ਤਵ
तान्वीतासरी	ਤਾਨ੍ਵੀਤਾਸਰੀ
तान्वेशा	ਤਾਨ੍ਵੇਸ਼ਾ
तान्श्राय	ਤਾਨ੍ਸ਼੍ਰਾਯ
तान्हिता	ਤਾਨ੍ਹਿਤਾ
तामस	ਤਾਮਸ
ताराधिश	ਤਾਰਾਧਿਸ਼
तारानाथ	ਤਾਰਾਨਾਥ
तारिणी	ਤਾਰਿਣੀ
तारीक	ਤਾਰੀਕ
तारीन	ਤਾਰੀਨ
दक्शिनयन	ਦਕ੍ਸ਼ਿਨਯਨ
दक्षायज्ञअविनाशीनी	ਦਕ੍ਸ਼ਾਯਜ੍ਞਅਵਿਨਾਸ਼ੀਨੀ
दक्षाहता	ਦਕ੍ਸ਼ਾਹਤਾ
दक्षित	ਦਕ੍ਸ਼ਿਤ
दज्शी	ਦਜ੍ਸ਼ੀ
दनूज़	ਦਨੂਜ਼
दयानीश्का	ਦਯਾਨੀਸ਼੍ਕਾ
दयामणी	ਦਯਾਮਣੀ
दयावान्ती	ਦਯਾਵਾਨ੍ਤੀ
दरिद्रा धाव्सीनी	ਦਰਿਦ੍ਰਾ ਧਾਵ੍ਸੀਨੀ
दरिद्रीयानाशीनी	ਦਰਿਦ੍ਰੀਯਾਨਾਸ਼ੀਨੀ
दर्पण	ਦਰ੍ਪਣ
दर्श	ਦਰ੍ਸ਼
दर्शिका	ਦਰ੍ਸ਼ਿਕਾ
दर्शीनीका	ਦਰ੍ਸ਼ੀਨੀਕਾ
दल	ਦਲ
दलापथी	ਦਲਾਪਥੀ
दशा	ਦਸ਼ਾ
दशाग्रीवा शीरोहरा	ਦਸ਼ਾਗ੍ਰੀਵਾ ਸ਼ੀਰੋਹਰਾ
दशाग्रीवाकुलान्ताका	ਦਸ਼ਾਗ੍ਰੀਵਾਕੁਲਾਨ੍ਤਾਕਾ
दशाबहवे	ਦਸ਼ਾਬਹਵੇ
दानवेन्द्रविनाशका	ਦਾਨਵੇਨ੍ਦ੍ਰਵਿਨਾਸ਼ਕਾ
दानास्वी	ਦਾਨਾਸ੍ਵੀ
दानीश	ਦਾਨੀਸ਼
दान्दयुंधापनी	ਦਾਨ੍ਦਯੁਂਧਾਪਨੀ
दायिनी	ਦਾਯਿਨੀ
दारुण	ਦਾਰੁਣ
दिनल	ਦਿਨਲ
दीक्षाना	ਦੀਕ੍ਸ਼ਾਨਾ
देदीप्य	ਦੇਦੀਪ੍ਯ
देबर्पीता	ਦੇਬਰ੍ਪੀਤਾ
देब्जानी	ਦੇਬ੍ਜਾਨੀ
दैत्याकुलान्ताका	ਦੈਤ੍ਯਾਕੁਲਾਨ੍ਤਾਕਾ
दैपायन	ਦੈਪਾਯਨ
दैवंश	ਦੈਵੰਸ਼
नंगाई	ਨੰਗਾਈ
नक्श	ਨਕ੍ਸ਼
नगरजन	ਨਗਰਜਨ
नगा मांल्लेस्वारी	ਨਗਾ ਮਾਂਲ੍ਲੇਸ੍ਵਾਰੀ
नदीप	ਨਦੀਪ
नभोज	ਨਭੋਜ
नाक्ति	ਨਾਕ੍ਤਿ
नाक्षथ्रा	ਨਾਕ੍ਸ਼ਥ੍ਰਾ
नाक्ष्थ्रा	ਨਾਕ੍ਸ਼੍ਥ੍ਰਾ
नाग	ਨਾਗ
नागममां	ਨਾਗਮਮਾਂ
नागराजा	ਨਾਗਰਾਜਾ
नागार्जुन	ਨਾਗਾਰ੍ਜੁਨ
नागेन्द्र	ਨਾਗੇਨ੍ਦ੍ਰ
नागैः	ਨਾਗੈ
नाचिक	ਨਾਚਿਕ
नादारंजनी	ਨਾਦਾਰੰਜਨੀ
नाबनीता	ਨਾਬਨੀਤਾ
नाभस	ਨਾਭਸ
नाभिता	ਨਾਭਿਤਾ
नामांनारायनी	ਨਾਮਾਂਨਾਰਾਯਨੀ
नामी	ਨਾਮੀ
नारंग	ਨਾਰੰਗ
नेमा	ਨੇਮਾ
नैंशी	ਨੈਂਸ਼ੀ
नैजा	ਨੈਜਾ
नैनीशा	ਨੈਨੀਸ਼ਾ
नैरित	ਨੈਰਿਤ
नैवेद	ਨੈਵੇਦ
पंखी	ਪੰਖੀ
पंडी	ਪੰਡੀ
पंड्या	ਪੰਡ੍ਯਾ
पक्ष	ਪਕ੍ਸ਼
पक्षालिका	ਪਕ੍ਸ਼ਾਲਿਕਾ
पदमन	ਪਦਮਨ
पद्मनाभ	ਪਦ੍ਮਨਾਭ
पद्मनाभा	ਪਦ੍ਮਨਾਭਾ
पद्ममालिनी	ਪਦ੍ਮਮਾਲਿਨੀ
पद्मरेखा	ਪਦ੍ਮਰੇਖਾ
पद्मांनाबन	ਪਦ੍ਮਾਂਨਾਬਨ
पद्मांनाभा प्रिया	ਪਦ੍ਮਾਂਨਾਭਾ ਪ੍ਰਿਯਾ
पद्माकर	ਪਦ੍ਮਾਕਰ
पद्माक्षी	ਪਦ੍ਮਾਕ੍ਸ਼ੀ
पद्माजई	ਪਦ੍ਮਾਜਈ
पद्मापति	ਪਦ੍ਮਾਪਤਿ
पद्मारूपा	ਪਦ੍ਮਾਰੂਪਾ
पन्दालावासन	ਪਨ੍ਦਾਲਾਵਾਸਨ
पन्यश्री	ਪਨ੍ਯਸ਼੍ਰੀ
पपम्मां	ਪਪਮ੍ਮਾਂ
पमीला	ਪਮੀਲਾ
पम्बवासन	ਪਮ੍ਬਵਾਸਨ
पम्बा	ਪਮ੍ਬਾ
पराजिका	ਪਰਾਜਿਕਾ
पलाक्ष	ਪਲਾਕ੍ਸ਼
पलाशकुसूम	ਪਲਾਸ਼ਕੁਸੂਮ
पलाशीनी	ਪਲਾਸ਼ੀਨੀ
पल्लब	ਪਲ੍ਲਬ
पल्लवित	ਪਲ੍ਲਵਿਤ
पाओला	ਪਾਓਲਾ
पाक	ਪਾਕ
पागलावन	ਪਾਗਲਾਵਨ
पाटला	ਪਾਟਲਾ
पातालवती	ਪਾਤਾਲਵਤੀ
पामेला	ਪਾਮੇਲਾ
पायल	ਪਾਯਲ
पारस	ਪਾਰਸ
पाराज	ਪਾਰਾਜ
पार्थीवी	ਪਾਰ੍ਥੀਵੀ
पालिन	ਪਾਲਿਨ
पालीन	ਪਾਲੀਨ
पावन	ਪਾਵਨ
पावनी	ਪਾਵਨੀ
पावानी	ਪਾਵਾਨੀ
पाही	ਪਾਹੀ
फिरकी	ਫਿਰਕੀ
फेनी	ਫੇਨੀ
फ्रवश	ਫ੍ਰਵਸ਼
फ्रान्चीस	ਫ੍ਰਾਨ੍ਚੀਸ
फ्रेया	ਫ੍ਰੇਯਾ
फ्लावीना	ਫ੍ਲਾਵੀਨਾ
बंदान	ਬੰਦਾਨ
बंधीनी	ਬੰਧੀਨੀ
बग्याराज	ਬਗ੍ਯਾਰਾਜ
बनबिहारी	ਬਨਬਿਹਾਰੀ
बन्दीता	ਬਨ੍ਦੀਤਾ
बन्नी	ਬਨ੍ਨੀ
बबला	ਬਬਲਾ
बरखा	ਬਰਖਾ
बर्षा	ਬਰ੍ਸ਼ਾ
बलदेव	ਬਲਦੇਵ
बलप्रदा	ਬਲਪ੍ਰਦਾ
बलरह	ਬਲਰਹ
बलवान	ਬਲਵਾਨ
बलाचंदर	ਬਲਾਚੰਦਰ
बलादीत्य	ਬਲਾਦੀਤ੍ਯ
बविता	ਬਵਿਤਾ
बवीश्यसरी	ਬਵੀਸ਼੍ਯਸਰੀ
बसंती	ਬਸੰਤੀ
बहुधा	ਬਹੁਧਾ
बांसुरी	ਬਾਂਸੁਰੀ
बाबु	ਬਾਬੁ
बालक्रिष्ना	ਬਾਲਕ੍ਰਿਸ਼੍ਨਾ
बालाजी	ਬਾਲਾਜੀ
बालाशंकर	ਬਾਲਾਸ਼ੰਕਰ
बालु	ਬਾਲੁ
बालेन्द्र	ਬਾਲੇਨ੍ਦ੍ਰ
बाळ सुब्रमनी	ਬਾਲ ਸੁਬ੍ਰਮਨੀ
बीकुन्थ	ਬੀਕੁਨ੍ਥ
बेकुरी	ਬੇਕੁਰੀ
बेनीता	ਬੇਨੀਤਾ
बेन्शिक	ਬੇਨ੍ਸ਼ਿਕ
बेला	ਬੇਲਾ
बैशाळी	ਬੈਸ਼ਾਲੀ
बैसाखी	ਬੈਸਾਖੀ
बौमांथी	ਬੌਮਾਂਥੀ
भव्य	ਭਵ੍ਯ
भागवंती	ਭਾਗਵੰਤੀ
भागवाथ	ਭਾਗਵਾਥ
भाद्रिका	ਭਾਦ੍ਰਿਕਾ
भारती	ਭਾਰਤੀ
मदेश	ਮਦੇਸ਼
मधु बिंदु	ਮਧੁ ਬਿਂਦੁ
मधुघोष	ਮਧੁਘੋਸ਼
मधुचंदा	ਮਧੁਚੰਦਾ
मधुप्रिता	ਮਧੁਪ੍ਰਿਤਾ
मधुप्रिया	ਮਧੁਪ੍ਰਿਯਾ
मधुमति	ਮਧੁਮਤਿ
मधुमालती	ਮਧੁਮਾਲਤੀ
मधुरानी	ਮਧੁਰਾਨੀ
मधुवंती	ਮਧੁਵੰਤੀ
मधुवंथी	ਮਧੁਵੰਥੀ
मधुशा	ਮਧੁਸ਼ਾ
मधुशाना	ਮਧੁਸ਼ਾਨਾ
मधेश	ਮਧੇਸ਼
महंथी	ਮਹੰਥੀ
महाक्रम	ਮਹਾਕ੍ਰਮ
महादुर्गा	ਮਹਾਦੁਰ੍ਗਾ
महादेवादीपुजीता	ਮਹਾਦੇਵਾਦੀਪੁਜੀਤਾ
महाध्युता	ਮਹਾਧ੍ਯੁਤਾ
महाबाहु	ਮਹਾਬਾਹੁ
महालक्ष्मी	ਮਹਾਲਕ੍ਸ਼੍ਮੀ
मांदव	ਮਾਂਦਵ
मांधुवेमान	ਮਾਂਧੁਵੇਮਾਨ
मागथी	ਮਾਗਥੀ
माघा	ਮਾਘਾ
माधव दास	ਮਾਧਵ ਦਾਸ
माधवन	ਮਾਧਵਨ
माधविलता	ਮਾਧਵਿਲਤਾ
माधवी	ਮਾਧਵੀ
मानीक्या	ਮਾਨੀਕ੍ਯਾ
मान्दाविक	ਮਾਨ੍ਦਾਵਿਕ
मायन	ਮਾਯਨ
माया	ਮਾਯਾ
मायीन	ਮਾਯੀਨ
मारीश	ਮਾਰੀਸ਼
मारीशा	ਮਾਰੀਸ਼ਾ
मार्गीन	ਮਾਰ੍ਗੀਨ
माला	ਮਾਲਾ
मालीन	ਮਾਲੀਨ
माही	ਮਾਹੀ
यग्ना	ਯਗ੍ਨਾ
यज्ञेश्वर	ਯਜ੍ਞੇਸ਼੍ਵਰ
यज्नारूप	ਯਜ੍ਨਾਰੂਪ
यथार्थ	ਯਥਾਰ੍ਥ
यशवंत	ਯਸ਼ਵੰਤ
यशस्व	ਯਸ਼ਸ੍ਵ
यशित	ਯਸ਼ਿਤ
यशील	ਯਸ਼ੀਲ
यशुस	ਯਸ਼ੁਸ
यशोदागर्बा सम्भूता	ਯਸ਼ੋਦਾਗਰ੍ਬਾ ਸਮ੍ਭੂਤਾ
यशोमती	ਯਸ਼ੋਮਤੀ
यश्मिता	ਯਸ਼੍ਮਿਤਾ
यश्वीन	ਯਸ਼੍ਵੀਨ
यस्मीनी	ਯਸ੍ਮੀਨੀ
यह्स्मिता	ਯਹ੍ਸ੍ਮਿਤਾ
याचन	ਯਾਚਨ
याज	ਯਾਜ
याजक	ਯਾਜਕ
यातीएश	ਯਾਤੀਏਸ਼
यादावी	ਯਾਦਾਵੀ
याधना	ਯਾਧਨਾ
यामि	ਯਾਮਿ
यामिनी	ਯਾਮਿਨੀ
यामुरा	ਯਾਮੁਰਾ
याशोगुरी	ਯਾਸ਼ੋਗੁਰੀ
यास्तीका	ਯਾਸ੍ਤੀਕਾ
रगब	ਰਗਬ
रगवेन्द्र	ਰਗਵੇਨ੍ਦ੍ਰ
रगुनातन	ਰਗੁਨਾਤਨ
रघुराम	ਰਘੁਰਾਮ
रजिता	ਰਜਿਤਾ
रजीनी	ਰਜੀਨੀ
रबानी	ਰਬਾਨੀ
रहस	ਰਹਸ
रहाम	ਰਹਾਮ
रहीनी	ਰਹੀਨੀ
राई	ਰਾਈ
रागावीनोदीनी	ਰਾਗਾਵੀਨੋਦੀਨੀ
रागेश	ਰਾਗੇਸ਼
राघवेन्द्र	ਰਾਘਵੇਨ੍ਦ੍ਰ
राज	ਰਾਜ
राज  किरण	ਰਾਜ  ਕਿਰਣ
राजकुमार	ਰਾਜਕੁਮਾਰ
राजमणी	ਰਾਜਮਣੀ
राजलक्ष्मी	ਰਾਜਲਕ੍ਸ਼੍ਮੀ
राजशेखर	ਰਾਜਸ਼ੇਖਰ
राजसेकर	ਰਾਜਸੇਕਰ
राजस्व	ਰਾਜਸ੍ਵ
राजार्शी	ਰਾਜਾਰ੍ਸ਼ੀ
राजेशनी	ਰਾਜੇਸ਼ਨੀ
राज्रीता	ਰਾਜ੍ਰੀਤਾ
राद्न्य	ਰਾਦ੍ਨ੍ਯ
राधेश	ਰਾਧੇਸ਼
रावी	ਰਾਵੀ
रास्या	ਰਾਸ੍ਯਾ
राहीन्य	ਰਾਹੀਨ੍ਯ
राहुल	ਰਾਹੁਲ
लक्षा	ਲਕ੍ਸ਼ਾ
लक्ष्मणा	ਲਕ੍ਸ਼੍ਮਣਾ
लक्ष्मीकानतम	ਲਕ੍ਸ਼੍ਮੀਕਾਨਤਮ
लक्ष्मीगोपाल	ਲਕ੍ਸ਼੍ਮੀਗੋਪਾਲ
लक्ष्मीनारायण	ਲਕ੍ਸ਼੍ਮੀਨਾਰਾਯਣ
लक्ष्मीश	ਲਕ੍ਸ਼੍ਮੀਸ਼
लक्ष्य	ਲਕ੍ਸ਼੍ਯ
लजीथा	ਲਜੀਥਾ
लताकारा	ਲਤਾਕਾਰਾ
लतेश	ਲਤੇਸ਼
लम्बोदरा	ਲਮ੍ਬੋਦਰਾ
ललित	ਲਲਿਤ
ललितचंद्रा	ਲਲਿਤਚੰਦ੍ਰਾ
ललितामोहना	ਲਲਿਤਾਮੋਹਨਾ
ललीतादीत्य	ਲਲੀਤਾਦੀਤ੍ਯ
लवना	ਲਵਨਾ
लवाम	ਲਵਾਮ
लशिका	ਲਸ਼ਿਕਾ
लहिता	ਲਹਿਤਾ
लहेर	ਲਹੇਰ
लाईना	ਲਾਈਨਾ
लाकेश	ਲਾਕੇਸ਼
लाक्सेथा	ਲਾਕ੍ਸੇਥਾ
लाजवती	ਲਾਜਵਤੀ
लाडु	ਲਾਡੁ
लातेश	ਲਾਤੇਸ਼
लारा	ਲਾਰਾ
लारान्य	ਲਾਰਾਨ੍ਯ
लारीना	ਲਾਰੀਨਾ
लालीतेश	ਲਾਲੀਤੇਸ਼
लावा	ਲਾਵਾ
लावालिका	ਲਾਵਾਲਿਕਾ
लावेन	ਲਾਵੇਨ
लासकी	ਲਾਸਕੀ
लास्यावी	ਲਾਸ੍ਯਾਵੀ
लौहित्य	ਲੌਹਿਤ੍ਯ
वक्ति	ਵਕ੍ਤਿ
वक्रतुंड	ਵਕ੍ਰਤੁਂਡ
वजसनी	ਵਜਸਨੀ
वज्रबाहू	ਵਜ੍ਰਬਾਹੂ
वज्रमानी	ਵਜ੍ਰਮਾਨੀ
वज्राधर	ਵਜ੍ਰਾਧਰ
वधी	ਵਧੀ
वनदुर्गा	ਵਨਦੁਰ੍ਗਾ
वनमाला	ਵਨਮਾਲਾ
वनाथी	ਵਨਾਥੀ
वन्दिता	ਵਨ੍ਦਿਤਾ
वाक्षु	ਵਾਕ੍ਸ਼ੁ
वाग्देवी	ਵਾਗ੍ਦੇਵੀ
वाटिका	ਵਾਟਿਕਾ
वानादुर्गा	ਵਾਨਾਦੁਰ੍ਗਾ
वान्या	ਵਾਨ੍ਯਾ
वामांनीए	ਵਾਮਾਂਨੀਏ
वालकय	ਵਾਲਕਯ
वाली	ਵਾਲੀ
वालीप्रमाताना	ਵਾਲੀਪ੍ਰਮਾਤਾਨਾ
वासवादात्ता	ਵਾਸਵਾਦਾਤ੍ਤਾ
वासु	ਵਾਸੁ
वाहिनी	ਵਾਹਿਨੀ
वेदांत	ਵੇਦਾਂਤ
वैजनाथ	ਵੈਜਨਾਥ
वैजयी	ਵੈਜਯੀ
वैजीनाथ	ਵੈਜੀਨਾਥ
वैवत	ਵੈਵਤ
वैशाली	ਵੈਸ਼ਾਲੀ
वैश्नोव	ਵੈਸ਼੍ਨੋਵ
वैषित	ਵੈਸ਼ਿਤ
वैषेका	ਵੈਸ਼ੇਕਾ
संदेश	ਸੰਦੇਸ਼
सच	ਸਚ
सचिता	ਸਚਿਤਾ
सचिव	ਸਚਿਵ
सचिश	ਸਚਿਸ਼
सचीना	ਸਚੀਨਾ
सचेत	ਸਚੇਤ
सचेतन	ਸਚੇਤਨ
सच्चिदानंदा	ਸਚ੍ਚਿਦਾਨੰਦਾ
सदानंदा	ਸਦਾਨੰਦਾ
सबरीश्री	ਸਬਰੀਸ਼੍ਰੀ
सहारिका	ਸਹਾਰਿਕਾ
सह्रुदी	ਸਹ੍ਰੁਦੀ
साई	ਸਾਈ
साई कुमारी	ਸਾਈ ਕੁਮਾਰੀ
साई वाणी	ਸਾਈ ਵਾਣੀ
सागरिक	ਸਾਗਰਿਕ
सागरिका	ਸਾਗਰਿਕਾ
साद्रीशी	ਸਾਦ੍ਰੀਸ਼ੀ
साधक	ਸਾਧਕ
साधका	ਸਾਧਕਾ
साध्वी	ਸਾਧ੍ਵੀ
सानवी तारीता	ਸਾਨਵੀ ਤਾਰੀਤਾ
सामान	ਸਾਮਾਨ
सामोद	ਸਾਮੋਦ
साय बिंधु	ਸਾਯ ਬਿਂਧੁ
सारंगी	ਸਾਰੰਗੀ
सारस	ਸਾਰਸ
सारांश	ਸਾਰਾਂਸ਼
सार्थ	ਸਾਰ੍ਥ
सार्या	ਸਾਰ੍ਯਾ
सावन	ਸਾਵਨ
सावीनी	ਸਾਵੀਨੀ
साहना	ਸਾਹਨਾ
हंशल	ਹੰਸ਼ਲ
हंसराज	ਹੰਸਰਾਜ
हंसानंदी	ਹੰਸਾਨੰਦੀ
हंसीनी	ਹੰਸੀਨੀ
हंस्ध्वानी	ਹੰਸ੍ਧ੍ਵਾਨੀ
हजेश	ਹਜੇਸ਼
हनार्वीन	ਹਨਾਰ੍ਵੀਨ
हनीश	ਹਨੀਸ਼
हनुमान	ਹਨੁਮਾਨ
हन्शीका	ਹਨ੍ਸ਼ੀਕਾ
हबीता	ਹਬੀਤਾ
हमृथा	ਹਮਥਾ
हरण	ਹਰਣ
हरनाध	ਹਰਨਾਧ
हरषी	ਹਰਸ਼ੀ
हरिज	ਹਰਿਜ
हरिजाथा	ਹਰਿਜਾਥਾ
हरिदास	ਹਰਿਦਾਸ
हरिद्र	ਹਰਿਦ੍ਰ
हरिनाक्षी	ਹਰਿਨਾਕ੍ਸ਼ੀ
हरिप्रसाद	ਹਰਿਪ੍ਰਸਾਦ
हरिशरण	ਹਰਿਸ਼ਰਣ
हरिहर	ਹਰਿਹਰ
हरिहर पुत्र	ਹਰਿਹਰ ਪੁਤ੍ਰ
हरी किशन	ਹਰੀ ਕਿਸ਼ਨ
हरी नारायण	ਹਰੀ ਨਾਰਾਯਣ
हरीथा	ਹਰੀਥਾ
हरीनीका	ਹਰੀਨੀਕਾ
हरीन्द्र	ਹਰੀਨ੍ਦ੍ਰ
हरीमांर्कातामांर्कता	ਹਰੀਮਾਂਰ੍ਕਾਤਾਮਾਂਰ੍ਕਤਾ
हरीराम	ਹਰੀਰਾਮ
हरीश्व	ਹਰੀਸ਼੍ਵ
हरीसाई	ਹਰੀਸਾਈ
हरेकृष्ण	ਹਰੇਕਸ਼੍ਣ
हरेश्वर	ਹਰੇਸ਼੍ਵਰ
हर्लेय	ਹਰ੍ਲੇਯ
हलेस्या	ਹਲੇਸ੍ਯਾ
हारनी	ਹਾਰਨੀ
हार्ड	ਹਾਰ੍ਡ
हासीता	ਹਾਸੀਤਾ
हीमांवाथी	ਹੀਮਾਂਵਾਥੀ
हील्लेय	ਹੀਲ੍ਲੇਯ
हेशीका	ਹੇਸ਼ੀਕਾ
#
#
# Territory names from CLDR
असेंशन द्वीप	ਅਸੇਂਸ਼ਨ ਦ੍ਵੀਪ
एंडोरा	ਏਂਡੋਰਾ
संयुक्त अरब अमीरात	ਸੰਯੁਕ੍ਤ ਅਰਬ ਅਮੀਰਾਤ
अफ़गानिस्तान	ਅਫ਼ਗਾਨਿਸ੍ਤਾਨ
एंटिगुआ और बरबुडा	ਏਂਟਿਗੁਆ ਔਰ ਬਰਬੁਡਾ
एंग्विला	ਏਂਗ੍ਵਿਲਾ
अल्बानिया	ਅਲ੍ਬਾਨਿਯਾ
आर्मेनिया	ਆਰ੍ਮੇਨਿਯਾ
अंगोला	ਅਂਗੋਲਾ
अंटार्कटिका	ਅਂਟਾਰ੍ਕਟਿਕਾ
अर्जेंटीना	ਅਰ੍ਜੇਂਟੀਨਾ
अमेरिकी समोआ	ਅਮੇਰਿਕੀ ਸਮੋਆ
ऑस्ट्रिया	ਓਸ੍ਟ੍ਰਿਯਾ
ऑस्ट्रेलिया	ਓਸ੍ਟ੍ਰੇਲਿਯਾ
अरूबा	ਅਰੂਬਾ
एलैंड द्वीपसमूह	ਏਲੈਂਡ ਦ੍ਵੀਪਸਮੂਹ
अज़रबैजान	ਅਜ਼ਰਬੈਜਾਨ
बोस्निया और हर्ज़ेगोविना	ਬੋਸ੍ਨਿਯਾ ਔਰ ਹਰ੍ਜ਼ੇਗੋਵਿਨਾ
बारबाडोस	ਬਾਰਬਾਡੋਸ
बांग्लादेश	ਬਾਂਗ੍ਲਾਦੇਸ਼
बेल्जियम	ਬੇਲ੍ਜਿਯਮ
बुर्किना फ़ासो	ਬੁਰ੍ਕਿਨਾ ਫ਼ਾਸੋ
बुल्गारिया	ਬੁਲ੍ਗਾਰਿਯਾ
बहरीन	ਬਹਰੀਨ
बुरुंडी	ਬੁਰੁਂਡੀ
बेनिन	ਬੇਨਿਨ
सेंट बार्थेलेमी	ਸੇਂਟ ਬਾਰ੍ਥੇਲੇਮੀ
बरमूडा	ਬਰਮੂਡਾ
ब्रूनेई	ਬ੍ਰੂਨੇਈ
बोलीविया	ਬੋਲੀਵਿਯਾ
कैरिबियन नीदरलैंड	ਕੈਰਿਬਿਯਨ ਨੀਦਰਲੈਂਡ
ब्राज़ील	ਬ੍ਰਾਜ਼ੀਲ
बहामास	ਬਹਾਮਾਸ
भूटान	ਭੂਟਾਨ
बोवेत द्वीप	ਬੋਵੇਤ ਦ੍ਵੀਪ
बोत्स्वाना	ਬੋਤ੍ਸ੍ਵਾਨਾ
बेलारूस	ਬੇਲਾਰੂਸ
बेलीज़	ਬੇਲੀਜ਼
कनाडा	ਕਨਾਡਾ
कोकोस (कीलिंग) द्वीपसमूह	ਕੋਕੋਸ (ਕੀਲਿਂਗ) ਦ੍ਵੀਪਸਮੂਹ
कांगो - किंशासा	ਕਾਂਗੋ - ਕਿਂਸ਼ਾਸਾ
कांगो (डीआरसी)	ਕਾਂਗੋ (ਡੀਆਰਸੀ)
मध्य अफ़्रीकी गणराज्य	ਮਧ੍ਯ ਅਫ਼੍ਰੀਕੀ ਗਣਰਾਜ੍ਯ
कांगो – ब्राज़ाविल	ਕਾਂਗੋ – ਬ੍ਰਾਜ਼ਾਵਿਲ
कांगो (गणराज्य)	ਕਾਂਗੋ (ਗਣਰਾਜ੍ਯ)
स्विट्ज़रलैंड	ਸ੍ਵਿਟ੍ਜ਼ਰਲੈਂਡ
कोट डी आइवर	ਕੋਟ ਡੀ ਆਇਵਰ
आइवरी कोस्ट	ਆਇਵਰੀ ਕੋਸ੍ਟ
कुक द्वीपसमूह	ਕੁਕ ਦ੍ਵੀਪਸਮੂਹ
चिली	ਚਿਲੀ
कैमरून	ਕੈਮਰੂਨ
चीन	ਚੀਨ
कोलंबिया	ਕੋਲੰਬਿਯਾ
क्लिपर्टन द्वीप	ਕ੍ਲਿਪਰ੍ਟਨ ਦ੍ਵੀਪ
कोस्टारिका	ਕੋਸ੍ਟਾਰਿਕਾ
क्यूबा	ਕ੍ਯੂਬਾ
केप वर्ड	ਕੇਪ ਵਰ੍ਡ
क्यूरासाओ	ਕ੍ਯੂਰਾਸਾਓ
क्रिसमस द्वीप	ਕ੍ਰਿਸਮਸ ਦ੍ਵੀਪ
साइप्रस	ਸਾਇਪ੍ਰਸ
चेक गणराज्य	ਚੇਕ ਗਣਰਾਜ੍ਯ
जर्मनी	ਜਰ੍ਮਨੀ
डिएगो गार्सिया	ਡਿਏਗੋ ਗਾਰ੍ਸਿਯਾ
जिबूती	ਜਿਬੂਤੀ
डेनमार्क	ਡੇਨਮਾਰ੍ਕ
डोमिनिका	ਡੋਮਿਨਿਕਾ
डोमिनिकन गणराज्य	ਡੋਮਿਨਿਕਨ ਗਣਰਾਜ੍ਯ
अल्जीरिया	ਅਲ੍ਜੀਰਿਯਾ
सेउटा और मेलिला	ਸੇਉਟਾ ਔਰ ਮੇਲਿਲਾ
इक्वाडोर	ਇਕ੍ਵਾਡੋਰ
एस्टोनिया	ਏਸ੍ਟੋਨਿਯਾ
मिस्र	ਮਿਸ੍ਰ
पश्चिमी सहारा	ਪਸ਼੍ਚਿਮੀ ਸਹਾਰਾ
इरिट्रिया	ਇਰਿਟ੍ਰਿਯਾ
स्पेन	ਸ੍ਪੇਨ
इथियोपिया	ਇਥਿਯੋਪਿਯਾ
यूरोपीय संघ	ਯੂਰੋਪੀਯ ਸੰਘ
फ़िनलैंड	ਫ਼ਿਨਲੈਂਡ
फ़िजी	ਫ਼ਿਜੀ
फ़ॉकलैंड द्वीपसमूह	ਫ਼ੌਕਲੈਂਡ ਦ੍ਵੀਪਸਮੂਹ
फ़ॉकलैंड द्वीपसमूह (इज़्लास माल्विनास)	ਫ਼ੌਕਲੈਂਡ ਦ੍ਵੀਪਸਮੂਹ (ਇਜ਼੍ਲਾਸ ਮਾਲ੍ਵਿਨਾਸ)
माइक्रोनेशिया	ਮਾਇਕ੍ਰੋਨੇਸ਼ਿਯਾ
फ़ेरो द्वीपसमूह	ਫ਼ੇਰੋ ਦ੍ਵੀਪਸਮੂਹ
फ़्रांस	ਫ਼੍ਰਾਂਸ
गैबॉन	ਗੈਬੌਨ
यूनाइटेड किंगडम	ਯੂਨਾਇਟੇਡ ਕਿਂਗਡਮ
ग्रेनाडा	ਗ੍ਰੇਨਾਡਾ
जॉर्जिया	ਜੌਰ੍ਜਿਯਾ
फ़्रेंच गयाना	ਫ਼੍ਰੇਂਚ ਗਯਾਨਾ
गर्नसी	ਗਰ੍ਨਸੀ
घाना	ਘਾਨਾ
जिब्राल्टर	ਜਿਬ੍ਰਾਲ੍ਟਰ
ग्रीनलैंड	ਗ੍ਰੀਨਲੈਂਡ
गाम्बिया	ਗਾਮ੍ਬਿਯਾ
गिनी	ਗਿਨੀ
ग्वाडेलूप	ਗ੍ਵਾਡੇਲੂਪ
इक्वेटोरियल गिनी	ਇਕ੍ਵੇਟੋਰਿਯਲ ਗਿਨੀ
यूनान	ਯੂਨਾਨ
दक्षिण जॉर्जिया और दक्षिण सैंडविच द्वीपसमूह	ਦਕ੍ਸ਼ਿਣ ਜੌਰ੍ਜਿਯਾ ਔਰ ਦਕ੍ਸ਼ਿਣ ਸੈਂਡਵਿਚ ਦ੍ਵੀਪਸਮੂਹ
ग्वाटेमाला	ਗ੍ਵਾਟੇਮਾਲਾ
गुआम	ਗੁਆਮ
गिनी-बिसाउ	ਗਿਨੀ-ਬਿਸਾਉ
गयाना	ਗਯਾਨਾ
हाँग काँग (चीन विशेष प्रशासनिक क्षेत्र)	ਹਾਁਗ ਕਾਁਗ (ਚੀਨ ਵਿਸ਼ੇਸ਼ ਪ੍ਰਸ਼ਾਸਨਿਕ ਕ੍ਸ਼ੇਤ੍ਰ)
हाँग काँग	ਹਾਁਗ ਕਾਁਗ
हर्ड द्वीप और मैकडोनॉल्ड द्वीपसमूह	ਹਰ੍ਡ ਦ੍ਵੀਪ ਔਰ ਮੈਕਡੋਨੌਲ੍ਡ ਦ੍ਵੀਪਸਮੂਹ
होंडूरास	ਹੋਂਡੂਰਾਸ
क्रोएशिया	ਕ੍ਰੋਏਸ਼ਿਯਾ
हैती	ਹੈਤੀ
हंगरी	ਹੰਗਰੀ
कैनेरी द्वीपसमूह	ਕੈਨੇਰੀ ਦ੍ਵੀਪਸਮੂਹ
इंडोनेशिया	ਇਂਡੋਨੇਸ਼ਿਯਾ
आयरलैंड	ਆਯਰਲੈਂਡ
इसराइल	ਇਸਰਾਇਲ
आइल ऑफ़ मैन	ਆਇਲ ਓਫ਼ ਮੈਨ
भारत	ਭਾਰਤ
ब्रिटिश हिंद महासागरीय क्षेत्र	ਬ੍ਰਿਟਿਸ਼ ਹਿਂਦ ਮਹਾਸਾਗਰੀਯ ਕ੍ਸ਼ੇਤ੍ਰ
इराक	ਇਰਾਕ
ईरान	ਈਰਾਨ
आइसलैंड	ਆਇਸਲੈਂਡ
इटली	ਇਟਲੀ
जर्सी	ਜਰ੍ਸੀ
जमैका	ਜਮੈਕਾ
जॉर्डन	ਜੌਰ੍ਡਨ
जापान	ਜਾਪਾਨ
केन्या	ਕੇਨ੍ਯਾ
किर्गिज़स्तान	ਕਿਰ੍ਗਿਜ਼ਸ੍ਤਾਨ
कंबोडिया	ਕੰਬੋਡਿਯਾ
किरिबाती	ਕਿਰਿਬਾਤੀ
कोमोरोस	ਕੋਮੋਰੋਸ
सेंट किट्स और नेविस	ਸੇਂਟ ਕਿਟ੍ਸ ਔਰ ਨੇਵਿਸ
उत्तर कोरिया	ਉਤ੍ਤਰ ਕੋਰਿਯਾ
दक्षिण कोरिया	ਦਕ੍ਸ਼ਿਣ ਕੋਰਿਯਾ
कुवैत	ਕੁਵੈਤ
केमैन द्वीपसमूह	ਕੇਮੈਨ ਦ੍ਵੀਪਸਮੂਹ
कज़ाखस्तान	ਕਜ਼ਾਖਸ੍ਤਾਨ
लाओस	ਲਾਓਸ
लेबनान	ਲੇਬਨਾਨ
सेंट लूसिया	ਸੇਂਟ ਲੂਸਿਯਾ
लिचेंस्टीन	ਲਿਚੇਂਸ੍ਟੀਨ
श्रीलंका	ਸ਼੍ਰੀਲੰਕਾ
लाइबेरिया	ਲਾਇਬੇਰਿਯਾ
लेसोथो	ਲੇਸੋਥੋ
लिथुआनिया	ਲਿਥੁਆਨਿਯਾ
लग्ज़मबर्ग	ਲਗ੍ਜ਼ਮਬਰ੍ਗ
लातविया	ਲਾਤਵਿਯਾ
लीबिया	ਲੀਬਿਯਾ
मोरक्को	ਮੋਰਕ੍ਕੋ
मोनाको	ਮੋਨਾਕੋ
मॉल्डोवा	ਮੌਲ੍ਡੋਵਾ
मोंटेनेग्रो	ਮੋਂਟੇਨੇਗ੍ਰੋ
सेंट मार्टिन	ਸੇਂਟ ਮਾਰ੍ਟਿਨ
मेडागास्कर	ਮੇਡਾਗਾਸ੍ਕਰ
मार्शल द्वीपसमूह	ਮਾਰ੍ਸ਼ਲ ਦ੍ਵੀਪਸਮੂਹ
मैसिडोनिया	ਮੈਸਿਡੋਨਿਯਾ
मैसिडोनिया (FYROM)	ਮੈਸਿਡੋਨਿਯਾ (FYROM)
माली	ਮਾਲੀ
म्यांमार (बर्मा)	ਮ੍ਯਾਂਮਾਰ (ਬਰ੍ਮਾ)
मंगोलिया	ਮੰਗੋਲਿਯਾ
मकाऊ (विशेष प्रशासनिक क्षेत्र चीन)	ਮਕਾਊ (ਵਿਸ਼ੇਸ਼ ਪ੍ਰਸ਼ਾਸਨਿਕ ਕ੍ਸ਼ੇਤ੍ਰ ਚੀਨ)
मकाऊ	ਮਕਾਊ
उत्तरी मारियाना द्वीपसमूह	ਉਤ੍ਤਰੀ ਮਾਰਿਯਾਨਾ ਦ੍ਵੀਪਸਮੂਹ
मार्टीनिक	ਮਾਰ੍ਟੀਨਿਕ
मॉरिटानिया	ਮੌਰਿਟਾਨਿਯਾ
मोंटसेरात	ਮੋਂਟਸੇਰਾਤ
माल्टा	ਮਾਲ੍ਟਾ
मॉरिशस	ਮੌਰਿਸ਼ਸ
मालदीव	ਮਾਲਦੀਵ
मलावी	ਮਲਾਵੀ
मैक्सिको	ਮੈਕ੍ਸਿਕੋ
मलेशिया	ਮਲੇਸ਼ਿਯਾ
मोज़ांबिक	ਮੋਜ਼ਾਂਬਿਕ
नामीबिया	ਨਾਮੀਬਿਯਾ
न्यू कैलेडोनिया	ਨ੍ਯੂ ਕੈਲੇਡੋਨਿਯਾ
नाइजर	ਨਾਇਜਰ
नॉरफ़ॉक द्वीप	ਨੌਰਫ਼ੌਕ ਦ੍ਵੀਪ
नाइजीरिया	ਨਾਇਜੀਰਿਯਾ
निकारागुआ	ਨਿਕਾਰਾਗੁਆ
नीदरलैंड	ਨੀਦਰਲੈਂਡ
नॉर्वे	ਨੌਰ੍ਵੇ
नेपाल	ਨੇਪਾਲ
नाउरु	ਨਾਉਰੁ
नीयू	ਨੀਯੂ
न्यूज़ीलैंड	ਨ੍ਯੂਜ਼ੀਲੈਂਡ
ओमान	ਓਮਾਨ
पनामा	ਪਨਾਮਾ
पेरू	ਪੇਰੂ
फ़्रेंच पोलिनेशिया	ਫ਼੍ਰੇਂਚ ਪੋਲਿਨੇਸ਼ਿਯਾ
पापुआ न्यू गिनी	ਪਾਪੁਆ ਨ੍ਯੂ ਗਿਨੀ
फ़िलिपींस	ਫ਼ਿਲਿਪੀਂਸ
पाकिस्तान	ਪਾਕਿਸ੍ਤਾਨ
पोलैंड	ਪੋਲੈਂਡ
सेंट पिएरे और मिक्वेलान	ਸੇਂਟ ਪਿਏਰੇ ਔਰ ਮਿਕ੍ਵੇਲਾਨ
पिटकैर्न द्वीपसमूह	ਪਿਟਕੈਰ੍ਨ ਦ੍ਵੀਪਸਮੂਹ
पोर्टो रिको	ਪੋਰ੍ਟੋ ਰਿਕੋ
फ़िलिस्तीनी क्षेत्र	ਫ਼ਿਲਿਸ੍ਤੀਨੀ ਕ੍ਸ਼ੇਤ੍ਰ
फ़िलिस्तीन	ਫ਼ਿਲਿਸ੍ਤੀਨ
पुर्तगाल	ਪੁਰ੍ਤਗਾਲ
पलाऊ	ਪਲਾਊ
पेराग्वे	ਪੇਰਾਗ੍ਵੇ
क़तर	ਕ਼ਤਰ
आउटलाइंग ओशिनिया	ਆਉਟਲਾਇਂਗ ਓਸ਼ਿਨਿਯਾ
रियूनियन	ਰਿਯੂਨਿਯਨ
रोमानिया	ਰੋਮਾਨਿਯਾ
सर्बिया	ਸਰ੍ਬਿਯਾ
रूस	ਰੂਸ
रवांडा	ਰਵਾਂਡਾ
सऊदी अरब	ਸਊਦੀ ਅਰਬ
सोलोमन द्वीपसमूह	ਸੋਲੋਮਨ ਦ੍ਵੀਪਸਮੂਹ
सेशेल्स	ਸੇਸ਼ੇਲ੍ਸ
सूडान	ਸੂਡਾਨ
स्वीडन	ਸ੍ਵੀਡਨ
सिंगापुर	ਸਿਂਗਾਪੁਰ
सेंट हेलेना	ਸੇਂਟ ਹੇਲੇਨਾ
स्लोवेनिया	ਸ੍ਲੋਵੇਨਿਯਾ
स्वालबार्ड और जान मायेन	ਸ੍ਵਾਲਬਾਰ੍ਡ ਔਰ ਜਾਨ ਮਾਯੇਨ
स्लोवाकिया	ਸ੍ਲੋਵਾਕਿਯਾ
सिएरा लियोन	ਸਿਏਰਾ ਲਿਯੋਨ
सैन मेरीनो	ਸੈਨ ਮੇਰੀਨੋ
सेनेगल	ਸੇਨੇਗਲ
सोमालिया	ਸੋਮਾਲਿਯਾ
सूरीनाम	ਸੂਰੀਨਾਮ
दक्षिण सूडान	ਦਕ੍ਸ਼ਿਣ ਸੂਡਾਨ
साओ टोम और प्रिंसिपे	ਸਾਓ ਟੋਮ ਔਰ ਪ੍ਰਿਂਸਿਪੇ
अल सल्वाडोर	ਅਲ ਸਲ੍ਵਾਡੋਰ
सिंट मार्टिन	ਸਿਂਟ ਮਾਰ੍ਟਿਨ
सीरिया	ਸੀਰਿਯਾ
स्वाज़ीलैंड	ਸ੍ਵਾਜ਼ੀਲੈਂਡ
त्रिस्टान डा कुना	ਤ੍ਰਿਸ੍ਟਾਨ ਡਾ ਕੁਨਾ
तुर्क और कैकोज़ द्वीपसमूह	ਤੁਰ੍ਕ ਔਰ ਕੈਕੋਜ਼ ਦ੍ਵੀਪਸਮੂਹ
चाड	ਚਾਡ
फ़्रांसीसी दक्षिणी क्षेत्र	ਫ਼੍ਰਾਂਸੀਸੀ ਦਕ੍ਸ਼ਿਣੀ ਕ੍ਸ਼ੇਤ੍ਰ
टोगो	ਟੋਗੋ
थाईलैंड	ਥਾਈਲੈਂਡ
ताजिकिस्तान	ਤਾਜਿਕਿਸ੍ਤਾਨ
तोकेलाउ	ਤੋਕੇਲਾਉ
तिमोर-लेस्त	ਤਿਮੋਰ-ਲੇਸ੍ਤ
पूर्वी तिमोर	ਪੂਰ੍ਵੀ ਤਿਮੋਰ
तुर्कमेनिस्तान	ਤੁਰ੍ਕਮੇਨਿਸ੍ਤਾਨ
ट्यूनीशिया	ਟ੍ਯੂਨੀਸ਼ਿਯਾ
टोंगा	ਟੋਂਗਾ
तुर्की	ਤੁਰ੍ਕੀ
त्रिनिदाद और टोबैगो	ਤ੍ਰਿਨਿਦਾਦ ਔਰ ਟੋਬੈਗੋ
तुवालू	ਤੁਵਾਲੂ
ताइवान	ਤਾਇਵਾਨ
तंज़ानिया	ਤੰਜ਼ਾਨਿਯਾ
यूक्रेन	ਯੂਕ੍ਰੇਨ
युगांडा	ਯੁਗਾਂਡਾ
संयुक्त राज्य	ਸੰਯੁਕ੍ਤ ਰਾਜ੍ਯ
अमेरिका	ਅਮੇਰਿਕਾ
उरूग्वे	ਉਰੂਗ੍ਵੇ
उज़्बेकिस्तान	ਉਜ਼੍ਬੇਕਿਸ੍ਤਾਨ
वेटिकन सिटी	ਵੇਟਿਕਨ ਸਿਟੀ
सेंट विंसेंट और ग्रेनाडाइंस	ਸੇਂਟ ਵਿਂਸੇਂਟ ਔਰ ਗ੍ਰੇਨਾਡਾਇਂਸ
वेनेज़ुएला	ਵੇਨੇਜ਼ੁਏਲਾ
ब्रिटिश वर्जिन द्वीपसमूह	ਬ੍ਰਿਟਿਸ਼ ਵਰ੍ਜਿਨ ਦ੍ਵੀਪਸਮੂਹ
वियतनाम	ਵਿਯਤਨਾਮ
वनुआतू	ਵਨੁਆਤੂ
वालिस और फ़्यूचूना	ਵਾਲਿਸ ਔਰ ਫ਼੍ਯੂਚੂਨਾ
समोआ	ਸਮੋਆ
कोसोवो	ਕੋਸੋਵੋ
यमन	ਯਮਨ
मायोते	ਮਾਯੋਤੇ
दक्षिण अफ़्रीका	ਦਕ੍ਸ਼ਿਣ ਅਫ਼੍ਰੀਕਾ
ज़ाम्बिया	ਜ਼ਾਮ੍ਬਿਯਾ
ज़िम्बाब्वे	ਜ਼ਿਮ੍ਬਾਬ੍ਵੇ
अज्ञात क्षेत्र	ਅਜ੍ਞਾਤ ਕ੍ਸ਼ੇਤ੍ਰ
