# Baby names
অকার্যতানাযা	അകാര്യതാനായാ
অগল্যা	അഗല്യാ
অগ্রাজা	അഗ്രാജാ
অড্যাত্রযী	അഡ്യാത്രയീ
অদ্বিথা	അദ്ബിഥാ
অদ্বৈথী	അദ്ബൈഥീ
অদ্রিতা	അദ്രിതാ
অদ্রীত্যা	അദ്രീത്യാ
অদ্শযা	അദ്ശയാ
অধুজা	അധുജാ
অবীনাযা	അബീനായാ
অবীলাশীনী	അബീലാശീനീ
অবীষেক	അബീഷേക
অব্জিত	അബ്ജിത
অব্ব্য্নায্হা	അബ്ബ്യ്നായ്ഹാ
অভাতী	അഭാതീ
অভিজিত	അഭിജിത
অভিজ্ঞান	അഭിജ്ഞാന
অভিনন্দন	അഭിനന്ദന
অভিমান	അഭിമാന
অভিসোকা	അഭിസോകാ
অভিহীতা	അഭിഹീതാ
অভীনাশ	അഭീനാശ
অভ্থা	അഭ്ഥാ
অভ্যান্কর	അഭ്യാന്കര
অভ্রনীলা	അഭ്രനീലാ
অহংতী	അഹംതീ
অহিল্যা	അഹില്യാ
অহেলী	അഹേലീ
আংজনেয	ആംജനേയ
আকর	ആകര
আকার	ആകാര
আঘোশ	ആഘോശ
আচমন	ആചമന
আতিশ	ആതിശ
আত্রব	ആത്രബ
আথী	ആഥീ
আদিতা	ആദിതാ
আদিম	ആദിമ
আদিযা	ആദിയാ
আদীজয	ആദീജയ
আদীত্রী	ആദീത്രീ
আদ্রিকা	ആദ്രികാ
আনংদতা	ആനംദതാ
আনংদিত	ആനംദിത
আনল	ആനല
আনাধীতা	ആനാധീതാ
আনাযা	ആനായാ
আন্শাল	ആന്ശാല
আপেক্ষা	ആപേക്ഷാ
আবীশ	ആബീശ
আভাস	ആഭാസ
আভীর	ആഭീര
আমিষ	ആമിഷ
আমোদ	ആമോദ
আযুষ্মান	ആയുഷ്മാന
আরংভী	ആരംഭീ
আরব	ആരബ
আরা	ആരാ
আরিনী	ആരിനീ
আরিযা	ആരിയാ
আরীন	ആരീന
আরুষী	ആരുഷീ
আরোন	ആരോന
আর্থী	ആര്ഥീ
আর্যমন	ആര്യമന
আর্যমিক	ആര്യമിക
আর্য্থ্য	ആര്യ്ഥ്യ
আর্শ্বী	ആര്ശ്ബീ
আলংব	ആലംബ
আলোক	ആലോക
আলোকা	ആലോകാ
আশাকিরণ	ആശാകിരണ
আশীতা	ആശീതാ
আষ্নী	ആഷ്നീ
আসিত	ആസിത
আহলাদ	ആഹലാദ
ইংদুমতী	ഇംദുമതീ
ইংদুলেক্ষ	ഇംദുലേക്ഷ
ইংবনাথন	ഇംബനാഥന
ইক্ষিত	ഇക്ഷിത
ইক্সুরা	ഇക്സുരാ
ইদুম	ഇദുമ
ইধাযা	ഇധായാ
ইনকী	ഇനകീ
ইন্দ্রদযুম্ন	ഇന്ദ്രദയുമ്ന
ইন্দ্রন	ഇന്ദ്രന
ইন্দ্রসেন	ഇന്ദ്രസേന
ইন্দ্রিনা	ഇന്ദ്രിനാ
ইবাংকা	ഇബാംകാ
ইব্বানী	ഇബ്ബാനീ
ইযুরেশ	ഇയുരേശ
ইরাজা	ഇരാജാ
ইরী	ഇരീ
ইলা	ഇലാ
ইশান্য	ഇശാന്യ
ইসকী	ഇസകീ
ইহিনা	ഇഹിനാ
ঈজ্যা	ഈജ്യാ
ঈরীন	ഈരീന
ঈলাক্ষী	ഈലാക്ഷീ
ঈশা	ഈശാ
ঈশাংত	ഈശാംത
ঈশিকা	ഈശികാ
ঈসাঈ	ഈസാഈ
উগন	ഉഗന
উগ্রসাঈ	ഉഗ്രസാഈ
উজযাতী	ഉജയാതീ
উজাযন	ഉജായന
উজ্জম	ഉജ്ജമ
উজ্জয	ഉജ്ജയ
উত্তরা	ഉത്തരാ
উত্পত্তি	ഉത്പത്തി
উত্সা	ഉത്സാ
উথামী	ഉഥാമീ
উদযন	ഉദയന
উদযা	ഉദയാ
উধায	ഉധായ
উধাযারনী	ഉധായാരനീ
উনীনাজ	ഉനീനാജ
উন্নত	ഉന്നത
উন্নতীশ	ഉന്നതീശ
উন্নাথী	ഉന്നാഥീ
উপল	ഉപല
উপেক্ষ	ഉപേക്ഷ
উপ্জস	ഉപ്ജസ
উপ্পাস	ഉപ്പാസ
উফ্তম	ഉഫ്തമ
উভয	ഉഭയ
উর্জানী	ഉര്ജാനീ
উর্দাহাব	ഉര്ദാഹാബ
উর্বিক	ഉര്ബിക
উর্বীনাথ	ഉര്ബീനാഥ
উশ্নীক	ഉശ്നീക
উষা	ഉഷാ
উষাশি	ഉഷാശി
উষাশ্রী	ഉഷാശ്രീ
উস্রা	ഉസ്രാ
একাকান্য	ഏകാകാന്യ
একাক্ষা	ഏകാക്ഷാ
একাগ্রহ	ഏകാഗ്രഹ
একান্তিকা	ഏകാന്തികാ
এচ্চুমতি	ഏച്ചുമതി
এবেলিন	ഏബേലിന
এবোন	ഏബോന
এব্বনী	ഏബ്ബനീ
এরীন	ഏരീന
এলীনা	ഏലീനാ
এলীলরাসন	ഏലീലരാസന
এশমাং	ഏശമാം
এশানিকা	ഏശാനികാ
এহিমাযা	ഏഹിമായാ
ওংদ্রিলা	ഓംദ്രിലാ
ওঈশী	ഓഈശീ
ওজস	ഓജസ
ওজস্বী	ഓജസ്ബീ
ওজস্বীন	ഓജസ്ബീന
ওজা	ഓജാ
ওজীস	ഓജീസ
ওদিতী	ഓദിതീ
ওবীএ	ഓബീഏ
ওমাজা	ഓമാജാ
ওমীশ	ഓമീശ
ওমেশ	ഓമേശ
ওশ্মী	ഓശ്മീ
ঔশিগ	ഔശിഗ
কংচ	കംച
কংচনভা	കംചനഭാ
কংজন	കംജന
কক্ষাপ	കക്ഷാപ
কদংবন	കദംബന
কদান্ম্বরী	കദാന്മ്ബരീ
কনিতা	കനിതാ
কনীজা	കനീജാ
কনীরা	കനീരാ
কনীষা	കനീഷാ
কন্তারব	കന്താരബ
কন্হৈযা	കന്ഹൈയാ
কপার্দিনী	കപാര്ദിനീ
কপিল	കപില
কবচ	കബച
কবিনযা	കബിനയാ
কবীযাসরী	കബീയാസരീ
কবীলান	കബീലാന
কমলা সমভাব	കമലാ സമഭാബ
কমলাপতি	കമലാപതി
কমোদ	കമോദ
করীশা	കരീശാ
করুণা সাগর	കരുണാ സാഗര
করুণানিধি	കരുണാനിധി
করুনাশংকর	കരുനാശംകര
করূলী	കരൂലീ
কর্তিযন	കര്തിയന
কর্দমাং	കര്ദമാം
কল-হংস	കല-ഹംസ
কলাকাংতী	കലാകാംതീ
কলাপীন	കലാപീന
কলাপ্রিযা	കലാപ്രിയാ
কলীযাহ	കലീയാഹ
কল্প	കല്പ
কল্যাণ	കല്യാണ
কল্লোলা	കല്ലോലാ
কল্হার	കല്ഹാര
কশীনাতন	കശീനാതന
কশ্বী	കശ്ബീ
কহ্কাশন	കഹ്കാശന
কাঁচী	കാംചീ
কাংতব	കാംതബ
কাংতা	കാംതാ
কাজল	കാജല
কাজোল	കാജോല
কাতীত	കാതീത
কানাকাবাল্লী	കാനാകാബാല്ലീ
কানাসু	കാനാസു
কানীমোঝ্হী	കാനീമോഝ്ഹീ
কানীল	കാനീല
কাব্য শ্রী	കാബ്യ ശ്രീ
কাব্যস্রী	കാബ്യസ്രീ
কামক্যা	കാമക്യാ
কামদা	കാമദാ
কামরাজ	കാമരാജ
কামুনা	കാമുനാ
কারথী	കാരഥീ
কারীন	കാരീന
কার্লা	കാര്ലാ
কালিদাস	കാലിദാസ
কাশী	കാശീ
কাশ্যপ	കാശ്യപ
কাহীনী	കാഹീനീ
কৌটিল্য	കൌടില്യ
কৌশ	കൌശ
কৌশ্লেন্দর	കൌശ്ലേന്ദര
কৌসল্যা	കൌസല്യാ
গংগিকা	ഗംഗികാ
গংগী	ഗംഗീ
গংধারা	ഗംധാരാ
গজপতি	ഗജപതി
গজরা	ഗജരാ
গজরূপ	ഗജരൂപ
গজেংদ্রনাথ	ഗജേംദ്രനാഥ
গতিক	ഗതിക
গদাধর	ഗദാധര
গনেসা	ഗനേസാ
গন্গেযন	ഗന്ഗേയന
গহনা	ഗഹനാ
গাথা	ഗാഥാ
গাথিকা	ഗാഥികാ
গাব্যা	ഗാബ്യാ
গাযকাপ্রিযা	ഗായകാപ്രിയാ
গীতাম্রীতা মহোদধি	ഗീതാമ്രീതാ മഹോദധി
গীতাশ্রী	ഗീതാശ്രീ
গীতি	ഗീതി
গীনা	ഗീനാ
গীরীনাথ	ഗീരീനാഥ
গীরীশরণ	ഗീരീശരണ
গুংজা	ഗുംജാ
গুগন	ഗുഗന
গুণাজী	ഗുണാജീ
গুনাশেকরণ	ഗുനാശേകരണ
গুনীত	ഗുനീത
গুন্জীতা	ഗുന്ജീതാ
গুরদযাল	ഗുരദയാല
গুরব	ഗുരബ
গুরীশ	ഗുരീശ
গুরু	ഗുരു
গুরুচরণ	ഗുരുചരണ
গুরুপদা	ഗുരുപദാ
গুরুরাজ	ഗുരുരാജ
গুরুরাজা	ഗുരുരാജാ
গুরুশরণ	ഗുരുശരണ
গুল	ഗുല
গূহারী	ഗൂഹാരീ
গেশনা	ഗേശനാ
গোউংতামান	ഗോഉംതാമാന
গোউংথমী	ഗോഉംഥമീ
গোউংসিক	ഗോഉംസിക
গোকুল	ഗോകുല
গোপান	ഗോപാന
গোপাল কৃষ্ণন	ഗോപാല കൃഷ്ണന
গোপীচংদ	ഗോപീചംദ
গোপেশ	ഗോപേശ
গোমাংতক	ഗോമാംതക
গোমীনী	ഗോമീനീ
গোম্যাসরী	ഗോമ്യാസരീ
গোরল	ഗോരല
গোশীতা	ഗോശീതാ
গৌর	ഗൌര
গৌরবী	ഗൌരബീ
গৌরাংশ	ഗൌരാംശ
গৌরীতা	ഗൌരീതാ
গৌর্যনবী	ഗൌര്യനബീ
গ্নানেন্দের	ഗ്നാനേന്ദേര
গ্যানবী	ഗ്യാനബീ
গ্রাহ্য	ഗ്രാഹ്യ
গ্রিষ্মা	ഗ്രിഷ്മാ
গ্রীশ্মীতা	ഗ്രീശ്മീതാ
গ্রীসমাং	ഗ്രീസമാം
ঘটোতকত্চা	ഘടോതകത്ചാ
ঘুংগরূ	ഘുംഗരൂ
চংদসরী	ചംദസരീ
চংদের্ভান	ചംദേര്ഭാന
চংদ্রকংতী	ചംദ്രകംതീ
চংদ্রকিশোর	ചംദ്രകിശോര
চংদ্রকীর্তী	ചംദ്രകീര്തീ
চংদ্রন	ചംദ്രന
চংদ্রন্শুং	ചംദ്രന്ശും
চংদ্রমতি	ചംദ്രമതി
চংদ্রমনী	ചംദ്രമനീ
চংদ্রা	ചംദ്രാ
চংদ্রিকা	ചംദ്രികാ
চংদ্রেযী	ചംദ്രേയീ
চংধু	ചംധു
চক্রপাণী	ചക്രപാണീ
চতুর্বী	ചതുര്ബീ
চনক	ചനക
চনাস্যা	ചനാസ്യാ
চন্দ্রকলী	ചന്ദ്രകലീ
চন্দ্রসহোদারী	ചന്ദ്രസഹോദാരീ
চপলা	ചപലാ
চযাংক	ചയാംക
চরণ	ചരണ
চরীতাব্যা	ചരീതാബ്യാ
চরীথা	ചരീഥാ
চরুশীল	ചരുശീല
চানাস্যা	ചാനാസ്യാ
চাব্রিক	ചാബ്രിക
চামীনী	ചാമീനീ
চিত্তেশ	ചിത്തേശ
চিত্রকূট সমাংশ্রাযা	ചിത്രകൂട സമാംശ്രായാ
চিত্রবাহূ	ചിത്രബാഹൂ
চিত্রমালা	ചിത്രമാലാ
চিত্রযুদ্ধ	ചിത്രയുദ്ധ
চিত্রিকা	ചിത്രികാ
চিত্রিতা	ചിത്രിതാ
চিমাযী	ചിമായീ
চিরংজীব	ചിരംജീബ
চিরংতন	ചിരംതന
চীথরা	ചീഥരാ
চীন্নীঃ	ചീന്നീഃ
চীস্থা	ചീസ്ഥാ
চুংবন	ചുംബന
চুটকী	ചുടകീ
চুন্নী	ചുന്നീ
চুমকী	ചുമകീ
চেতন্সাঈ	ചേതന്സാഈ
চৈতাল	ചൈതാല
চৈত্রী	ചൈത്രീ
চৈনীকা	ചൈനീകാ
চৈসরণ	ചൈസരണ
জক্ষানী	ജക്ഷാനീ
জগতপ্রকাশ	ജഗതപ്രകാശ
জগদগুরুবে	ജഗദഗുരുബേ
জগদীপ	ജഗദീപ
জগদেশা	ജഗദേശാ
জগাতী	ജഗാതീ
জগ্সনা	ജഗ്സനാ
জতন	ജതന
জনামেজয	ജനാമേജയ
জনিতা	ജനിതാ
জবিনে	ജബിനേ
জযকিশন	ജയകിശന
জযগোপাল	ജയഗോപാല
জযনা	ജയനാ
জযাজীত	ജയാജീത
জযানংদ	ജയാനംദ
জরুল	ജരുല
জলজ়া	ജലജാ
জশ্বীথা	ജശ്ബീഥാ
জশ্মীথা	ജശ്മീഥാ
জসরাজ	ജസരാജ
জস্টীন	ജസ്ടീന
জহাংগীর	ജഹാംഗീര
জাংবুবন	ജാംബുബന
জাগচংদ্রা	ജാഗചംദ്രാ
জানকীবল্লভ	ജാനകീബല്ലഭ
জানকীভূষণ	ജാനകീഭൂഷണ
জানবী	ജാനബീ
জানহিতা	ജാനഹിതാ
জানীশ	ജാനീശ
জাবা	ജാബാ
জারন	ജാരന
জালেংদু	ജാലേംദു
জিগ্নাসা	ജിഗ്നാസാ
জীজ্ঞাশা	ജീജ്ഞാശാ
জীতেশী	ജീതേശീ
জীন্ষা	ജീന്ഷാ
জীমী	ജീമീ
জেনীকা	ജേനീകാ
জের্শীকা	ജേര്ശീകാ
জেসরী	ജേസരീ
জৈক্রীশ	ജൈക്രീശ
জৈন	ജൈന
জৈনিল	ജൈനില
জৈনীত	ജൈനീത
জৈমীনী	ജൈമീനീ
জৈহাসীনী	ജൈഹാസീനീ
জ্ঞানী	ജ്ഞാനീ
জ্ঞানেশ্বর	ജ്ഞാനേശ്ബര
জ্হুমাং	ജ്ഹുമാം
ঝারা	ഝാരാ
ঝিনূক	ഝിനൂക
ঝিযন	ഝിയന
ঝীল	ഝീല
ঝীহান	ഝീഹാന
ঝেনীল	ഝേനീല
ঝেনীশা	ഝേനീശാ
ঠাকুর	ഠാകുര
ঠুমরী	ഠുമരീ
তংত্র	തംത്ര
তজজ্ঞ	തജജ്ഞ
তনিশ্ক	തനിശ്ക
তনিষ	തനിഷ
তনুংগ্না	തനുംഗ്നാ
তনেশ	തനേശ
তনোজ	തനോജ
তন্বিকা	തന്ബികാ
তন্মাযা	തന്മായാ
তপেন্দ্র	തപേന്ദ്ര
তবলীন :	തബലീന :
তব্বু	തബ്ബു
তমসী	തമസീ
তরুণ  বিজয	തരുണ  ബിജയ
তরুন্সীবা	തരുന്സീബാ
তরুশ্রী	തരുശ്രീ
তরুসা	തരുസാ
তলংক	തലംക
তাত্বিক	താത്ബിക
তানুংমালয	താനുംമാലയ
তানুংশ্সী	താനുംശ്സീ
তাপিত	താപിത
তামাংশ্রী	താമാംശ്രീ
তারকনাথ	താരകനാഥ
তারকা	താരകാ
তারকেশ	താരകേശ
তারকেশ্বর	താരകേശ്ബര
তারচংদ	താരചംദ
তারা প্রশাদ	താരാ പ്രശാദ
তারাকিনী	താരാകിനീ
তারীশী	താരീശീ
তারুষ	താരുഷ
তালংক	താലംക
তালিকা	താലികാ
তালীন	താലീന
তিনাশ	തിനാശ
তিরবিকা	തിരബികാ
তিলক	തിലക
তিস্যা	തിസ്യാ
তীম্মাং	തീമ്മാം
তীযাসা	തീയാസാ
তীলাকারতনা	തീലാകാരതനാ
তীস্তা	തീസ്താ
তুমীর	തുമീര
তেজপাল	തേജപാല
তেজম	തേജമ
তেজস্মীতা	തേജസ്മീതാ
তেজ়	തേജ
তেজুস	തേജുസ
তেজোভাদ্র	തേജോഭാദ്ര
তেনুং	തേനും
তের্ষম	തേര്ഷമ
তোযেশ	തോയേശ
তোশাল	തോശാല
তোশী	തോശീ
ত্রিলোক	ത്രിലോക
ত্রীলূকামন	ത്രീലൂകാമന
ত্রীশ	ത്രീശ
থমারাঈ	ഥമാരാഈ
থারা	ഥാരാ
থেন্মোলী	ഥേന്മോലീ
থ্রানীসা	ഥ്രാനീസാ
দক্শিনযন	ദക്ശിനയന
দক্শীন্য	ദക്ശീന്യ
দক্ষেশ্বর	ദക്ഷേശ്ബര
দক্ষেষ	ദക്ഷേഷ
দত্তাত্রী	ദത്താത്രീ
দত্তাত্রেয	ദത്താത്രേയ
দনীলা	ദനീലാ
দনুংসীযা	ദനുംസീയാ
দন্যতা	ദന്യതാ
দবাশীশ	ദബാശീശ
দবীত	ദബീത
দযাল	ദയാല
দযাস্বরূপ	ദയാസ്ബരൂപ
দর্মীনী	ദര്മീനീ
দর্শনী	ദര്ശനീ
দর্শিক	ദര്ശിക
দর্শীল	ദര്ശീല
দলাপথী	ദലാപഥീ
দশাবহবে	ദശാബഹബേ
দানবেন্দ্রবিনাশকা	ദാനബേന്ദ്രബിനാശകാ
দান্দাপানী	ദാന്ദാപാനീ
দাব	ദാബ
দামন	ദാമന
দারুণ	ദാരുണ
দাল্ভযা	ദാല്ഭയാ
দাস	ദാസ
দিক্ষীন	ദിക്ഷീന
দিন দযাল	ദിന ദയാല
দিনাবংধাবে	ദിനാബംധാബേ
দিপন্ষা	ദിപന്ഷാ
দিপ্তিকা	ദിപ്തികാ
দিবেনা	ദിബേനാ
দিযা	ദിയാ
দিরাজ	ദിരാജ
দীক্ষিতা	ദീക്ഷിതാ
দীতা	ദീതാ
দীপক	ദീപക
দীপনা	ദീപനാ
দীপশিখা	ദീപശിഖാ
দীপালী	ദീപാലീ
দীপ্তা	ദീപ്താ
দীপ্তিকানা	ദീപ്തികാനാ
দেনীষ	ദേനീഷ
দেন্সী	ദേന്സീ
দেবগর্ভা	ദേബഗര്ഭാ
দেবর্পীতা	ദേബര്പീതാ
দেবা	ദേബാ
দেবাগাংধারী	ദേബാഗാംധാരീ
দেবারতী	ദേബാരതീ
দেবারীশী	ദേബാരീശീ
দেবিক	ദേബിക
দেবীন	ദേബീന
দেব্প্রসাদ	ദേബ്പ്രസാദ
দেব্প্রীতা	ദേബ്പ്രീതാ
দেম্ধেন্দ্র	ദേമ്ധേന്ദ്ര
দেযাশীনী	ദേയാശീനീ
দেস্পীনা	ദേസ്പീനാ
দৈবত	ദൈബത
দৈবী	ദൈബീ
দৈবেয	ദൈബേയ
ধনশ্রী	ധനശ്രീ
ধনিযা	ധനിയാ
ধন্যতা	ധന്യതാ
ধন্যশ্রী	ധന്യശ്രീ
ধরনী	ധരനീ
ধরাহাসীনী	ധരാഹാസീനീ
ধারিকা	ധാരികാ
ধারীত্রী	ധാരീത്രീ
ধার্শীকা	ധാര്ശീകാ
নংদ-নংদন	നംദ-നംദന
নংদপাল	നംദപാല
নংধা	നംധാ
নচিকেতা	നചികേതാ
নটরাজ	നടരാജ
নবকুংজ	നബകുംജ
নবরাতনা	നബരാതനാ
নবেংদু	നബേംദു
নমনা	നമനാ
নর্মদা	നര്മദാ
নাংবী	നാംബീ
নাগবেনী	നാഗബേനീ
নাগভুষণ	നാഗഭുഷണ
নাগমমাং	നാഗമമാം
নাগরাজু	നാഗരാജു
নাগেস্বারী	നാഗേസ്ബാരീ
নাতন	നാതന
নাতিন	നാതിന
নাতীক	നാതീക
নান্দীথা	നാന്ദീഥാ
নাবেতা	നാബേതാ
নাবেশা	നാബേശാ
নাভ্যা	നാഭ്യാ
নামাংহা	നാമാംഹാ
নাযসা	നായസാ
নাযানী	നായാനീ
নারাযণন	നാരായണന
নারাযন	നാരായന
নার্ন্রতা	നാര്ന്രതാ
নাশাল	നാശാല
নিদ্রা	നിദ്രാ
নিবা	നിബാ
নিহারিকা	നിഹാരികാ
নীকাশা	നീകാശാ
নীচিকা	നീചികാ
নীথী	നീഥീ
নীনা	നീനാ
নীবেদীতা	നീബേദീതാ
নীরজ নযন	നീരജ നയന
নীরব	നീരബ
নীলকাংত্	നീലകാംത്
নীলযা	നീലയാ
নীলাবাথী	നീലാബാഥീ
নীলাম্বর	നീലാമ്ബര
নীলাম্বরী	നീലാമ്ബരീ
নেকা	നേകാ
নেথ্রা	നേഥ്രാ
নেবেধা	നേബേധാ
নেমাংলী	നേമാംലീ
নেল্বীন	നേല്ബീന
নেসরা	നേസരാ
নৈংশী	നൈംശീ
নৈনীশ	നൈനീശ
নৈনুষ	നൈനുഷ
নৈমিষ	നൈമിഷ
নৈমিষা	നൈമിഷാ
নৈমেষ	നൈമേഷ
নৌরিন	നൌരിന
পংকজ	പംകജ
পংকাজধারিণী	പംകാജധാരിണീ
পংখী	പംഖീ
পংচজন্য	പംചജന്യ
পংধারী	പംധാരീ
পট মংজরী	പട മംജരീ
পতগ	പതഗ
পত্তাম্বরাপরীধানা	പത്താമ്ബരാപരീധാനാ
পত্র	പത്ര
পদমাংক্ষ্য	പദമാംക്ഷ്യ
পদ্মকাংত	പദ്മകാംത
পদ্মগ্রিহা	പദ്മഗ്രിഹാ
পদ্মমালিনী	പദ്മമാലിനീ
পদ্মাংকল্যানী	പദ്മാംകല്യാനീ
পদ্মাজঈ	പദ്മാജഈ
পনিতা	പനിതാ
পন্দালাবাসন	പന്ദാലാബാസന
পন্দীযারাজ	പന്ദീയാരാജ
পবন  আদিত্য	പബന  ആദിത്യ
পবনপুত্র	പബനപുത്ര
পবিত্রণ	പബിത്രണ
পবিনা	പബിനാ
পবীকরণ	പബീകരണ
পবীশ্না	പബീശ്നാ
পযোধরা	പയോധരാ
পরতাপ ; পরতাপ	പരതാപ ; പരതാപ
পরম-হংস	പരമ-ഹംസ
পরমাত্মা	പരമാത്മാ
পরমার্থ	പരമാര്ഥ
পরাকাষ	പരാകാഷ
পরান্জয	പരാന്ജയ
পরাসরা	പരാസരാ
পরিচয	പരിചയ
পরিসী	പരിസീ
পরেশ	പരേശ
পর্কাবী	പര്കാബീ
পর্নবী	പര്നബീ
পর্নল	പര്നല
পর্বতীপ্রিত	പര്ബതീപ്രിത
পর্হন	പര്ഹന
পলক	പലക
পলানী	പലാനീ
পলাশ	പലാശ
পল্লাবী	പല്ലാബീ
পহেল	പഹേല
পাক	പാക
পানমোলী	പാനമോലീ
পাব	പാബ
পাযোধর	പായോധര
পারিতোশ	പാരിതോശ
পারুল	പാരുല
পালীত	പാലീത
পাহী	പാഹീ
পীতাংবর	പീതാംബര
পীযাশা	പീയാശാ
পূজীতা	പൂജീതാ
পূর্বীজ্হা	പൂര്ബീജ്ഹാ
পূশীথা	പൂശീഥാ
পোউর্নীমাং	പോഉര്നീമാം
পোর্নীমাং	പോര്നീമാം
পোশীথা	പോശീഥാ
পৌরুষ	പൌരുഷ
ফণীশ	ഫണീശ
ফনিংদ্র	ഫനിംദ്ര
ফ্রেযল	ഫ്രേയല
ফ্লাবীনা	ഫ്ലാബീനാ
বংশজা	ബംശജാ
বংশীধর	ബംശീധര
বংসী	ബംസീ
বকা	ബകാ
বদ্রীনাথ	ബദ്രീനാഥ
বনমালা	ബനമാലാ
বনাজ	ബനാജ
বনীলা	ബനീലാ
বন্দীনী	ബന്ദീനീ
বন্ধানা	ബന്ധാനാ
বপুন	ബപുന
ববয	ബബയ
ববিশ	ബബിശ
বরজোত্তামাং	ബരജോത്താമാം
বর্টীক	ബര്ടീക
বর্তার	ബര്താര
বর্শনেযা	ബര്ശനേയാ
বর্শীতা	ബര്ശീതാ
বর্ষিত	ബര്ഷിത
বলরাম	ബലരാമ
বলাচান্দ্রণ	ബലാചാന്ദ്രണ
বলামানী	ബലാമാനീ
বলামুরুগন	ബലാമുരുഗന
বশীশ্কা	ബശീശ്കാ
বষা	ബഷാ
বসংতী	ബസംതീ
বসংথাজা	ബസംഥാജാ
বসব	ബസബ
বসুদেবন	ബസുദേബന
বস্তী	ബസ്തീ
বস্মীহা	ബസ്മീഹാ
বহুলেযন	ബഹുലേയന
বাংসুরী	ബാംസുരീ
বাগ-দেবী	ബാഗ-ദേബീ
বাচাস্য	ബാചാസ്യ
বাজীনাথ	ബാജീനാഥ
বাজ্রহাস্তা	ബാജ്രഹാസ്താ
বাত্সক	ബാത്സക
বানাজাক্ষী	ബാനാജാക്ഷീ
বানীস্রী	ബാനീസ്രീ
বানুজা	ബാനുജാ
বাপু	ബാപു
বাবীন	ബാബീന
বাযুন	ബായുന
বারীধার	ബാരീധാര
বার্গবী	ബാര്ഗബീ
বাল কৃষ্ণ	ബാല കൃഷ്ണ
বালচংদ্র	ബാലചംദ്ര
বালাদিত্য	ബാലാദിത്യ
বালামানী	ബാലാമാനീ
বালামুরুগন	ബാലാമുരുഗന
বালার	ബാലാര
বালারমাংথী	ബാലാരമാംഥീ
বালারাম	ബാലാരാമ
বাল্দাস	ബാല്ദാസ
বাল্মিক	ബാല്മിക
বাশু	ബാശു
বাস্তব	ബാസ്തബ
বিংদী	ബിംദീ
বিনা	ബിനാ
বিনাপানী	ബിനാപാനീ
বিপাশা	ബിപാശാ
বিরাজ	ബിരാജ
বীড্যা	ബീഡ്യാ
বীণা	ബീണാ
বীথীকা	ബീഥീകാ
বীনাবানী	ബീനാബാനീ
বীরাজীনী	ബീരാജീനീ
বুলবুল	ബുലബുല
বূমী	ബൂമീ
বেথিনা	ബേഥിനാ
বেদকার্তিক	ബേദകാര്തിക
বেদবিদ্যা	ബേദബിദ്യാ
বেদা শ্রী	ബേദാ ശ്രീ
বেদাবাথী	ബേദാബാഥീ
বেদীথা	ബേദീഥാ
বেনীতা	ബേനീതാ
বেন্শিক	ബേന്ശിക
বৈদয	ബൈദയ
বৈদ্যনাথ	ബൈദ്യനാഥ
বৈধাঈ	ബൈധാഈ
বৈরাজ	ബൈരാജ
বৈশ্নোব	ബൈശ്നോബ
ব্রহ্মবাদীনী	ബ്രഹ്മബാദീനീ
ব্রাহ্মী	ബ്രാഹ്മീ
ব্রিজা	ബ്രിജാ
ব্লেস্সী	ബ്ലേസ്സീ
ভক্তি	ഭക്തി
ভদ্রংগ	ഭദ്രംഗ
ভবিযা	ഭബിയാ
ভরনী	ഭരനീ
ভর্গ	ഭര്ഗ
ভাদ্রুষা	ഭാദ്രുഷാ
ভানু রেখা	ഭാനു രേഖാ
ভাব্যংশ	ഭാബ്യംശ
ভামিনী	ഭാമിനീ
ভার্গবী	ഭാര്ഗബീ
ভালচংদ্র	ഭാലചംദ്ര
ভাস্বন	ഭാസ്ബന
ভীবত্সুং	ഭീബത്സും
ভীলানগনা	ഭീലാനഗനാ
ভীষ্মা	ഭീഷ്മാ
ভুবা	ഭുബാ
ভূমি	ഭൂമി
ভেরূ	ഭേരൂ
ভোজা	ഭോജാ
ভৌমিক	ഭൌമിക
ভ্রামরী	ഭ്രാമരീ
মংদা	മംദാ
মংদিথ	മംദിഥ
মগধ	മഗധ
মগনা	മഗനാ
মদনীকা	മദനീകാ
মদির	മദിര
মধুমাংলী	മധുമാംലീ
মধুল	മധുല
মধুলতা	മധുലതാ
মধুশা	മധുശാ
মনিক	മനിക
মনীদীপ	മനീദീപ
মনীবলন	മനീബലന
মনীষ	മനീഷ
মমতা	മമതാ
মলাংক	മലാംക
মল্লিকা	മല്ലികാ
মহা গণপতি	മഹാ ഗണപതി
মহাতাপ	മഹാതാപ
মহাদেবাদীপুজীতা	മഹാദേബാദീപുജീതാ
মহাবালা	മഹാബാലാ
মহাবীর	മഹാബീര
মহারাবণমর্দানা	മഹാരാബണമര്ദാനാ
মহালক্ষ্মী	മഹാലക്ഷ്മീ
মহালিকা	മഹാലികാ
মহালীংগ	മഹാലീംഗ
মহিমা	മഹിമാ
মহিষাসুরমর্দিনী	മഹിഷാസുരമര്ദിനീ
মহীথা	മഹീഥാ
মহুযা	മഹുയാ
মহেন্দর	മഹേന്ദര
মহেলীকা	മഹേലീകാ
মহেশ	മഹേശ
মহেশ্বর	മഹേശ്ബര
মহোদরা	മഹോദരാ
মাংধুমাংন্তী	മാംധുമാംന്തീ
মাংনাশ্যুং	മാംനാശ്യും
মাংনীশোব্র্যা	മാംനീശോബ്ര്യാ
মাংন্জুনাতা	മാംന്ജുനാതാ
মাংন্দারিকা	മാംന്ദാരികാ
মাংলার্বীঝ্হী	മാംലാര്ബീഝ്ഹീ
মাংলাশ্রী	മാംലാശ്രീ
মাগথী	മാഗഥീ
মাথুর	മാഥുര
মাধান	മാധാന
মাধ্যম	മാധ്യമ
মানক	മാനക
মানজ	മാനജ
মানসিকা	മാനസികാ
মানিক	മാനിക
মানিনী	മാനിനീ
মানীএ	മാനീഏ
মানীসিলা	മാനീസിലാ
মানোবীকা	മാനോബീകാ
মান্দাবিক	മാന്ദാബിക
মান্ধাতা	മാന്ധാതാ
মান্মাতন	മാന്മാതന
মান্যসরী	മാന്യസരീ
মালারাবন	മാലാരാബന
মাল্লেষম	മാല്ലേഷമ
মাহিত	മാഹിത
মৈথ্রা	മൈഥ്രാ
মৈনাবী	മൈനാബീ
যজুর	യജുര
যদু	യദു
যদুনংদন	യദുനംദന
যশস্ব	യശസ്ബ
যশীল	യശീല
যশ্বী	യശ്ബീ
যাগবী/যহাবী	യാഗബീ/യഹാബീ
যাগ্নেশ্বারা	യാഗ്നേശ്ബാരാ
যাতনা	യാതനാ
যাদবা	യാദബാ
যামি	യാമി
যামিনী	യാമിനീ
যাশ্রী	യാശ്രീ
যুকাশ্রী	യുകാശ്രീ
যুগান্ধর	യുഗാന്ധര
যুতি	യുതി
যুধ্ধ	യുധ്ധ
যুব	യുബ
যুবরাণী	യുബരാണീ
যুবানী	യുബാനീ
যুবাসরী	യുബാസരീ
যেঘরাজ	യേഘരാജ
যেনাক্ষী	യേനാക്ഷീ
যেশাস্বীনী	യേശാസ്ബീനീ
যেশ্বীন	യേശ്ബീന
যেস্বীন	യേസ്ബീന
যোগনা	യോഗനാ
যোগী	യോഗീ
যোগীন	യോഗീന
যোগেশ্বর	യോഗേശ്ബര
যোচনা	യോചനാ
যোত্শনা	യോത്ശനാ
যোশন	യോശന
যোশিতা	യോശിതാ
যোষিত	യോഷിത
যৌষা	യൌഷാ
রংগনাতন	രംഗനാതന
রংগিথা	രംഗിഥാ
রংজীব	രംജീബ
রংহ	രംഹ
রংহিতা	രംഹിതാ
রক্ষা	രക്ഷാ
রক্ষ্য	രക്ഷ്യ
রগাব	രഗാബ
রগীশ	രഗീശ
রঘবেন্দর	രഘബേന്ദര
রজনী	രജനീ
রজনীগংধা	രജനീഗംധാ
রজিত	രജിത
রণছোড	രണഛോഡ
রণবিজয	രണബിജയ
রনীত	രനീത
রন্কীনী	രന്കീനീ
রমণীক	രമണീക
রমাংভাদ্র	രമാംഭാദ്ര
রমাংস্বম্য	രമാംസ്ബമ്യ
রসনা	രസനാ
রাকীন	രാകീന
রাগ	രാഗ
রাগ্বীনদার	രാഗ്ബീനദാര
রাজঋষি	രാജഋഷി
রাজস	രാജസ
রাজসূয	രാജസൂയ
রাজসেকরণ	രാജസേകരണ
রাজান্ন্য	രാജാന്ന്യ
রাজাবেলুং	രാജാബേലും
রাজারাম	രാജാരാമ
রাজালক্ষ্মী	രാജാലക്ഷ്മീ
রাজীষ	രാജീഷ
রাজেন্দর	രാജേന്ദര
রাজেশ্রম	രാജേശ്രമ
রাজ্বলা	രാജ്ബലാ
রাধিকা	രാധികാ
রাধী	രാധീ
রাধেশ	രാധേശ
রাম  কীন্কার	രാമ  കീന്കാര
রামকথালোলাযা	രാമകഥാലോലായാ
রামচংদর	രാമചംദര
রামচংদ্র	രാമചംദ്ര
রামনাথন	രാമനാഥന
রামাধুতা	രാമാധുതാ
রাষীপ	രാഷീപ
রিনী	രിനീ
রিলা	രിലാ
রীমা	രീമാ
রীষা	രീഷാ
রেধা	രേധാ
রেভা	രേഭാ
রেমিথা	രേമിഥാ
রেহা	രേഹാ
রোসাহেব	രോസാഹേബ
লক্ষণা	ലക്ഷണാ
লক্ষ্মণ	ലക്ഷ്മണ
লক্ষ্মিবংতা	ലക്ഷ്മിബംതാ
লক্ষ্মীকা	ലക്ഷ്മീകാ
লক্ষ্মীনাথ	ലക്ഷ്മീനാഥ
লক্ষ্মীনারাযনা	ലക്ഷ്മീനാരായനാ
লজীথা	ലജീഥാ
লবিনিযা	ലബിനിയാ
লযনা	ലയനാ
ললিতামোহনা	ലലിതാമോഹനാ
লাক্শীকা	ലാക്ശീകാ
লান্কীনীভান্জানা	ലാന്കീനീഭാന്ജാനാ
লালন	ലാലന
লালনা	ലാലനാ
লালী	ലാലീ
লীজেশ	ലീജേശ
লীতীশা	ലീതീശാ
লীনেয্ষা	ലീനേയ്ഷാ
লীন্গসম্য	ലീന്ഗസമ്യ
লীন্নেত	ലീന്നേത
লীন্সী	ലീന്സീ
লীলাকর	ലീലാകര
লীশীথা	ലീശീഥാ
লুকেশ্বর	ലുകേശ്ബര
লুব্যা	ലുബ്യാ
লুম্বিনী	ലുമ്ബിനീ
লুসিযা	ലുസിയാ
লেঈবীনা	ലേഈബീനാ
লেখিত	ലേഖിത
লেনীশা	ലേനീശാ
লেমাং	ലേമാം
লোকাপতী	ലോകാപതീ
লোকীথা	ലോകീഥാ
লোকীনী	ലോകീനീ
লোকেন্দের	ലോകേന്ദേര
লোগনাথন	ലോഗനാഥന
লোগীতা	ലോഗീതാ
লোবীশ	ലോബീശ
লোবেযংশ	ലോബേയംശ
লোবেলীন	ലോബേലീന
লোলাকসী	ലോലാകസീ
লোহেংদ্র	ലോഹേംദ്ര
সংকষ্টী	സംകഷ്ടീ
সংকেত	സംകേത
সংচিতা	സംചിതാ
সংজাণথী	സംജാണഥീ
সংজীতী	സംജീതീ
সংভাজী	സംഭാജീ
সক্তীবেল	സക്തീബേല
সক্ষম	സക്ഷമ
সখ্যা	സഖ്യാ
সচংদ্র	സചംദ്ര
সচিদানংদ বিগ্রহ	സചിദാനംദ ബിഗ്രഹ
সচিশ	സചിശ
সচীনা	സചീനാ
সজনী	സജനീ
সজলা	സജലാ
সজীলী	സജീലീ
সদগুনা	സദഗുനാ
সদভুজা	സദഭുജാ
সনাহ	സനാഹ
সবরিশ	സബരിശ
সমবরণ	സമബരണ
সমরজীত	സമരജീത
সমাংখ্যা	സമാംഖ്യാ
সমান্য	സമാന്യ
সমাপ্তি	സമാപ്തി
সমিতা	സമിതാ
সমীপতা	സമീപതാ
সমুদীতা	സമുദീതാ
সমেধ	സമേധ
সম্কীর্তী	സമ്കീര്തീ
সম্মতি	സമ്മതി
সম্রীতা	സമ്രീതാ
সম্হীঠা	സമ്ഹീഠാ
সম্হীত	സമ്ഹീത
সলজ	സലജ
সলারজুংগ	സലാരജുംഗ
সলীজ	സലീജ
সলোখ	സലോഖ
সহজানংদ	സഹജാനംദ
সহস্য	സഹസ്യ
সহুরী	സഹുരീ
সহেলী	സഹേലീ
সহ্রুদী	സഹ്രുദീ
সাঈ	സാഈ
সাঈ কুমার	സാഈ കുമാര
সাঈ চরণ	സാഈ ചരണ
সাঈ সাহস	സാഈ സാഹസ
সাকেত  শ্রীরাম	സാകേത  ശ്രീരാമ
সাগরী	സാഗരീ
সাগ্নীকা	സാഗ്നീകാ
সাচিকা	സാചികാ
সাজিশ	സാജിശ
সাত্বী	സാത്ബീ
সাধনা	സാധനാ
সাধীন	സാധീന
সাধ্রী	സാധ്രീ
সানাবী	സാനാബീ
সানিযা	സാനിയാ
সাফল্য	സാഫല്യ
সামলী	സാമലീ
সামান	സാമാന
সালন	സാലന
সাহিত্য	സാഹിത്യ
সাহিল	സാഹില
সৈকত	സൈകത
সৈচারণ	സൈചാരണ
সৈলী	സൈലീ
সৈলেশ্বর	സൈലേശ്ബര
সৈস্বেঠা	സൈസ്ബേഠാ
হংসিক	ഹംസിക
হতিশা	ഹതിശാ
হনীমা	ഹനീമാ
হনীশ	ഹനീശ
হনুমংত	ഹനുമംത
হন্বীথা	ഹന്ബീഥാ
হবন	ഹബന
হম্সলেখা	ഹമ്സലേഖാ
হযাতী	ഹയാതീ
হরম্যা	ഹരമ്യാ
হরা	ഹരാ
হরীআক্ষ	ഹരീആക്ഷ
হরীচংদনা	ഹരീചംദനാ
হরীরাম	ഹരീരാമ
হরীশ	ഹരീശ
হরেকৃষ্ণ	ഹരേകൃഷ്ണ
হরেশ	ഹരേശ
হরেহান	ഹരേഹാന
হর্থীকা	ഹര്ഥീകാ
হর্শত	ഹര്ശത
হশন	ഹശന
হশিকা	ഹശികാ
হশ্বর্ধন	ഹശ്ബര്ധന
হসিত	ഹസിത
হসীত	ഹസീത
হসীনী	ഹസീനീ
হস্বীকা	ഹസ്ബീകാ
হস্সীনী	ഹസ്സീനീ
হাকেশ	ഹാകേശ
হারজীত	ഹാരജീത
হাসীতা	ഹാസീതാ
হিডিংবা	ഹിഡിംബാ
হিত	ഹിത
হিতেশ	ഹിതേശ
হিথীকা	ഹിഥീകാ
হিমংজয	ഹിമംജയ
হিমবংত	ഹിമബംത
হিরকনী	ഹിരകനീ
হিরণ	ഹിരണ
হিরেশ	ഹിരേശ
হিশেথা	ഹിശേഥാ
হীমীর	ഹീമീര
হেতংশ	ഹേതംശ
হেনীত	ഹേനീത
হেনীশী	ഹേനീശീ
হেপ্পী	ഹേപ്പീ
হেমচংদর	ഹേമചംദര
হেমরাজ	ഹേമരാജ
হেমা লাথী	ഹേമാ ലാഥീ
হেমাংগ	ഹേമാംഗ
হেমাংবিংদু	ഹേമാംബിംദു
হেমাংশু	ഹേമാംശു
হেমাগনী	ഹേമാഗനീ
হেমিল	ഹേമില
হেম্স	ഹേമ്സ
হেরংব	ഹേരംബ
হৈমাং	ഹൈമാം
হৈযা	ഹൈയാ
হোমা	ഹോമാ
হ্রাদিনী	ഹ്രാദിനീ
হ্রাধা	ഹ്രാധാ
হ্রীদা	ഹ്രീദാ
হ্রীদান্ক্ষ	ഹ്രീദാന്ക്ഷ
#
#
# Territory names from CLDR
অ্যাসসেনশন আইল্যান্ড	അ്യാസസേനശന ആഇല്യാന്ഡ
এ্যান্ডোরা	ഏ്യാന്ഡോരാ
সংযুক্ত আরব আমিরাত	സംയുക്ത ആരബ ആമിരാത
আফগানিস্তান	ആഫഗാനിസ്താന
এন্টিগুয়া ও বারবুডা	ഏന്ടിഗുയാ ഓ ബാരബുഡാ
এ্যাঙ্গুইলা	ഏ്യാങ്ഗുഇലാ
আলব্যানিয়া	ആലബ്യാനിയാ
আর্মেনিয়া	ആര്മേനിയാ
অ্যাঙ্গোলা	അ്യാങ്ഗോലാ
অ্যান্টার্কটিকা	അ്യാന്ടാര്കടികാ
আর্জেন্টিনা	ആര്ജേന്ടിനാ
আমেরিকান সামোয়া	ആമേരികാന സാമോയാ
অস্ট্রিয়া	അസ്ട്രിയാ
অস্ট্রেলিয়া	അസ്ട്രേലിയാ
আরুবা	ആരുബാ
আলান্ড দ্বীপপুঞ্জ	ആലാന്ഡ ദ്ബീപപുഞ്ജ
আজারবাইজান	ആജാരബാഇജാന
বসনিয়া ও হার্জেগোভিনা	ബസനിയാ ഓ ഹാര്ജേഗോഭിനാ
বারবাদোস	ബാരബാദോസ
বাংলাদেশ	ബാംലാദേശ
বেলজিয়াম	ബേലജിയാമ
বুরকিনা ফাসো	ബുരകിനാ ഫാസോ
বুলগেরিয়া	ബുലഗേരിയാ
বাহরাইন	ബാഹരാഇന
বুরুন্ডি	ബുരുന്ഡി
বেনিন	ബേനിന
সেন্ট বারথেলিমি	സേന്ട ബാരഥേലിമി
বারমুডা	ബാരമുഡാ
ব্রুনেই	ബ്രുനേഇ
বোলিভিয়া	ബോലിഭിയാ
ক্যারিবিয়ান নেদারল্যান্ডস	ക്യാരിബിയാന നേദാരല്യാന്ഡസ
ব্রাজিল	ബ്രാജില
বাহামা দ্বীপপুঞ্জ	ബാഹാമാ ദ്ബീപപുഞ്ജ
ভুটান	ഭുടാന
বোভেট দ্বীপ	ബോഭേട ദ്ബീപ
বতসোয়ানা	ബതസോയാനാ
বেলোরুশিয়া	ബേലോരുശിയാ
বেলিজ	ബേലിജ
কানাডা	കാനാഡാ
কোকোস (কিলিং)দ্বীপপুঞ্জ	കോകോസ (കിലിം)ദ്ബീപപുഞ്ജ
কঙ্গো-কিনশাসা	കങ്ഗോ-കിനശാസാ
কঙ্গো(DRC)	കങ്ഗോ(DRC)
মধ্য আফ্রিকার প্রজাতন্ত্র	മധ്യ ആഫ്രികാര പ്രജാതന്ത്ര
কঙ্গো - ব্রাজাভিল	കങ്ഗോ - ബ്രാജാഭില
কঙ্গো (প্রজাতন্ত্র)	കങ്ഗോ (പ്രജാതന്ത്ര)
সুইজারল্যান্ড	സുഇജാരല്യാന്ഡ
আইভরি কোস্ট	ആഇഭരി കോസ്ട
কুক দ্বীপপুঞ্জ	കുക ദ്ബീപപുഞ്ജ
চিলি	ചിലി
ক্যামেরুন	ക്യാമേരുന
চীন	ചീന
কোলোম্বিয়া	കോലോമ്ബിയാ
ক্লিপারটন আইল্যান্ড	ക്ലിപാരടന ആഇല്യാന്ഡ
কোস্টারিকা	കോസ്ടാരികാ
কিউবা	കിഉബാ
কেপভার্দে	കേപഭാര്ദേ
কিউরাসাও	കിഉരാസാഓ
ক্রিসমাস দ্বীপ	ക്രിസമാസ ദ്ബീപ
সাইপ্রাস	സാഇപ്രാസ
চেক প্রজাতন্ত্র	ചേക പ്രജാതന്ത്ര
জার্মানি	ജാര്മാനി
দিয়েগো গার্সিয়া	ദിയേഗോ ഗാര്സിയാ
জিবুতি	ജിബുതി
ডেনমার্ক	ഡേനമാര്ക
ডোমিনিকা	ഡോമിനികാ
ডোমেনিকান প্রজাতন্ত্র	ഡോമേനികാന പ്രജാതന്ത്ര
আলজেরিয়া	ആലജേരിയാ
কুউটা এবং মেলিলা	കുഉടാ ഏബം മേലിലാ
ইকুয়েডর	ഇകുയേഡര
এস্তোনিয়া	ഏസ്തോനിയാ
মিশর	മിശര
পশ্চিম সাহারা	പശ്ചിമ സാഹാരാ
ইরিত্রিয়া	ഇരിത്രിയാ
স্পেন	സ്പേന
ইফিওপিয়া	ഇഫിഓപിയാ
ইউরোপীয় ইউনিয়ন	ഇഉരോപീയ ഇഉനിയന
ফিনল্যান্ড	ഫിനല്യാന്ഡ
ফিজি	ഫിജി
ফকল্যান্ড দ্বীপপুঞ্জ	ഫകല്യാന്ഡ ദ്ബീപപുഞ്ജ
ফকল্যান্ড আইল্যান্ড ( ইসল্যাস মাসভেনিস)	ഫകല്യാന്ഡ ആഇല്യാന്ഡ ( ഇസല്യാസ മാസഭേനിസ)
মাইক্রোনেশিয়া	മാഇക്രോനേശിയാ
ফ্যারও দ্বীপপুঞ্জ	ഫ്യാരഓ ദ്ബീപപുഞ്ജ
ফ্রান্স	ഫ്രാന്സ
গ্যাবন	ഗ്യാബന
যুক্তরাজ্য	യുക്തരാജ്യ
গ্রেনেডা	ഗ്രേനേഡാ
জর্জিয়া	ജര്ജിയാ
ফরাসী গায়ানা	ഫരാസീ ഗായാനാ
গ্রাঞ্জি	ഗ്രാഞ്ജി
ঘানা	ഘാനാ
জিব্রাল্টার	ജിബ്രാല്ടാര
গ্রীনল্যান্ড	ഗ്രീനല്യാന്ഡ
গাম্বিয়া	ഗാമ്ബിയാ
গিনি	ഗിനി
গুয়াদেলৌপ	ഗുയാദേലൌപ
নিরক্ষীয় গিনি	നിരക്ഷീയ ഗിനി
গ্রীস	ഗ്രീസ
দক্ষিণ জর্জিয়া ও দক্ষিণ স্যান্ডউইচ দ্বীপপুঞ্জ	ദക്ഷിണ ജര്ജിയാ ഓ ദക്ഷിണ സ്യാന്ഡഉഇച ദ്ബീപപുഞ്ജ
গোয়াতেমালা	ഗോയാതേമാലാ
গুয়াম	ഗുയാമ
গিনি-বিসাউ	ഗിനി-ബിസാഉ
গিয়ানা	ഗിയാനാ
হংকং এসএআর চীনা	ഹംകം ഏസഏആര ചീനാ
হংকং	ഹംകം
হার্ড দ্বীপ এবং ম্যাকডোনাল্ড দ্বীপপুঞ্জ	ഹാര്ഡ ദ്ബീപ ഏബം മ്യാകഡോനാല്ഡ ദ്ബീപപുഞ്ജ
হণ্ডুরাস	ഹണ്ഡുരാസ
ক্রোয়েশিয়া	ക്രോയേശിയാ
হাইতি	ഹാഇതി
হাঙ্গেরি	ഹാങ്ഗേരി
ক্যানারি দ্বীপপুঞ্জ	ക്യാനാരി ദ്ബീപപുഞ്ജ
ইন্দোনেশিয়া	ഇന്ദോനേശിയാ
আয়ারল্যান্ড	ആയാരല്യാന്ഡ
ইজরায়েল	ഇജരായേല
আইল অফ ম্যান	ആഇല അഫ മ്യാന
ভারত	ഭാരത
ব্রিটিশ ভারত মহাসাগরীয় অঞ্চল	ബ്രിടിശ ഭാരത മഹാസാഗരീയ അഞ്ചല
ইরাক	ഇരാക
ইরান	ഇരാന
আইসল্যান্ড	ആഇസല്യാന്ഡ
ইতালী	ഇതാലീ
জার্সি	ജാര്സി
জামাইকা	ജാമാഇകാ
জর্ডন	ജര്ഡന
জাপান	ജാപാന
কেনিয়া	കേനിയാ
কির্গিজিয়া	കിര്ഗിജിയാ
কম্বোডিয়া	കമ്ബോഡിയാ
কিরিবাতি	കിരിബാതി
কমোরোস	കമോരോസ
সেন্ট কিটস ও নেভিস	സേന്ട കിടസ ഓ നേഭിസ
উত্তর কোরিয়া	ഉത്തര കോരിയാ
দক্ষিণ কোরিয়া	ദക്ഷിണ കോരിയാ
কুয়েত	കുയേത
কেম্যান দ্বীপপুঞ্জ	കേമ്യാന ദ്ബീപപുഞ്ജ
কাজাখস্তান	കാജാഖസ്താന
লাওস	ലാഓസ
লেবানন	ലേബാനന
সেন্ট লুসিয়া	സേന്ട ലുസിയാ
লিচেনস্টেইন	ലിചേനസ്ടേഇന
শ্রীলঙ্কা	ശ്രീലങ്കാ
লাইবেরিয়া	ലാഇബേരിയാ
লেসোথো	ലേസോഥോ
লিথুয়ানিয়া	ലിഥുയാനിയാ
লাক্সেমবার্গ	ലാക്സേമബാര്ഗ
লাত্ভিয়া	ലാത്ഭിയാ
লিবিয়া	ലിബിയാ
মোরক্কো	മോരക്കോ
মোনাকো	മോനാകോ
মোল্দাভিয়া	മോല്ദാഭിയാ
মন্টিনিগ্রো	മന്ടിനിഗ്രോ
সেন্ট মার্টিন	സേന്ട മാര്ടിന
মাদাগাস্কার	മാദാഗാസ്കാര
মার্শাল দ্বীপপুঞ্জ	മാര്ശാല ദ്ബീപപുഞ്ജ
ম্যাসাডোনিয়া	മ്യാസാഡോനിയാ
মেসিডোনিয়া(FYROM)	മേസിഡോനിയാ(FYROM)
মালি	മാലി
মায়ানমার (বার্মা)	മായാനമാര (ബാര്മാ)
মঙ্গোলিয়া	മങ്ഗോലിയാ
ম্যাকাও এস এ আর চায়না	മ്യാകാഓ ഏസ ഏ ആര ചായനാ
ম্যাকাও	മ്യാകാഓ
উত্তরাঞ্চলীয় মারিয়ানা দ্বীপপুঞ্জ	ഉത്തരാഞ്ചലീയ മാരിയാനാ ദ്ബീപപുഞ്ജ
মার্টিনিক	മാര്ടിനിക
মরিতানিয়া	മരിതാനിയാ
মন্টসেরাট	മന്ടസേരാട
মাল্টা	മാല്ടാ
মরিশাস	മരിശാസ
মালদ্বীপ	മാലദ്ബീപ
মালাউই	മാലാഉഇ
মেক্সিকো	മേക്സികോ
মালয়েশিয়া	മാലയേശിയാ
মোজাম্বিক	മോജാമ്ബിക
নামিবিয়া	നാമിബിയാ
নিউ ক্যালেডোনিয়া	നിഉ ക്യാലേഡോനിയാ
নাইজার	നാഇജാര
নিরফোক দ্বীপ	നിരഫോക ദ്ബീപ
নাইজেরিয়া	നാഇജേരിയാ
নিকারাগুয়া	നികാരാഗുയാ
নেদারল্যান্ডস	നേദാരല്യാന്ഡസ
নরওয়ে	നരഓയേ
নেপাল	നേപാല
নাউরু	നാഉരു
নিউয়ে	നിഉയേ
নিউজিল্যান্ড	നിഉജില്യാന്ഡ
ওমান	ഓമാന
পানামা	പാനാമാ
পিরু	പിരു
ফরাসী পলিনেশিয়া	ഫരാസീ പലിനേശിയാ
পাপুয়া নিউ গিনি	പാപുയാ നിഉ ഗിനി
ফিলিপাইন	ഫിലിപാഇന
পাকিস্তান	പാകിസ്താന
পোল্যান্ড	പോല്യാന്ഡ
সেন্ট পিয়ের ও মিকুয়েলন	സേന്ട പിയേര ഓ മികുയേലന
পিটকেয়ার্ন দ্বীপপুঞ্জ	പിടകേയാര്ന ദ്ബീപപുഞ്ജ
পুয়ের্তো রিকো	പുയേര്തോ രികോ
ফিলিস্তিন অঞ্চলসমূহ	ഫിലിസ്തിന അഞ്ചലസമൂഹ
ফিলিস্তিন	ഫിലിസ്തിന
পর্তুগাল	പര്തുഗാല
পালাউ	പാലാഉ
প্যারাগুয়ে	പ്യാരാഗുയേ
কাতার	കാതാര
আউটলাইনিং ওসানিয়া	ആഉടലാഇനിം ഓസാനിയാ
রিইউনিয়ন	രിഇഉനിയന
রুমানিয়া	രുമാനിയാ
সার্বিয়া	സാര്ബിയാ
রাশিয়া	രാശിയാ
রুয়ান্ডা	രുയാന്ഡാ
সৌদি আরব	സൌദി ആരബ
সলোমন দ্বীপপুঞ্জ	സലോമന ദ്ബീപപുഞ്ജ
সিসিলি	സിസിലി
সুদান	സുദാന
সুইডেন	സുഇഡേന
সিঙ্গাপুর	സിങ്ഗാപുര
সেন্ট হেলেনা	സേന്ട ഹേലേനാ
স্লোভানিয়া	സ്ലോഭാനിയാ
স্বালবার্ড ও জান মেয়েন	സ്ബാലബാര്ഡ ഓ ജാന മേയേന
শ্লোভাকিয়া	ശ്ലോഭാകിയാ
সিয়েরালিওন	സിയേരാലിഓന
সান মারিনো	സാന മാരിനോ
সেনেগাল	സേനേഗാല
সোমালিয়া	സോമാലിയാ
সুরিনাম	സുരിനാമ
দক্ষিন সুদান	ദക്ഷിന സുദാന
সাওটোমা ও প্রিন্সিপি	സാഓടോമാ ഓ പ്രിന്സിപി
এল সালভেদর	ഏല സാലഭേദര
সিন্ট মার্টেন	സിന്ട മാര്ടേന
সিরিয়া	സിരിയാ
সোয়াজিল্যান্ড	സോയാജില്യാന്ഡ
ট্রিস্টান ডা কুনহা	ട്രിസ്ടാന ഡാ കുനഹാ
তুর্কস ও কাইকোস দ্বীপপুঞ্জ	തുര്കസ ഓ കാഇകോസ ദ്ബീപപുഞ്ജ
চাদ	ചാദ
ফরাসী দক্ষিণাঞ্চল	ഫരാസീ ദക്ഷിണാഞ്ചല
টোগো	ടോഗോ
থাইল্যান্ড	ഥാഇല്യാന്ഡ
তাজিকস্থান	താജികസ്ഥാന
টোকেলাউ	ടോകേലാഉ
তিমুর-লেস্তে	തിമുര-ലേസ്തേ
পূর্ব তিমুর	പൂര്ബ തിമുര
তুর্কমেনিস্তান	തുര്കമേനിസ്താന
তিউনিশিয়া	തിഉനിശിയാ
টোঙ্গা	ടോങ്ഗാ
তুরস্ক	തുരസ്ക
ত্রিনিনাদ ও টোব্যাগো	ത്രിനിനാദ ഓ ടോബ്യാഗോ
টুভালু	ടുഭാലു
তাইওয়ান	താഇഓയാന
তাঞ্জানিয়া	താഞ്ജാനിയാ
ইউক্রেইন	ഇഉക്രേഇന
উগান্ডা	ഉഗാന്ഡാ
যুক্তরাষ্ট্রের পার্শ্ববর্তী দ্বীপপুঞ্জ	യുക്തരാഷ്ട്രേര പാര്ശ്ബബര്തീ ദ്ബീപപുഞ്ജ
মার্কিন যুক্তরাষ্ট্র	മാര്കിന യുക്തരാഷ്ട്ര
ইউ এস	ഇഉ ഏസ
উরুগুয়ে	ഉരുഗുയേ
উজবেকিস্তান	ഉജബേകിസ്താന
ভ্যাটিকান সিটি	ഭ്യാടികാന സിടി
সেন্ট ভিনসেন্ট ও দ্যা গ্রেনাডিনস	സേന്ട ഭിനസേന്ട ഓ ദ്യാ ഗ്രേനാഡിനസ
ভেনেজুয়েলা	ഭേനേജുയേലാ
ব্রিটিশ ভার্জিন দ্বীপপুঞ্জ	ബ്രിടിശ ഭാര്ജിന ദ്ബീപപുഞ്ജ
মার্কিন ভার্জিন দ্বীপপুঞ্জ	മാര്കിന ഭാര്ജിന ദ്ബീപപുഞ്ജ
ভিয়েতনাম	ഭിയേതനാമ
ভানুয়াটু	ഭാനുയാടു
ওয়ালিস ও ফুটুনা	ഓയാലിസ ഓ ഫുടുനാ
সামোয়া	സാമോയാ
কসোভো	കസോഭോ
ইয়েমেন	ഇയേമേന
মায়োত্তে	മായോത്തേ
দক্ষিণ আফ্রিকা	ദക്ഷിണ ആഫ്രികാ
জাম্বিয়া	ജാമ്ബിയാ
জিম্বাবোয়ে	ജിമ്ബാബോയേ
অজানা স্থান	അജാനാ സ്ഥാന
