# Baby names
अनिया	அநியா
आकर्षक	ஆகர்ஷக
आघोश	ஆகோஶ
आदम्य	ஆதம்ய
आदर्श	ஆதர்ஶ
आदित्व	ஆதித்வ
आदिया	ஆதியா
आदीजय	ஆதீஜய
आधाव	ஆதாவ
आधीरेन	ஆதீரேந
आध्या	ஆத்யா
आन	ஆந
आनंत्या	ஆநஂத்யா
आनंदित	ஆநஂதித
आनाधीता	ஆநாதீதா
आनाया	ஆநாயா
आन्वी	ஆந்வீ
आभात	ஆபாத
आमोघ	ஆமோக
आमोदीन	ஆமோதீந
आर	ஆர
आराड्या	ஆராட்யா
आराधक	ஆராதக
आराधना	ஆராதநா
आराध्य	ஆராத்ய
आरीन	ஆரீந
आर्ना	ஆர்நா
आल्या	ஆல்யா
आहलादिता	ஆஹலாதிதா
इंदिरा	இஂதிரா
इंदुकला	இஂதுகலா
इंदुजा	இஂதுஜா
इंदुभूषण	இஂதுபூஷண
इंदुलाला	இஂதுலாலா
इकंश	இகஂஶ
इक्शु	இக்ஶு
इक्षित	இக்ஷித
इक्सुरा	இக்ஸுரா
इदित्री	இதித்ரீ
इधित्री	இதித்ரீ
इन्गनाम	இந்கநாம
इन्दिवारस	இந்திவாரஸ
इन्दुप्रभा	இந்துப்ரபா
इन्दुमत	இந்துமத
इन्दुमांथी	இந்துமாஂதீ
इन्द्रदयुम्न	இந்த்ரதயும்ந
इन्द्रसेन	இந்த்ரஸேந
इरावत	இராவத
इरित	இரித
इलंपीरई	இலஂபீரஈ
इलावेनिल	இலாவேநில
इष्टा	இஷ்டா
इसार	இஸார
इह्सान	இஹ்ஸாந
ईज्या	ஈஜ்யா
ईझ्रीने	ஈச்ரீநே
ईदी	ஈதீ
ईम्पाल	ஈம்பால
ईरीन	ஈரீந
ईरीश	ஈரீஶ
ईलापताये	ஈலாபதாயே
ईल्लीशा	ஈல்லீஶா
ईशान	ஈஶாந
ईशानी	ஈஶாநீ
ईश्वर	ஈஶ்வர
ईसैवलन	ஈஸைவலந
उग्रस्रवास	உக்ரஸ்ரவாஸ
उग्रेश	உக்ரேஶ
उच्चल	உச்சல
उजाला	உஜாலா
उज्जवल	உஜ்ஜவல
उज्ज्वला /उज्वला	உஜ்ஜ்வலா /உஜ்வலா
उज्वल	உஜ்வல
उदय कुमार	உதய குமார
उदयसूरियाँ	உதயஸூரியாஂ
उदीता	உதீதா
उद्गिता	உத்கிதா
उद्दीप्ता	உத்தீப்தா
उद्वंश	உத்வஂஶ
उननीका	உநநீகா
उन्जली	உந்ஜலீ
उन्नाथी	உந்நாதீ
उन्न्य	உந்ந்ய
उन्मा	உந்மா
उपदा	உபதா
उमरानी	உமராநீ
उमा शंकर	உமா ஶஂகர
उमांमांहेश्वर	உமாஂமாஂஹேஶ்வர
उम्सीहा	உம்ஸீஹா
उरवशी	உரவஶீ
उर्मिला	உர்மிலா
उर्वरा	உர்வரா
उर्वशी	உர்வஶீ
उर्वा	உர்வா
उर्वी	உர்வீ
उल्केश	உல்கேஶ
उषाकिरण	உஷாகிரண
ऊर्जा	ஊர்ஜா
एअस्वरण	ஏஅஸ்வரண
एकक्षरपरा	ஏகக்ஷரபரா
एकत्र	ஏகத்ர
एकना	ஏகநா
एकयावन	ஏகயாவந
एकलव्य	ஏகலவ்ய
एकलव्या	ஏகலவ்யா
एकांश	ஏகாஂஶ
एकाक्षा	ஏகாக்ஷா
एकाग्रह	ஏகாக்ரஹ
एकाचक्र	ஏகாசக்ர
एकाधना	ஏகாதநா
एकेस्वार	ஏகேஸ்வார
एच्चुमति	ஏச்சுமதி
एधा	ஏதா
एलान्द्र	ஏலாந்த்ர
एलीना	ஏலீநா
एलीशा	ஏலீஶா
एवान्गेलीन	ஏவாந்கேலீந
एवोन	ஏவோந
एशांश	ஏஶாஂஶ
एशान्य	ஏஶாந்ய
एशिका	ஏஶிகா
एश्वर	ஏஶ்வர
एहीत	ஏஹீத
ऑरी	ஒரீ
ओजस्वानी	ஓஜஸ்வாநீ
ओजस्वीत	ஓஜஸ்வீத
ओदथी	ஓததீ
ओनिश	ஓநிஶ
ओन्नेशा	ஓந்நேஶா
ओप्पिलमणि	ஓப்பிலமணி
ओय्शी	ஓய்ஶீ
ओवियान	ஓவியாந
ओशमां	ஓஶமாஂ
ओशि	ஓஶி
ओश्मी	ஓஶ்மீ
कक्षक	கக்ஷக
कक्षाप	கக்ஷாப
कदंबन	கதஂபந
कबीलाश	கபீலாஶ
कल-हंस	கல-ஹஂஸ
कलाकांती	கலாகாஂதீ
कलाधर	கலாதர
कलाप	கலாப
कलासावेरी	கலாஸாவேரீ
कलिंग	கலிஂக
कलीयाह	கலீயாஹ
कलैवानी	கலைவாநீ
कल्पना	கல்பநா
कल्पिनी	கல்பிநீ
कल्मेश	கல்மேஶ
कल्याणी	கல்யாணீ
कल्लोला	கல்லோலா
कहेर	கஹேர
काजल	காஜல
काजाल्सरी	காஜால்ஸரீ
कान्चानाध्वाजा	காந்சாநாத்வாஜா
कान्हा	காந்ஹா
कामज	காமஜ
कामना	காமநா
कामित	காமித
कामोदी	காமோதீ
कारुं	காருஂ
कार्तिक	கார்திக
कार्तीकी	கார்தீகீ
काल	கால
कालिनी	காலிநீ
कालिमोहन	காலிமோஹந
काश्य	காஶ்ய
काहीनी	காஹீநீ
कुँर्र्तुलें	குஂர்ர்துலேஂ
कैकाई	கைகாஈ
कैकेयी	கைகேயீ
कैतक	கைதக
कैरवी	கைரவீ
कैषा	கைஷா
गंगवार	கஂகவார
गंगाधरा	கஂகாதரா
गंगाह	கஂகாஹ
गंगेश	கஂகேஶ
गंदिवा	கஂதிவா
गंधरज	கஂதரஜ
गंधा	கஂதா
गग्नेश	கக்நேஶ
गजगामिनी	கஜகாமிநீ
गजबाहू	கஜபாஹூ
गजानंद	கஜாநஂத
गणपत	கணபத
गणावी	கணாவீ
गति	கதி
गनेसा	கநேஸா
गन्नों	கந்நோஂ
गम्या	கம்யா
गरिमान	கரிமாந
गरिष्ट	கரிஷ்ட
गर्विक	கர்விக
गहना	கஹநா
गांगी	காஂகீ
गांधिनी	காஂதிநீ
गांधी	காஂதீ
गान्धरिका	காந்தரிகா
गान्धर्व	காந்தர்வ
गायकाप्रिया	காயகாப்ரியா
गायले	காயலே
गारीन	காரீந
गावी	காவீ
गीतासरी	கீதாஸரீ
गीथीका	கீதீகா
गौरीमनोहरी	கௌரீமநோஹரீ
चंदन	சஂதந
चंदर	சஂதர
चंदा	சஂதா
चंदालिनी	சஂதாலிநீ
चंद्र भान	சஂத்ர பாந
चंद्रक	சஂத்ரக
चंद्रकान्ता	சஂத்ரகாந்தா
चंद्रदेव	சஂத்ரதேவ
चंद्रन्शुं	சஂத்ரந்ஶுஂ
चंद्रबिंदु	சஂத்ரபிஂது
चंद्रमाधाव	சஂத்ரமாதாவ
चंद्रलेक्षा	சஂத்ரலேக்ஷா
चंद्रानन	சஂத்ராநந
चंपक	சஂபக
चंपा	சஂபா
चकोर	சகோர
चक्रदेव	சக்ரதேவ
चक्रधारीनी	சக்ரதாரீநீ
चक्रेश	சக்ரேஶ
चक्शन	சக்ஶந
चनक	சநக
चन्द्रवादना	சந்த்ரவாதநா
चमेली	சமேலீ
चानक्य	சாநக்ய
चानाक्षी	சாநாக்ஷீ
चानास्या	சாநாஸ்யா
चारन	சாரந
चाहना	சாஹநா
चैन	சைந
चैनीका	சைநீகா
छाया	சாயா
छायावती	சாயாவதீ
जगजीवन	ஜகஜீவந
जगतगुरु	ஜகதகுரு
जगतप्रभु	ஜகதப்ரபு
जगदम्बा	ஜகதம்பா
जगनमाता	ஜகநமாதா
जगन्नाथ	ஜகந்நாத
जगाती	ஜகாதீ
जग्रवी	ஜக்ரவீ
जनकनंदिनी	ஜநகநஂதிநீ
जनिता	ஜநிதா
जनीशा	ஜநீஶா
जबिने	ஜபிநே
जलधि	ஜலதி
जलधीजा	ஜலதீஜா
जल्पा	ஜல்பா
ज़ैलेखा	ஜைலேகா
जागती	ஜாகதீ
जागवी	ஜாகவீ
जाननी	ஜாநநீ
जाह्नवी	ஜாஹ்நவீ
जिअना	ஜிஅநா
जैकापिश	ஜைகாபிஶ
जैदेव	ஜைதேவ
जैमिल	ஜைமில
जैलेण	ஜைலேண
जैलेश	ஜைலேஶ
जैहासीनी	ஜைஹாஸீநீ
झांजर	சாஂஜர
झानीशा	சாநீஶா
झीतीएन	சீதீஏந
झीहान	சீஹாந
झेव	சேவ
टागोर	டாகோர
डाली	டாலீ
तंगी	தஂகீ
तंबूरा	தஂபூரா
तनय	தநய
तनाव	தநாவ
तनिश्क	தநிஶ்க
तनिसी	தநிஸீ
तनुं प्रिया	தநுஂ ப்ரியா
तनुश्री	தநுஶ்ரீ
तन्निष्ठा	தந்நிஷ்டா
तन्मयी	தந்மயீ
तन्वीश्री	தந்வீஶ்ரீ
तपीश	தபீஶ
तपेन्द्र	தபேந்த்ர
तप्त	தப்த
तमन	தமந
तमसा	தமஸா
तमाली	தமாலீ
तमिला	தமிலா
तम्मना	தம்மநா
तरंत	தரஂத
तलंक	தலஂக
तलाव	தலாவ
तहान	தஹாந
तहास्वीनी	தஹாஸ்வீநீ
ताजेन्दर	தாஜேந்தர
तानाय्मी	தாநாய்மீ
तानाश्वी	தாநாஶ்வீ
तानीसका	தாநீஸகா
तानीस्क	தாநீஸ்க
तानुंश्सी	தாநுஂஶ்ஸீ
तानेश्वर	தாநேஶ்வர
तान्तव	தாந்தவ
तान्वीतासरी	தாந்வீதாஸரீ
तान्वेशा	தாந்வேஶா
तान्श्राय	தாந்ஶ்ராய
तान्हिता	தாந்ஹிதா
तामस	தாமஸ
ताराधिश	தாராதிஶ
तारानाथ	தாராநாத
तारिणी	தாரிணீ
तारीक	தாரீக
तारीन	தாரீந
दक्शिनयन	தக்ஶிநயந
दक्षायज्ञअविनाशीनी	தக்ஷாயஜ்ஞஅவிநாஶீநீ
दक्षाहता	தக்ஷாஹதா
दक्षित	தக்ஷித
दज्शी	தஜ்ஶீ
दनूज़	தநூஜ
दयानीश्का	தயாநீஶ்கா
दयामणी	தயாமணீ
दयावान्ती	தயாவாந்தீ
दरिद्रा धाव्सीनी	தரித்ரா தாவ்ஸீநீ
दरिद्रीयानाशीनी	தரித்ரீயாநாஶீநீ
दर्पण	தர்பண
दर्श	தர்ஶ
दर्शिका	தர்ஶிகா
दर्शीनीका	தர்ஶீநீகா
दल	தல
दलापथी	தலாபதீ
दशा	தஶா
दशाग्रीवा शीरोहरा	தஶாக்ரீவா ஶீரோஹரா
दशाग्रीवाकुलान्ताका	தஶாக்ரீவாகுலாந்தாகா
दशाबहवे	தஶாபஹவே
दानवेन्द्रविनाशका	தாநவேந்த்ரவிநாஶகா
दानास्वी	தாநாஸ்வீ
दानीश	தாநீஶ
दान्दयुंधापनी	தாந்தயுஂதாபநீ
दायिनी	தாயிநீ
दारुण	தாருண
दिनल	திநல
दीक्षाना	தீக்ஷாநா
देदीप्य	தேதீப்ய
देबर्पीता	தேபர்பீதா
देब्जानी	தேப்ஜாநீ
दैत्याकुलान्ताका	தைத்யாகுலாந்தாகா
दैपायन	தைபாயந
दैवंश	தைவஂஶ
नंगाई	நஂகாஈ
नक्श	நக்ஶ
नगरजन	நகரஜந
नगा मांल्लेस्वारी	நகா மாஂல்லேஸ்வாரீ
नदीप	நதீப
नभोज	நபோஜ
नाक्ति	நாக்தி
नाक्षथ्रा	நாக்ஷத்ரா
नाक्ष्थ्रा	நாக்ஷ்த்ரா
नाग	நாக
नागममां	நாகமமாஂ
नागराजा	நாகராஜா
नागार्जुन	நாகார்ஜுந
नागेन्द्र	நாகேந்த்ர
नागैः	நாகைஃ
नाचिक	நாசிக
नादारंजनी	நாதாரஂஜநீ
नाबनीता	நாபநீதா
नाभस	நாபஸ
नाभिता	நாபிதா
नामांनारायनी	நாமாஂநாராயநீ
नामी	நாமீ
नारंग	நாரஂக
नेमा	நேமா
नैंशी	நைஂஶீ
नैजा	நைஜா
नैनीशा	நைநீஶா
नैरित	நைரித
नैवेद	நைவேத
पंखी	பஂகீ
पंडी	பஂடீ
पंड्या	பஂட்யா
पक्ष	பக்ஷ
पक्षालिका	பக்ஷாலிகா
पदमन	பதமந
पद्मनाभ	பத்மநாப
पद्मनाभा	பத்மநாபா
पद्ममालिनी	பத்மமாலிநீ
पद्मरेखा	பத்மரேகா
पद्मांनाबन	பத்மாஂநாபந
पद्मांनाभा प्रिया	பத்மாஂநாபா ப்ரியா
पद्माकर	பத்மாகர
पद्माक्षी	பத்மாக்ஷீ
पद्माजई	பத்மாஜஈ
पद्मापति	பத்மாபதி
पद्मारूपा	பத்மாரூபா
पन्दालावासन	பந்தாலாவாஸந
पन्यश्री	பந்யஶ்ரீ
पपम्मां	பபம்மாஂ
पमीला	பமீலா
पम्बवासन	பம்பவாஸந
पम्बा	பம்பா
पराजिका	பராஜிகா
पलाक्ष	பலாக்ஷ
पलाशकुसूम	பலாஶகுஸூம
पलाशीनी	பலாஶீநீ
पल्लब	பல்லப
पल्लवित	பல்லவித
पाओला	பாஓலா
पाक	பாக
पागलावन	பாகலாவந
पाटला	பாடலா
पातालवती	பாதாலவதீ
पामेला	பாமேலா
पायल	பாயல
पारस	பாரஸ
पाराज	பாராஜ
पार्थीवी	பார்தீவீ
पालिन	பாலிந
पालीन	பாலீந
पावन	பாவந
पावनी	பாவநீ
पावानी	பாவாநீ
पाही	பாஹீ
फिरकी	பிரகீ
फेनी	பேநீ
फ्रवश	ப்ரவஶ
फ्रान्चीस	ப்ராந்சீஸ
फ्रेया	ப்ரேயா
फ्लावीना	ப்லாவீநா
बंदान	பஂதாந
बंधीनी	பஂதீநீ
बग्याराज	பக்யாராஜ
बनबिहारी	பநபிஹாரீ
बन्दीता	பந்தீதா
बन्नी	பந்நீ
बबला	பபலா
बरखा	பரகா
बर्षा	பர்ஷா
बलदेव	பலதேவ
बलप्रदा	பலப்ரதா
बलरह	பலரஹ
बलवान	பலவாந
बलाचंदर	பலாசஂதர
बलादीत्य	பலாதீத்ய
बविता	பவிதா
बवीश्यसरी	பவீஶ்யஸரீ
बसंती	பஸஂதீ
बहुधा	பஹுதா
बांसुरी	பாஂஸுரீ
बाबु	பாபு
बालक्रिष्ना	பாலக்ரிஷ்நா
बालाजी	பாலாஜீ
बालाशंकर	பாலாஶஂகர
बालु	பாலு
बालेन्द्र	பாலேந்த்ர
बाळ सुब्रमनी	பாள ஸுப்ரமநீ
बीकुन्थ	பீகுந்த
बेकुरी	பேகுரீ
बेनीता	பேநீதா
बेन्शिक	பேந்ஶிக
बेला	பேலா
बैशाळी	பைஶாளீ
बैसाखी	பைஸாகீ
बौमांथी	பௌமாஂதீ
भव्य	பவ்ய
भागवंती	பாகவஂதீ
भागवाथ	பாகவாத
भाद्रिका	பாத்ரிகா
भारती	பாரதீ
मदेश	மதேஶ
मधु बिंदु	மது பிஂது
मधुघोष	மதுகோஷ
मधुचंदा	மதுசஂதா
मधुप्रिता	மதுப்ரிதா
मधुप्रिया	மதுப்ரியா
मधुमति	மதுமதி
मधुमालती	மதுமாலதீ
मधुरानी	மதுராநீ
मधुवंती	மதுவஂதீ
मधुवंथी	மதுவஂதீ
मधुशा	மதுஶா
मधुशाना	மதுஶாநா
मधेश	மதேஶ
महंथी	மஹஂதீ
महाक्रम	மஹாக்ரம
महादुर्गा	மஹாதுர்கா
महादेवादीपुजीता	மஹாதேவாதீபுஜீதா
महाध्युता	மஹாத்யுதா
महाबाहु	மஹாபாஹு
महालक्ष्मी	மஹாலக்ஷ்மீ
मांदव	மாஂதவ
मांधुवेमान	மாஂதுவேமாந
मागथी	மாகதீ
माघा	மாகா
माधव दास	மாதவ தாஸ
माधवन	மாதவந
माधविलता	மாதவிலதா
माधवी	மாதவீ
मानीक्या	மாநீக்யா
मान्दाविक	மாந்தாவிக
मायन	மாயந
माया	மாயா
मायीन	மாயீந
मारीश	மாரீஶ
मारीशा	மாரீஶா
मार्गीन	மார்கீந
माला	மாலா
मालीन	மாலீந
माही	மாஹீ
यग्ना	யக்நா
यज्ञेश्वर	யஜ்ஞேஶ்வர
यज्नारूप	யஜ்நாரூப
यथार्थ	யதார்த
यशवंत	யஶவஂத
यशस्व	யஶஸ்வ
यशित	யஶித
यशील	யஶீல
यशुस	யஶுஸ
यशोदागर्बा सम्भूता	யஶோதாகர்பா ஸம்பூதா
यशोमती	யஶோமதீ
यश्मिता	யஶ்மிதா
यश्वीन	யஶ்வீந
यस्मीनी	யஸ்மீநீ
यह्स्मिता	யஹ்ஸ்மிதா
याचन	யாசந
याज	யாஜ
याजक	யாஜக
यातीएश	யாதீஏஶ
यादावी	யாதாவீ
याधना	யாதநா
यामि	யாமி
यामिनी	யாமிநீ
यामुरा	யாமுரா
याशोगुरी	யாஶோகுரீ
यास्तीका	யாஸ்தீகா
रगब	ரகப
रगवेन्द्र	ரகவேந்த்ர
रगुनातन	ரகுநாதந
रघुराम	ரகுராம
रजिता	ரஜிதா
रजीनी	ரஜீநீ
रबानी	ரபாநீ
रहस	ரஹஸ
रहाम	ரஹாம
रहीनी	ரஹீநீ
राई	ராஈ
रागावीनोदीनी	ராகாவீநோதீநீ
रागेश	ராகேஶ
राघवेन्द्र	ராகவேந்த்ர
राज	ராஜ
राज  किरण	ராஜ  கிரண
राजकुमार	ராஜகுமார
राजमणी	ராஜமணீ
राजलक्ष्मी	ராஜலக்ஷ்மீ
राजशेखर	ராஜஶேகர
राजसेकर	ராஜஸேகர
राजस्व	ராஜஸ்வ
राजार्शी	ராஜார்ஶீ
राजेशनी	ராஜேஶநீ
राज्रीता	ராஜ்ரீதா
राद्न्य	ராத்ந்ய
राधेश	ராதேஶ
रावी	ராவீ
रास्या	ராஸ்யா
राहीन्य	ராஹீந்ய
राहुल	ராஹுல
लक्षा	லக்ஷா
लक्ष्मणा	லக்ஷ்மணா
लक्ष्मीकानतम	லக்ஷ்மீகாநதம
लक्ष्मीगोपाल	லக்ஷ்மீகோபால
लक्ष्मीनारायण	லக்ஷ்மீநாராயண
लक्ष्मीश	லக்ஷ்மீஶ
लक्ष्य	லக்ஷ்ய
लजीथा	லஜீதா
लताकारा	லதாகாரா
लतेश	லதேஶ
लम्बोदरा	லம்போதரா
ललित	லலித
ललितचंद्रा	லலிதசஂத்ரா
ललितामोहना	லலிதாமோஹநா
ललीतादीत्य	லலீதாதீத்ய
लवना	லவநா
लवाम	லவாம
लशिका	லஶிகா
लहिता	லஹிதா
लहेर	லஹேர
लाईना	லாஈநா
लाकेश	லாகேஶ
लाक्सेथा	லாக்ஸேதா
लाजवती	லாஜவதீ
लाडु	லாடு
लातेश	லாதேஶ
लारा	லாரா
लारान्य	லாராந்ய
लारीना	லாரீநா
लालीतेश	லாலீதேஶ
लावा	லாவா
लावालिका	லாவாலிகா
लावेन	லாவேந
लासकी	லாஸகீ
लास्यावी	லாஸ்யாவீ
लौहित्य	லௌஹித்ய
वक्ति	வக்தி
वक्रतुंड	வக்ரதுஂட
वजसनी	வஜஸநீ
वज्रबाहू	வஜ்ரபாஹூ
वज्रमानी	வஜ்ரமாநீ
वज्राधर	வஜ்ராதர
वधी	வதீ
वनदुर्गा	வநதுர்கா
वनमाला	வநமாலா
वनाथी	வநாதீ
वन्दिता	வந்திதா
वाक्षु	வாக்ஷு
वाग्देवी	வாக்தேவீ
वाटिका	வாடிகா
वानादुर्गा	வாநாதுர்கா
वान्या	வாந்யா
वामांनीए	வாமாஂநீஏ
वालकय	வாலகய
वाली	வாலீ
वालीप्रमाताना	வாலீப்ரமாதாநா
वासवादात्ता	வாஸவாதாத்தா
वासु	வாஸு
वाहिनी	வாஹிநீ
वेदांत	வேதாஂத
वैजनाथ	வைஜநாத
वैजयी	வைஜயீ
वैजीनाथ	வைஜீநாத
वैवत	வைவத
वैशाली	வைஶாலீ
वैश्नोव	வைஶ்நோவ
वैषित	வைஷித
वैषेका	வைஷேகா
संदेश	ஸஂதேஶ
सच	ஸச
सचिता	ஸசிதா
सचिव	ஸசிவ
सचिश	ஸசிஶ
सचीना	ஸசீநா
सचेत	ஸசேத
सचेतन	ஸசேதந
सच्चिदानंदा	ஸச்சிதாநஂதா
सदानंदा	ஸதாநஂதா
सबरीश्री	ஸபரீஶ்ரீ
सहारिका	ஸஹாரிகா
सह्रुदी	ஸஹ்ருதீ
साई	ஸாஈ
साई कुमारी	ஸாஈ குமாரீ
साई वाणी	ஸாஈ வாணீ
सागरिक	ஸாகரிக
सागरिका	ஸாகரிகா
साद्रीशी	ஸாத்ரீஶீ
साधक	ஸாதக
साधका	ஸாதகா
साध्वी	ஸாத்வீ
सानवी तारीता	ஸாநவீ தாரீதா
सामान	ஸாமாந
सामोद	ஸாமோத
साय बिंधु	ஸாய பிஂது
सारंगी	ஸாரஂகீ
सारस	ஸாரஸ
सारांश	ஸாராஂஶ
सार्थ	ஸார்த
सार्या	ஸார்யா
सावन	ஸாவந
सावीनी	ஸாவீநீ
साहना	ஸாஹநா
हंशल	ஹஂஶல
हंसराज	ஹஂஸராஜ
हंसानंदी	ஹஂஸாநஂதீ
हंसीनी	ஹஂஸீநீ
हंस्ध्वानी	ஹஂஸ்த்வாநீ
हजेश	ஹஜேஶ
हनार्वीन	ஹநார்வீந
हनीश	ஹநீஶ
हनुमान	ஹநுமாந
हन्शीका	ஹந்ஶீகா
हबीता	ஹபீதா
हमृथा	ஹம்ரிதா
हरण	ஹரண
हरनाध	ஹரநாத
हरषी	ஹரஷீ
हरिज	ஹரிஜ
हरिजाथा	ஹரிஜாதா
हरिदास	ஹரிதாஸ
हरिद्र	ஹரித்ர
हरिनाक्षी	ஹரிநாக்ஷீ
हरिप्रसाद	ஹரிப்ரஸாத
हरिशरण	ஹரிஶரண
हरिहर	ஹரிஹர
हरिहर पुत्र	ஹரிஹர புத்ர
हरी किशन	ஹரீ கிஶந
हरी नारायण	ஹரீ நாராயண
हरीथा	ஹரீதா
हरीनीका	ஹரீநீகா
हरीन्द्र	ஹரீந்த்ர
हरीमांर्कातामांर्कता	ஹரீமாஂர்காதாமாஂர்கதா
हरीराम	ஹரீராம
हरीश्व	ஹரீஶ்வ
हरीसाई	ஹரீஸாஈ
हरेकृष्ण	ஹரேக்ரிஷ்ண
हरेश्वर	ஹரேஶ்வர
हर्लेय	ஹர்லேய
हलेस्या	ஹலேஸ்யா
हारनी	ஹாரநீ
हार्ड	ஹார்ட
हासीता	ஹாஸீதா
हीमांवाथी	ஹீமாஂவாதீ
हील्लेय	ஹீல்லேய
हेशीका	ஹேஶீகா
#
#
# Territory names from CLDR
असेंशन द्वीप	அஸேஂஶந த்வீப
एंडोरा	ஏஂடோரா
संयुक्त अरब अमीरात	ஸஂயுக்த அரப அமீராத
अफ़गानिस्तान	அபகாநிஸ்தாந
एंटिगुआ और बरबुडा	ஏஂடிகுஆ ஔர பரபுடா
एंग्विला	ஏஂக்விலா
अल्बानिया	அல்பாநியா
आर्मेनिया	ஆர்மேநியா
अंगोला	அஂகோலா
अंटार्कटिका	அஂடார்கடிகா
अर्जेंटीना	அர்ஜேஂடீநா
अमेरिकी समोआ	அமேரிகீ ஸமோஆ
ऑस्ट्रिया	ஒஸ்ட்ரியா
ऑस्ट्रेलिया	ஒஸ்ட்ரேலியா
अरूबा	அரூபா
एलैंड द्वीपसमूह	ஏலைஂட த்வீபஸமூஹ
अज़रबैजान	அஜரபைஜாந
बोस्निया और हर्ज़ेगोविना	போஸ்நியா ஔர ஹர்ஜேகோவிநா
बारबाडोस	பாரபாடோஸ
बांग्लादेश	பாஂக்லாதேஶ
बेल्जियम	பேல்ஜியம
बुर्किना फ़ासो	புர்கிநா பாஸோ
बुल्गारिया	புல்காரியா
बहरीन	பஹரீந
बुरुंडी	புருஂடீ
बेनिन	பேநிந
सेंट बार्थेलेमी	ஸேஂட பார்தேலேமீ
बरमूडा	பரமூடா
ब्रूनेई	ப்ரூநேஈ
बोलीविया	போலீவியா
कैरिबियन नीदरलैंड	கைரிபியந நீதரலைஂட
ब्राज़ील	ப்ராஜீல
बहामास	பஹாமாஸ
भूटान	பூடாந
बोवेत द्वीप	போவேத த்வீப
बोत्स्वाना	போத்ஸ்வாநா
बेलारूस	பேலாரூஸ
बेलीज़	பேலீஜ
कनाडा	கநாடா
कोकोस (कीलिंग) द्वीपसमूह	கோகோஸ (கீலிஂக) த்வீபஸமூஹ
कांगो - किंशासा	காஂகோ - கிஂஶாஸா
कांगो (डीआरसी)	காஂகோ (டீஆரஸீ)
मध्य अफ़्रीकी गणराज्य	மத்ய அப்ரீகீ கணராஜ்ய
कांगो – ब्राज़ाविल	காஂகோ – ப்ராஜாவில
कांगो (गणराज्य)	காஂகோ (கணராஜ்ய)
स्विट्ज़रलैंड	ஸ்விட்ஜரலைஂட
कोट डी आइवर	கோட டீ ஆஇவர
आइवरी कोस्ट	ஆஇவரீ கோஸ்ட
कुक द्वीपसमूह	குக த்வீபஸமூஹ
चिली	சிலீ
कैमरून	கைமரூந
चीन	சீந
कोलंबिया	கோலஂபியா
क्लिपर्टन द्वीप	க்லிபர்டந த்வீப
कोस्टारिका	கோஸ்டாரிகா
क्यूबा	க்யூபா
केप वर्ड	கேப வர்ட
क्यूरासाओ	க்யூராஸாஓ
क्रिसमस द्वीप	க்ரிஸமஸ த்வீப
साइप्रस	ஸாஇப்ரஸ
चेक गणराज्य	சேக கணராஜ்ய
जर्मनी	ஜர்மநீ
डिएगो गार्सिया	டிஏகோ கார்ஸியா
जिबूती	ஜிபூதீ
डेनमार्क	டேநமார்க
डोमिनिका	டோமிநிகா
डोमिनिकन गणराज्य	டோமிநிகந கணராஜ்ய
अल्जीरिया	அல்ஜீரியா
सेउटा और मेलिला	ஸேஉடா ஔர மேலிலா
इक्वाडोर	இக்வாடோர
एस्टोनिया	ஏஸ்டோநியா
मिस्र	மிஸ்ர
पश्चिमी सहारा	பஶ்சிமீ ஸஹாரா
इरिट्रिया	இரிட்ரியா
स्पेन	ஸ்பேந
इथियोपिया	இதியோபியா
यूरोपीय संघ	யூரோபீய ஸஂக
फ़िनलैंड	பிநலைஂட
फ़िजी	பிஜீ
फ़ॉकलैंड द्वीपसमूह	பாகலைஂட த்வீபஸமூஹ
फ़ॉकलैंड द्वीपसमूह (इज़्लास माल्विनास)	பாகலைஂட த்வீபஸமூஹ (இஜ்லாஸ மால்விநாஸ)
माइक्रोनेशिया	மாஇக்ரோநேஶியா
फ़ेरो द्वीपसमूह	பேரோ த்வீபஸமூஹ
फ़्रांस	ப்ராஂஸ
गैबॉन	கைபாந
यूनाइटेड किंगडम	யூநாஇடேட கிஂகடம
ग्रेनाडा	க்ரேநாடா
जॉर्जिया	ஜார்ஜியா
फ़्रेंच गयाना	ப்ரேஂச கயாநா
गर्नसी	கர்நஸீ
घाना	காநா
जिब्राल्टर	ஜிப்ரால்டர
ग्रीनलैंड	க்ரீநலைஂட
गाम्बिया	காம்பியா
गिनी	கிநீ
ग्वाडेलूप	க்வாடேலூப
इक्वेटोरियल गिनी	இக்வேடோரியல கிநீ
यूनान	யூநாந
दक्षिण जॉर्जिया और दक्षिण सैंडविच द्वीपसमूह	தக்ஷிண ஜார்ஜியா ஔர தக்ஷிண ஸைஂடவிச த்வீபஸமூஹ
ग्वाटेमाला	க்வாடேமாலா
गुआम	குஆம
गिनी-बिसाउ	கிநீ-பிஸாஉ
गयाना	கயாநா
हाँग काँग (चीन विशेष प्रशासनिक क्षेत्र)	ஹாஂக காஂக (சீந விஶேஷ ப்ரஶாஸநிக க்ஷேத்ர)
हाँग काँग	ஹாஂக காஂக
हर्ड द्वीप और मैकडोनॉल्ड द्वीपसमूह	ஹர்ட த்வீப ஔர மைகடோநால்ட த்வீபஸமூஹ
होंडूरास	ஹோஂடூராஸ
क्रोएशिया	க்ரோஏஶியா
हैती	ஹைதீ
हंगरी	ஹஂகரீ
कैनेरी द्वीपसमूह	கைநேரீ த்வீபஸமூஹ
इंडोनेशिया	இஂடோநேஶியா
आयरलैंड	ஆயரலைஂட
इसराइल	இஸராஇல
आइल ऑफ़ मैन	ஆஇல ஒப மைந
भारत	பாரத
ब्रिटिश हिंद महासागरीय क्षेत्र	ப்ரிடிஶ ஹிஂத மஹாஸாகரீய க்ஷேத்ர
इराक	இராக
ईरान	ஈராந
आइसलैंड	ஆஇஸலைஂட
इटली	இடலீ
जर्सी	ஜர்ஸீ
जमैका	ஜமைகா
जॉर्डन	ஜார்டந
जापान	ஜாபாந
केन्या	கேந்யா
किर्गिज़स्तान	கிர்கிஜஸ்தாந
कंबोडिया	கஂபோடியா
किरिबाती	கிரிபாதீ
कोमोरोस	கோமோரோஸ
सेंट किट्स और नेविस	ஸேஂட கிட்ஸ ஔர நேவிஸ
उत्तर कोरिया	உத்தர கோரியா
दक्षिण कोरिया	தக்ஷிண கோரியா
कुवैत	குவைத
केमैन द्वीपसमूह	கேமைந த்வீபஸமூஹ
कज़ाखस्तान	கஜாகஸ்தாந
लाओस	லாஓஸ
लेबनान	லேபநாந
सेंट लूसिया	ஸேஂட லூஸியா
लिचेंस्टीन	லிசேஂஸ்டீந
श्रीलंका	ஶ்ரீலஂகா
लाइबेरिया	லாஇபேரியா
लेसोथो	லேஸோதோ
लिथुआनिया	லிதுஆநியா
लग्ज़मबर्ग	லக்ஜமபர்க
लातविया	லாதவியா
लीबिया	லீபியா
मोरक्को	மோரக்கோ
मोनाको	மோநாகோ
मॉल्डोवा	மால்டோவா
मोंटेनेग्रो	மோஂடேநேக்ரோ
सेंट मार्टिन	ஸேஂட மார்டிந
मेडागास्कर	மேடாகாஸ்கர
मार्शल द्वीपसमूह	மார்ஶல த்வீபஸமூஹ
मैसिडोनिया	மைஸிடோநியா
मैसिडोनिया (FYROM)	மைஸிடோநியா (FYROM)
माली	மாலீ
म्यांमार (बर्मा)	ம்யாஂமார (பர்மா)
मंगोलिया	மஂகோலியா
मकाऊ (विशेष प्रशासनिक क्षेत्र चीन)	மகாஊ (விஶேஷ ப்ரஶாஸநிக க்ஷேத்ர சீந)
मकाऊ	மகாஊ
उत्तरी मारियाना द्वीपसमूह	உத்தரீ மாரியாநா த்வீபஸமூஹ
मार्टीनिक	மார்டீநிக
मॉरिटानिया	மாரிடாநியா
मोंटसेरात	மோஂடஸேராத
माल्टा	மால்டா
मॉरिशस	மாரிஶஸ
मालदीव	மாலதீவ
मलावी	மலாவீ
मैक्सिको	மைக்ஸிகோ
मलेशिया	மலேஶியா
मोज़ांबिक	மோஜாஂபிக
नामीबिया	நாமீபியா
न्यू कैलेडोनिया	ந்யூ கைலேடோநியா
नाइजर	நாஇஜர
नॉरफ़ॉक द्वीप	நாரபாக த்வீப
नाइजीरिया	நாஇஜீரியா
निकारागुआ	நிகாராகுஆ
नीदरलैंड	நீதரலைஂட
नॉर्वे	நார்வே
नेपाल	நேபால
नाउरु	நாஉரு
नीयू	நீயூ
न्यूज़ीलैंड	ந்யூஜீலைஂட
ओमान	ஓமாந
पनामा	பநாமா
पेरू	பேரூ
फ़्रेंच पोलिनेशिया	ப்ரேஂச போலிநேஶியா
पापुआ न्यू गिनी	பாபுஆ ந்யூ கிநீ
फ़िलिपींस	பிலிபீஂஸ
पाकिस्तान	பாகிஸ்தாந
पोलैंड	போலைஂட
सेंट पिएरे और मिक्वेलान	ஸேஂட பிஏரே ஔர மிக்வேலாந
पिटकैर्न द्वीपसमूह	பிடகைர்ந த்வீபஸமூஹ
पोर्टो रिको	போர்டோ ரிகோ
फ़िलिस्तीनी क्षेत्र	பிலிஸ்தீநீ க்ஷேத்ர
फ़िलिस्तीन	பிலிஸ்தீந
पुर्तगाल	புர்தகால
पलाऊ	பலாஊ
पेराग्वे	பேராக்வே
क़तर	கதர
आउटलाइंग ओशिनिया	ஆஉடலாஇஂக ஓஶிநியா
रियूनियन	ரியூநியந
रोमानिया	ரோமாநியா
सर्बिया	ஸர்பியா
रूस	ரூஸ
रवांडा	ரவாஂடா
सऊदी अरब	ஸஊதீ அரப
सोलोमन द्वीपसमूह	ஸோலோமந த்வீபஸமூஹ
सेशेल्स	ஸேஶேல்ஸ
सूडान	ஸூடாந
स्वीडन	ஸ்வீடந
सिंगापुर	ஸிஂகாபுர
सेंट हेलेना	ஸேஂட ஹேலேநா
स्लोवेनिया	ஸ்லோவேநியா
स्वालबार्ड और जान मायेन	ஸ்வாலபார்ட ஔர ஜாந மாயேந
स्लोवाकिया	ஸ்லோவாகியா
सिएरा लियोन	ஸிஏரா லியோந
सैन मेरीनो	ஸைந மேரீநோ
सेनेगल	ஸேநேகல
सोमालिया	ஸோமாலியா
सूरीनाम	ஸூரீநாம
दक्षिण सूडान	தக்ஷிண ஸூடாந
साओ टोम और प्रिंसिपे	ஸாஓ டோம ஔர ப்ரிஂஸிபே
अल सल्वाडोर	அல ஸல்வாடோர
सिंट मार्टिन	ஸிஂட மார்டிந
सीरिया	ஸீரியா
स्वाज़ीलैंड	ஸ்வாஜீலைஂட
त्रिस्टान डा कुना	த்ரிஸ்டாந டா குநா
तुर्क और कैकोज़ द्वीपसमूह	துர்க ஔர கைகோஜ த்வீபஸமூஹ
चाड	சாட
फ़्रांसीसी दक्षिणी क्षेत्र	ப்ராஂஸீஸீ தக்ஷிணீ க்ஷேத்ர
टोगो	டோகோ
थाईलैंड	தாஈலைஂட
ताजिकिस्तान	தாஜிகிஸ்தாந
तोकेलाउ	தோகேலாஉ
तिमोर-लेस्त	திமோர-லேஸ்த
पूर्वी तिमोर	பூர்வீ திமோர
तुर्कमेनिस्तान	துர்கமேநிஸ்தாந
ट्यूनीशिया	ட்யூநீஶியா
टोंगा	டோஂகா
तुर्की	துர்கீ
त्रिनिदाद और टोबैगो	த்ரிநிதாத ஔர டோபைகோ
तुवालू	துவாலூ
ताइवान	தாஇவாந
तंज़ानिया	தஂஜாநியா
यूक्रेन	யூக்ரேந
युगांडा	யுகாஂடா
संयुक्त राज्य	ஸஂயுக்த ராஜ்ய
अमेरिका	அமேரிகா
उरूग्वे	உரூக்வே
उज़्बेकिस्तान	உஜ்பேகிஸ்தாந
वेटिकन सिटी	வேடிகந ஸிடீ
सेंट विंसेंट और ग्रेनाडाइंस	ஸேஂட விஂஸேஂட ஔர க்ரேநாடாஇஂஸ
वेनेज़ुएला	வேநேஜுஏலா
ब्रिटिश वर्जिन द्वीपसमूह	ப்ரிடிஶ வர்ஜிந த்வீபஸமூஹ
वियतनाम	வியதநாம
वनुआतू	வநுஆதூ
वालिस और फ़्यूचूना	வாலிஸ ஔர ப்யூசூநா
समोआ	ஸமோஆ
कोसोवो	கோஸோவோ
यमन	யமந
मायोते	மாயோதே
दक्षिण अफ़्रीका	தக்ஷிண அப்ரீகா
ज़ाम्बिया	ஜாம்பியா
ज़िम्बाब्वे	ஜிம்பாப்வே
अज्ञात क्षेत्र	அஜ்ஞாத க்ஷேத்ர
