# Baby names
અંશ	ਅਂਸ਼
અકન્ગ્ષા	ਅਕਨ੍ਗ੍ਸ਼ਾ
અકશીની	ਅਕਸ਼ੀਨੀ
અકસરા	ਅਕਸਰਾ
અકાર્યસુતા	ਅਕਾਰ੍ਯਸੁਤਾ
અકાલકા	ਅਕਾਲਕਾ
અકિતા	ਅਕਿਤਾ
અક્ષધા	ਅਕ੍ਸ਼ਧਾ
અક્ષ્યા	ਅਕ੍ਸ਼੍ਯਾ
અક્સા	ਅਕ੍ਸਾ
અગ્નિશિખા	ਅਗ੍ਨਿਸ਼ਿਖਾ
અગ્રીમા	ਅਗ੍ਰੀਮਾ
અચલેંદ્ર	ਅਚਲੇਂਦ੍ਰ
અજન્તા	ਅਜਨ੍ਤਾ
અજમુખી	ਅਜਮੁਖੀ
અજિયા	ਅਜਿਯਾ
અજીતા	ਅਜੀਤਾ
અડ્યાદવૈતા	ਅਡ੍ਯਾਦਵੈਤਾ
અદવૈકા	ਅਦਵੈਕਾ
અદિતરાજ	ਅਦਿਤਰਾਜ
અદિત્યેશ	ਅਦਿਤ੍ਯੇਸ਼
અદીતીયા	ਅਦੀਤੀਯਾ
અદીરા	ਅਦੀਰਾ
અદેન્ય	ਅਦੇਨ੍ਯ
અદ્રિતા	ਅਦ੍ਰਿਤਾ
અદ્રિતી	ਅਦ੍ਰਿਤੀ
અદ્વય	ਅਦ੍ਵਯ
અદ્વિકા	ਅਦ੍ਵਿਕਾ
અદ્વેત	ਅਦ੍ਵੇਤ
અદ્વૈયા	ਅਦ੍ਵੈਯਾ
અધીર	ਅਧੀਰ
અધીરતા	ਅਧੀਰਤਾ
અધ્યાત્મ	ਅਧ੍ਯਾਤ੍ਮ
અબિનય	ਅਬਿਨਯ
અબિભવા	ਅਬਿਭਵਾ
અબીનાવ	ਅਬੀਨਾਵ
અબીશા	ਅਬੀਸ਼ਾ
અબીસેશન	ਅਬੀਸੇਸ਼ਨ
અબ્બીર	ਅਬ੍ਬੀਰ
અભિજાત	ਅਭਿਜਾਤ
અભિજ્ઞાન	ਅਭਿਜ੍ਞਾਨ
અભિનું	ਅਭਿਨੁਂ
અભિપ્રિથિ	ਅਭਿਪ੍ਰਿਥਿ
અભિમોદા	ਅਭਿਮੋਦਾ
અભિરુચિ	ਅਭਿਰੁਚਿ
અભિવાદન	ਅਭਿਵਾਦਨ
અભિસુમત	ਅਭਿਸੁਮਤ
અભિસોકા	ਅਭਿਸੋਕਾ
અભીકાંક્ષા	ਅਭੀਕਾਂਕ੍ਸ਼ਾ
અભીચંદ્ર	ਅਭੀਚੰਦ੍ਰ
અભીજુન	ਅਭੀਜੁਨ
અભીધર્મ	ਅਭੀਧਰ੍ਮ
અભીલેશ	ਅਭੀਲੇਸ਼
અભુ	ਅਭੁ
અભ્થા	ਅਭ੍ਥਾ
અભ્રકાસિન	ਅਭ੍ਰਕਾਸਿਨ
અરધ્યાય	ਅਰਧ੍ਯਾਯ
અલંકારાપ્રિયા	ਅਲੰਕਾਰਾਪ੍ਰਿਯਾ
અલંક્રિતા	ਅਲੰਕ੍ਰਿਤਾ
અહીના	ਅਹੀਨਾ
આંદાલ	ਆਂਦਾਲ
આંશી	ਆਂਸ਼ੀ
આએઇન્દ્રિ	ਆਏਇਨ੍ਦ੍ਰਿ
આકર્ષ	ਆਕਰ੍ਸ਼
આકાંક્ષ	ਆਕਾਂਕ੍ਸ਼
આકામ્પન	ਆਕਾਮ੍ਪਨ
આકાશ	ਆਕਾਸ਼
આકાશી	ਆਕਾਸ਼ੀ
આકેશ	ਆਕੇਸ਼
આત્મજ	ਆਤ੍ਮਜ
આત્રયી	ਆਤ੍ਰਯੀ
આદાવન	ਆਦਾਵਨ
આદિકવિ	ਆਦਿਕਵਿ
આદિકેશ	ਆਦਿਕੇਸ਼
આદિતિય	ਆਦਿਤਿਯ
આદિત્વ	ਆਦਿਤ੍ਵ
આદિદેવ	ਆਦਿਦੇਵ
આદિશ	ਆਦਿਸ਼
આદિશંકર	ਆਦਿਸ਼ੰਕਰ
આદિસેશ	ਆਦਿਸੇਸ਼
આદીત્રી	ਆਦੀਤ੍ਰੀ
આદીલ	ਆਦੀਲ
આદ્યા	ਆਦ੍ਯਾ
આનંદતા	ਆਨੰਦਤਾ
આનાધીતા	ਆਨਾਧੀਤਾ
આનુષ	ਆਨੁਸ਼
આમાંની	ਆਮਾਂਨੀ
આયાતી	ਆਯਾਤੀ
આયુધ	ਆਯੁਧ
આરવી	ਆਰਵੀ
આરા	ਆਰਾ
આરાડ્યા	ਆਰਾਡ੍ਯਾ
આરાધક	ਆਰਾਧਕ
આરાધના	ਆਰਾਧਨਾ
આરુન્ય	ਆਰੁਨ੍ਯ
આરુપા	ਆਰੁਪਾ
આરોચન	ਆਰੋਚਨ
આર્થ	ਆਰ੍ਥ
આર્ય્થ્ય	ਆਰ੍ਯ੍ਥ੍ਯ
આલય	ਆਲਯ
આલિશા	ਆਲਿਸ਼ਾ
આલેઃયા	ਆਲੇਯਾ
આલ્યા	ਆਲ੍ਯਾ
આવાની	ਆਵਾਨੀ
આવ્યા	ਆਵ੍ਯਾ
આશાલી	ਆਸ਼ਾਲੀ
આશીર્વાદ	ਆਸ਼ੀਰ੍ਵਾਦ
આસ્યા	ਆਸ੍ਯਾ
આસ્વી	ਆਸ੍ਵੀ
આહ્નીક	ਆਹ੍ਨੀਕ
ઇંદિરા	ਇਂਦਿਰਾ
ઇંદિવર	ਇਂਦਿਵਰ
ઇંદુલેક્ષ	ਇਂਦੁਲੇਕ੍ਸ਼
ઇંદુશેખર	ਇਂਦੁਸ਼ੇਖਰ
ઇતિ	ਇਤਿ
ઇતિશ્રી	ਇਤਿਸ਼੍ਰੀ
ઇદિત્રી	ਇਦਿਤ੍ਰੀ
ઇનકી	ਇਨਕੀ
ઇન્કિત	ਇਨ੍ਕਿਤ
ઇન્ગનામ	ਇਨ੍ਗਨਾਮ
ઇન્દ્રતેજ	ਇਨ੍ਦ੍ਰਤੇਜ
ઇન્દ્રન	ਇਨ੍ਦ੍ਰਨ
ઇન્દ્રેશ	ਇਨ੍ਦ੍ਰੇਸ਼
ઇભાન	ਇਭਾਨ
ઇભ્યા	ਇਭ੍ਯਾ
ઇયેનગર	ਇਯੇਨਗਰ
ઇલવરસન	ਇਲਵਰਸਨ
ઇલિસા	ਇਲਿਸਾ
ઇવાન	ਇਵਾਨ
ઇશા	ਇਸ਼ਾ
ઇશાયુ	ਇਸ਼ਾਯੁ
ઇસાર	ਇਸਾਰ
ઇસીરી	ਇਸੀਰੀ
ઈઝ્રીને	ਈਝ੍ਰੀਨੇ
ઈનિઅવેલન	ਈਨਿਅਵੇਲਨ
ઈનિયવન	ਈਨਿਯਵਨ
ઈન્દુસ	ਈਨ੍ਦੁਸ
ઈરીશ	ਈਰੀਸ਼
ઈલ્વિકા	ਈਲ੍ਵਿਕਾ
ઈશાંત	ਈਸ਼ਾਂਤ
ઈશિત	ਈਸ਼ਿਤ
ઈશ્મીતા	ਈਸ਼੍ਮੀਤਾ
ઈશ્વ	ਈਸ਼੍ਵ
ઈસાઈ	ਈਸਾਈ
ઉજય	ਉਜਯ
ઉજાગર	ਉਜਾਗਰ
ઉજાસ	ਉਜਾਸ
ઉજીત્ર	ਉਜੀਤ੍ਰ
ઉજેન્દ્ર	ਉਜੇਨ੍ਦ੍ਰ
ઉજ્જાનિની	ਉਜ੍ਜਾਨਿਨੀ
ઉજ્જ્વાલા	ਉਜ੍ਜ੍ਵਾਲਾ
ઉત્કર્શ્રાજ	ਉਤ੍ਕਰ੍ਸ਼੍ਰਾਜ
ઉત્કલ	ਉਤ੍ਕਲ
ઉત્કલીતા	ਉਤ੍ਕਲੀਤਾ
ઉત્કશાના	ਉਤ੍ਕਸ਼ਾਨਾ
ઉત્પત્તિ	ਉਤ੍ਪਤ੍ਤਿ
ઉત્પલ	ਉਤ੍ਪਲ
ઉત્વિક	ਉਤ੍ਵਿਕ
ઉત્સા	ਉਤ੍ਸਾ
ઉથીશા	ਉਥੀਸ਼ਾ
ઉદંત	ਉਦੰਤ
ઉદયાચલ	ਉਦਯਾਚਲ
ઉદરથી	ਉਦਰਥੀ
ઉદાર્શ	ਉਦਾਰ੍ਸ਼
ઉદેય	ਉਦੇਯ
ઉદ્વંશ	ਉਦ੍ਵੰਸ਼
ઉધાયારની	ਉਧਾਯਾਰਨੀ
ઉપજય	ਉਪਜਯ
ઉપદા	ਉਪਦਾ
ઉપનાયિક	ਉਪਨਾਯਿਕ
ઉપાગુપ્તા	ਉਪਾਗੁਪ੍ਤਾ
ઉપેન્દ્રન	ਉਪੇਨ੍ਦ੍ਰਨ
ઉભય	ਉਭਯ
ઉમાંપુત્ર	ਉਮਾਂਪੁਤ੍ਰ
ઉમાપત્ય	ਉਮਾਪਤ੍ਯ
ઉમિકા	ਉਮਿਕਾ
ઉમેશ	ਉਮੇਸ਼
ઉરિશિલ્લા	ਉਰਿਸ਼ਿਲ੍ਲਾ
ઉર્નીક	ਉਰ੍ਨੀਕ
ઉર્મિલ	ਉਰ੍ਮਿਲ
ઉર્મિલા	ਉਰ੍ਮਿਲਾ
ઉર્મી	ਉਰ੍ਮੀ
ઉર્વીશા	ਉਰ੍ਵੀਸ਼ਾ
ઉલ્લાસીથા	ਉਲ੍ਲਾਸੀਥਾ
ઉસહાસ	ਉਸਹਾਸ
ઉસ્લુંનન	ਉਸ੍ਲੁਂਨਨ
ઊર્જિત	ਊਰ੍ਜਿਤ
એઇલા	ਏਇਲਾ
એકદંતન	ਏਕਦੰਤਨ
એકન્ષા	ਏਕਨ੍ਸ਼ਾ
એકાંશ	ਏਕਾਂਸ਼
એકાચક્ર	ਏਕਾਚਕ੍ਰ
એકાવિરા	ਏਕਾਵਿਰਾ
એકીશ	ਏਕੀਸ਼
એકેસ્વારા	ਏਕੇਸ੍ਵਾਰਾ
એક્શીકા	ਏਕ੍ਸ਼ੀਕਾ
એદોમ	ਏਦੋਮ
એપ્શીતા	ਏਪ੍ਸ਼ੀਤਾ
એલાવારાસન	ਏਲਾਵਾਰਾਸਨ
એલેના	ਏਲੇਨਾ
એવાની	ਏਵਾਨੀ
એવોન	ਏਵੋਨ
એશંકા	ਏਸ਼ੰਕਾ
એશાન્ય	ਏਸ਼ਾਨ੍ਯ
ઐસીરી	ਐਸੀਰੀ
ઓજ્જસ્વીન	ਓਜ੍ਜਸ੍ਵੀਨ
ઓદથી	ਓਦਥੀ
ઓનિશ	ਓਨਿਸ਼
ઓનીર	ਓਨੀਰ
ઓન્નેશા	ਓਨ੍ਨੇਸ਼ਾ
ઓબલેશ	ਓਬਲੇਸ਼
ઓમપતિ	ਓਮਪਤਿ
ઓમવતી	ਓਮਵਤੀ
ઓમિષા	ਓਮਿਸ਼ਾ
ઓવીએ	ਓਵੀਏ
ઓહા	ਓਹਾ
કંકના	ਕੰਕਨਾ
કંજમ	ਕੰਜਮ
કંઠ	ਕੰਠ
કંવર	ਕੰਵਰ
કતીરેશન	ਕਤੀਰੇਸ਼ਨ
કથીર	ਕਥੀਰ
કદિતુલા	ਕਦਿਤੁਲਾ
કનક	ਕਨਕ
કનીસા	ਕਨੀਸਾ
કનુષ	ਕਨੁਸ਼
કપિલા	ਕਪਿਲਾ
કમલનયન	ਕਮਲਨਯਨ
કમલાબંધુ	ਕਮਲਾਬੰਧੁ
કરબી	ਕਰਬੀ
કરીના	ਕਰੀਨਾ
કરીશા	ਕਰੀਸ਼ਾ
કરીસમાં	ਕਰੀਸਮਾਂ
કરુન્યા	ਕਰੁਨ੍ਯਾ
કર્ણ	ਕਰ੍ਣ
કર્તીગા	ਕਰ੍ਤੀਗਾ
કર્નાપ્રિયા	ਕਰ੍ਨਾਪ੍ਰਿਯਾ
કર્નીકા	ਕਰ੍ਨੀਕਾ
કર્નીશ	ਕਰ੍ਨੀਸ਼
કલમજીરરન્જિનિ	ਕਲਮਜੀਰਰਨ੍ਜਿਨਿ
કલાતર	ਕਲਾਤਰ
કલાપક	ਕਲਾਪਕ
કલાપ્રિયા	ਕਲਾਪ੍ਰਿਯਾ
કલૈસેલવી	ਕਲੈਸੇਲਵੀ
કલ્પ	ਕਲ੍ਪ
કલ્પેશ	ਕਲ੍ਪੇਸ਼
કવચ	ਕਵਚ
કવિનયા	ਕਵਿਨਯਾ
કવીપ્રનીતા	ਕਵੀਪ੍ਰਨੀਤਾ
કશિશ	ਕਸ਼ਿਸ਼
કશ્યપ	ਕਸ਼੍ਯਪ
કસ્તૂરી	ਕਸ੍ਤੂਰੀ
કહન	ਕਹਨ
કાંવ	ਕਾਂਵ
કાજળ	ਕਾਜਲ
કાત્યયાની	ਕਾਤ੍ਯਯਾਨੀ
કાદમ્બિની	ਕਾਦਮ੍ਬਿਨੀ
કાનાસુ	ਕਾਨਾਸੁ
કાન્જીરા	ਕਾਨ੍ਜੀਰਾ
કામાખ્યા	ਕਾਮਾਖ੍ਯਾ
કામિકા	ਕਾਮਿਕਾ
કામીક	ਕਾਮੀਕ
કામેરીના	ਕਾਮੇਰੀਨਾ
કાયંશ	ਕਾਯੰਸ਼
કાયલવિલી	ਕਾਯਲਵਿਲੀ
કારૂકા	ਕਾਰੂਕਾ
કાલપી	ਕਾਲਪੀ
કાલિંદી	ਕਾਲਿਂਦੀ
કાલિરંજન	ਕਾਲਿਰੰਜਨ
કાવ્યંશ	ਕਾਵ੍ਯੰਸ਼
કાષ્ઠ	ਕਾਸ਼੍ਠ
કિન્નેરા	ਕਿਨ੍ਨੇਰਾ
કિર્તિત	ਕਿਰ੍ਤਿਤ
કિશા	ਕਿਸ਼ਾ
કેતવ	ਕੇਤਵ
કેતિકા	ਕੇਤਿਕਾ
કેતીત	ਕੇਤੀਤ
કેદારનાથ	ਕੇਦਾਰਨਾਥ
કેનિષા	ਕੇਨਿਸ਼ਾ
કેયા	ਕੇਯਾ
કેયાન	ਕੇਯਾਨ
કેલ્વીન	ਕੇਲ੍ਵੀਨ
કેવલકુમાર	ਕੇਵਲਕੁਮਾਰ
કેવિકા	ਕੇਵਿਕਾ
કેવ્લીના	ਕੇਵ੍ਲੀਨਾ
કેશિકા	ਕੇਸ਼ਿਕਾ
કેશિન	ਕੇਸ਼ਿਨ
કેશોરી	ਕੇਸ਼ੋਰੀ
કેસવા	ਕੇਸਵਾ
કૈરવી	ਕੈਰਵੀ
કૈલાશચંદ્ર	ਕੈਲਾਸ਼ਚੰਦ੍ਰ
કૌશિક	ਕੌਸ਼ਿਕ
કૌશેય	ਕੌਸ਼ੇਯ
કૌસ્તુભી	ਕੌਸ੍ਤੁਭੀ
ખરાધ્વામ્સીને	ਖਰਾਧ੍ਵਾਮ੍ਸੀਨੇ
ખાદીર	ਖਾਦੀਰ
ખાવ્યા	ਖਾਵ੍ਯਾ
ખુશ્બૂ	ਖੁਸ਼੍ਬੂ
ખેજલ	ਖੇਜਲ
ગંગા	ਗੰਗਾ
ગંગિકા	ਗੰਗਿਕਾ
ગંગી	ਗੰਗੀ
ગંગેયા	ਗੰਗੇਯਾ
ગંગેશ	ਗੰਗੇਸ਼
ગંદિરા	ਗੰਦਿਰਾ
ગંધા	ਗੰਧਾ
ગંધાર	ਗੰਧਾਰ
ગજપતિ	ਗਜਪਤਿ
ગ઼ુનસૂંદરી	ਗ਼ੁਨਸੂਂਦਰੀ
ગાંધામધના	ਗਾਂਧਾਮਧਨਾ
ગાયન	ਗਾਯਨ
ગાલવ	ਗਾਲਵ
ગીતિકા	ਗੀਤਿਕਾ
ગીતીશા	ਗੀਤੀਸ਼ਾ
ગીતેશ	ਗੀਤੇਸ਼
ગીત્શ	ਗੀਤ੍ਸ਼
ગીરિષા	ਗੀਰਿਸ਼ਾ
ગીર્જેશ	ਗੀਰ੍ਜੇਸ਼
ગીવીથા	ਗੀਵੀਥਾ
ગીહિતી	ਗੀਹਿਤੀ
ગુણવાથી	ਗੁਣਵਾਥੀ
ગુદાકેશ	ਗੁਦਾਕੇਸ਼
ગુનાક્ષી	ਗੁਨਾਕ੍ਸ਼ੀ
ગુનાનીધી	ਗੁਨਾਨੀਧੀ
ગુનિના	ਗੁਨਿਨਾ
ગુનીત	ਗੁਨੀਤ
ગુરનામ	ਗੁਰਨਾਮ
ગુરીશ	ਗੁਰੀਸ਼
ગુરુશરણ	ਗੁਰੁਸ਼ਰਣ
ગોપાલ કૃષ્ણન	ਗੋਪਾਲ ਕਸ਼੍ਣਨ
ગોવરી	ਗੋਵਰੀ
ગોવ્થમી	ਗੋਵ੍ਥਮੀ
ગૌરિકાંત	ਗੌਰਿਕਾਂਤ
ગૌરેશ	ਗੌਰੇਸ਼
ગૌર્યનવી	ਗੌਰ੍ਯਨਵੀ
ગ્યાનવી	ਗ੍ਯਾਨਵੀ
ગ્રહિત	ਗ੍ਰਹਿਤ
ઘટા	ਘਟਾ
ઘનાનંદ	ਘਨਾਨੰਦ
ઘુંગરૂ	ਘੁਂਗਰੂ
ચંચલાદવાલા	ਚੰਚਲਾਦਵਾਲਾ
ચંચારી	ਚੰਚਾਰੀ
ચંચારીક	ਚੰਚਾਰੀਕ
ચંદિકા	ਚੰਦਿਕਾ
ચંદ્ર ભાન	ਚੰਦ੍ਰ ਭਾਨ
ચંદ્રકિરણ	ਚੰਦ੍ਰਕਿਰਣ
ચંદ્રકીર્તી	ਚੰਦ੍ਰਕੀਰ੍ਤੀ
ચંદ્રબિંદુ	ਚੰਦ੍ਰਬਿਂਦੁ
ચક્રદેવ	ਚਕ੍ਰਦੇਵ
ચક્રિક	ਚਕ੍ਰਿਕ
ચન્દ્રવદન	ਚਨ੍ਦ੍ਰਵਦਨ
ચન્દ્રહાસ	ਚਨ੍ਦ੍ਰਹਾਸ
ચમેલી	ਚਮੇਲੀ
ચરક	ਚਰਕ
ચરણજીત	ਚਰਣਜੀਤ
ચરણરજ	ਚਰਣਰਜ
ચરિત	ਚਰਿਤ
ચરુલા	ਚਰੁਲਾ
ચસ્મીતા	ਚਸ੍ਮੀਤਾ
ચાકરીન	ਚਾਕਰੀਨ
ચાને	ਚਾਨੇ
ચાન્નક્કા	ਚਾਨ੍ਨਕ੍ਕਾ
ચાન્નાય	ਚਾਨ੍ਨਾਯ
ચારીકા	ਚਾਰੀਕਾ
ચારુદત્ત	ਚਾਰੁਦਤ੍ਤ
ચારુલતા	ਚਾਰੁਲਤਾ
ચારુશીલા	ਚਾਰੁਸ਼ੀਲਾ
ચિંટૂ	ਚਿਂਟੂ
ચિતહેશ	ਚਿਤਹੇਸ਼
ચિત્કલા	ਚਿਤ੍ਕਲਾ
ચિત્તસ્વરૂપ	ਚਿਤ੍ਤਸ੍ਵਰੂਪ
ચિત્રકુન્દાલા	ਚਿਤ੍ਰਕੁਨ੍ਦਾਲਾ
ચિત્રલ	ਚਿਤ੍ਰਲ
ચિત્રેશ	ਚਿਤ੍ਰੇਸ਼
ચિદાત્મા	ਚਿਦਾਤ੍ਮਾ
ચિધાત્મા	ਚਿਧਾਤ੍ਮਾ
ચિન્મય	ਚਿਨ੍ਮਯ
ચિર્ત્રંગ	ਚਿਰ੍ਤ੍ਰੰਗ
ચીન્નીઃ	ਚੀਨ੍ਨੀ
ચેથના	ਚੇਥਨਾ
ચેનના	ਚੇਨਨਾ
ચૈતન	ਚੈਤਨ
ચૈત્રી	ਚੈਤ੍ਰੀ
ચોલામિત્ર	ਚੋਲਾਮਿਤ੍ਰ
ચૌનતા	ਚੌਨਤਾ
છાયા	ਛਾਯਾ
જગતપાલ	ਜਗਤਪਾਲ
જગદગુરુવે	ਜਗਦਗੁਰੁਵੇ
જગદીપ	ਜਗਦੀਪ
જગન	ਜਗਨ
જગિશ	ਜਗਿਸ਼
જગ્ગેર	ਜਗ੍ਗੇਰ
જગ્સના	ਜਗ੍ਸਨਾ
જનતા	ਜਨਤਾ
જનાદેવ	ਜਨਾਦੇਵ
જનાર્દનન	ਜਨਾਰ੍ਦਨਨ
જનિતા	ਜਨਿਤਾ
જન્મ	ਜਨ੍ਮ
જમ્બાવતી	ਜਮ੍ਬਾਵਤੀ
જય ગોપાલ	ਜਯ ਗੋਪਾਲ
જયંતાસેના	ਜਯੰਤਾਸੇਨਾ
જયદા	ਜਯਦਾ
જયન	ਜਯਨ
જયમેન	ਜਯਮੇਨ
જયલક્ષ્મી	ਜਯਲਕ੍ਸ਼੍ਮੀ
જયલલીથા	ਜਯਲਲੀਥਾ
જયશેખર	ਜਯਸ਼ੇਖਰ
જયહરી	ਜਯਹਰੀ
જયાકીર્તન	ਜਯਾਕੀਰ੍ਤਨ
જયાપાદમાં	ਜਯਾਪਾਦਮਾਂ
જયાલક્ષ્મી	ਜਯਾਲਕ੍ਸ਼੍ਮੀ
જય્મીની	ਜਯ੍ਮੀਨੀ
જલાગંધા	ਜਲਾਗੰਧਾ
જલાર્ક	ਜਲਾਰ੍ਕ
જલ્પેશ	ਜਲ੍ਪੇਸ਼
જશપાલ	ਜਸ਼ਪਾਲ
જસ્લીના	ਜਸ੍ਲੀਨਾ
જસ્વીથા	ਜਸ੍ਵੀਥਾ
જસ્સીચા	ਜਸ੍ਸੀਚਾ
જહાંગીર	ਜਹਾਂਗੀਰ
જાગ્રત	ਜਾਗ੍ਰਤ
જાગ્રવ	ਜਾਗ੍ਰਵ
જાઝીમ	ਜਾਝੀਮ
જાતાવેદાસ	ਜਾਤਾਵੇਦਾਸ
જાનકીરમન	ਜਾਨਕੀਰਮਨ
જાનવી	ਜਾਨਵੀ
જાનહાન	ਜਾਨਹਾਨ
જાન્વી	ਜਾਨ੍ਵੀ
જામીની	ਜਾਮੀਨੀ
જાલેંદ્ર	ਜਾਲੇਂਦ੍ਰ
જાહનવી	ਜਾਹਨਵੀ
જિનાભદ્ર	ਜਿਨਾਭਦ੍ਰ
જિલેશ	ਜਿਲੇਸ਼
જિલ્પા	ਜਿਲ੍ਪਾ
જીગર	ਜੀਗਰ
જીતીશ	ਜੀਤੀਸ਼
જીન	ਜੀਨ
જીન્શીત	ਜੀਨ੍ਸ਼ੀਤ
જીમૂત	ਜੀਮੂਤ
જીલવ	ਜੀਲਵ
જીવા	ਜੀਵਾ
જીવિકા	ਜੀਵਿਕਾ
જીવેશ	ਜੀਵੇਸ਼
જીશના	ਜੀਸ਼ਨਾ
જીશું	ਜੀਸ਼ੁਂ
જુનીતા	ਜੁਨੀਤਾ
જેગપ્રીયાન	ਜੇਗਪ੍ਰੀਯਾਨ
જેતલ	ਜੇਤਲ
જેનીતા	ਜੇਨੀਤਾ
જેબીશા	ਜੇਬੀਸ਼ਾ
જૈચંદ	ਜੈਚੰਦ
જૈચરણ	ਜੈਚਰਣ
જૈદેવ	ਜੈਦੇਵ
જૈસંકર	ਜੈਸੰਕਰ
જૈસ્યા	ਜੈਸ੍ਯਾ
જોયાત્રી	ਜੋਯਾਤ੍ਰੀ
જોવાકી	ਜੋਵਾਕੀ
જોવિતા	ਜੋਵਿਤਾ
જોસ્યા	ਜੋਸ੍ਯਾ
જ્ઞાન	ਜ੍ਞਾਨ
જ્ઞાનાલ	ਜ੍ਞਾਨਾਲ
જ્યોસ્તના	ਜ੍ਯੋਸ੍ਤਨਾ
ઝંકાર	ਝੰਕਾਰ
ઝરલ	ਝਰਲ
ઝાએઈ	ਝਾਏਈ
ઝારા	ਝਾਰਾ
ઝિનૂક	ਝਿਨੂਕ
ઝુબીન	ਝੁਬੀਨ
ઝુલિએર	ਝੁਲਿਏਰ
ઝેનીલ	ਝੇਨੀਲ
ઠરાનીકા	ਠਰਾਨੀਕਾ
ડાલી	ਡਾਲੀ
તંગમ	ਤੰਗਮ
તક્ષક	ਤਕ੍ਸ਼ਕ
તથાથાન	ਤਥਾਥਾਨ
તનવી	ਤਨਵੀ
તનવીર	ਤਨਵੀਰ
તનિશ્ક	ਤਨਿਸ਼੍ਕ
તનુપા	ਤਨੁਪਾ
તન્નિષ્ઠા	ਤਨ੍ਨਿਸ਼੍ਠਾ
તન્વી શ્રી	ਤਨ੍ਵੀ ਸ਼੍ਰੀ
તપસેન્દ્ર	ਤਪਸੇਨ੍ਦ੍ਰ
તપસ્વિની	ਤਪਸ੍ਵਿਨੀ
તમન	ਤਮਨ
તમન્ના	ਤਮਨ੍ਨਾ
તમોનષ	ਤਮੋਨਸ਼
તયા	ਤਯਾ
તરણ	ਤਰਣ
તરનીજા	ਤਰਨੀਜਾ
તરુણી	ਤਰੁਣੀ
તરુશ્રી	ਤਰੁਸ਼੍ਰੀ
તરોશ	ਤਰੋਸ਼
તશા	ਤਸ਼ਾ
તસ્મિ	ਤਸ੍ਮਿ
તસ્ય	ਤਸ੍ਯ
તાનક	ਤਾਨਕ
તાના	ਤਾਨਾ
તાની	ਤਾਨੀ
તાનીશતા	ਤਾਨੀਸ਼ਤਾ
તાન્વી	ਤਾਨ੍ਵੀ
તાન્વેશા	ਤਾਨ੍ਵੇਸ਼ਾ
તામસી	ਤਾਮਸੀ
તામીલ્મરણ	ਤਾਮੀਲ੍ਮਰਣ
તારક	ਤਾਰਕ
તારકેશ	ਤਾਰਕੇਸ਼
તારકેશ્વર	ਤਾਰਕੇਸ਼੍ਵਰ
તારાનીસેન	ਤਾਰਾਨੀਸੇਨ
તારોક	ਤਾਰੋਕ
તાલંક	ਤਾਲੰਕ
તાલીન	ਤਾਲੀਨ
તાવીનીશ	ਤਾਵੀਨੀਸ਼
તિક્શીકા	ਤਿਕ੍ਸ਼ੀਕਾ
તિજિલ	ਤਿਜਿਲ
તિતિર	ਤਿਤਿਰ
તિનકા	ਤਿਨਕਾ
તિર્થાયાદ	ਤਿਰ੍ਥਾਯਾਦ
તિલકા	ਤਿਲਕਾ
તિલોત્તમા	ਤਿਲੋਤ੍ਤਮਾ
તીમિત	ਤੀਮਿਤ
તીમીતા	ਤੀਮੀਤਾ
તીયાસા	ਤੀਯਾਸਾ
તીરુગ્નાનમ	ਤੀਰੁਗ੍ਨਾਨਮ
તીરુમેની	ਤੀਰੁਮੇਨੀ
તીર્થરાજ	ਤੀਰ੍ਥਰਾਜ
તીશા	ਤੀਸ਼ਾ
તુકારામ	ਤੁਕਾਰਾਮ
તુન્ગાર	ਤੁਨ੍ਗਾਰ
તુલસા	ਤੁਲਸਾ
તૃષા	ਤਸ਼ਾ
તેજસી	ਤੇਜਸੀ
તેજસ્વીતા	ਤੇਜਸ੍ਵੀਤਾ
તેજસ્વીની	ਤੇਜਸ੍ਵੀਨੀ
તેજેસ્વીની	ਤੇਜੇਸ੍ਵੀਨੀ
તેજોભાદ્ર	ਤੇਜੋਭਾਦ੍ਰ
તેર્ષમ	ਤੇਰ੍ਸ਼ਮ
તેહીહ્યા	ਤੇਹੀਹ੍ਯਾ
તોમોગના	ਤੋਮੋਗਨਾ
તોશાની	ਤੋਸ਼ਾਨੀ
તોશીન	ਤੋਸ਼ੀਨ
તૌરુસ	ਤੌਰੁਸ
ત્રિકાયા	ਤ੍ਰਿਕਾਯਾ
ત્રિધાત્રી	ਤ੍ਰਿਧਾਤ੍ਰੀ
ત્રિનાથ	ਤ੍ਰਿਨਾਥ
ત્રિભુવન	ਤ੍ਰਿਭੁਵਨ
ત્રિમૂર્તિ	ਤ੍ਰਿਮੂਰ੍ਤਿ
ત્રિયા	ਤ੍ਰਿਯਾ
ત્રિવેન્દ્ર	ਤ੍ਰਿਵੇਨ੍ਦ੍ਰ
ત્રિશુલાંક	ਤ੍ਰਿਸ਼ੁਲਾਂਕ
ત્રિષર	ਤ੍ਰਿਸ਼ਰ
ત્રીનેશ	ਤ੍ਰੀਨੇਸ਼
ત્રીભુવન	ਤ੍ਰੀਭੁਵਨ
ત્રીલોકાત્માને	ਤ੍ਰੀਲੋਕਾਤ੍ਮਾਨੇ
ત્રીવીક્રમાં	ਤ੍ਰੀਵੀਕ੍ਰਮਾਂ
ત્રીવીદ	ਤ੍ਰੀਵੀਦ
ત્રેયા	ਤ੍ਰੇਯਾ
થનીરિકા	ਥਨੀਰਿਕਾ
થાનીકા	ਥਾਨੀਕਾ
થાનીષા	ਥਾਨੀਸ਼ਾ
થાનીસરી	ਥਾਨੀਸਰੀ
થાન્યસ્રી	ਥਾਨ੍ਯਸ੍ਰੀ
થામીલારાસન	ਥਾਮੀਲਾਰਾਸਨ
થારન્યા	ਥਾਰਨ੍ਯਾ
થેન્મોલી	ਥੇਨ੍ਮੋਲੀ
થ્રાયા	ਥ੍ਰਾਯਾ
દક્શીકા	ਦਕ੍ਸ਼ੀਕਾ
દક્ષિત	ਦਕ੍ਸ਼ਿਤ
દક્ષેષ	ਦਕ੍ਸ਼ੇਸ਼
દજ્શી	ਦਜ੍ਸ਼ੀ
દધીચિ	ਦਧੀਚਿ
દયસરા	ਦਯਸਰਾ
દયાકર	ਦਯਾਕਰ
દયાનીશ્કા	ਦਯਾਨੀਸ਼੍ਕਾ
દરસાથ	ਦਰਸਾਥ
દરહાસ	ਦਰਹਾਸ
દરિદ્રીયાનાશીની	ਦਰਿਦ੍ਰੀਯਾਨਾਸ਼ੀਨੀ
દર્શિકા	ਦਰ੍ਸ਼ਿਕਾ
દર્સીકા	ਦਰ੍ਸੀਕਾ
દલજીત	ਦਲਜੀਤ
દલ્શેર	ਦਲ੍ਸ਼ੇਰ
દશાગ્રીવા શીરોહરા	ਦਸ਼ਾਗ੍ਰੀਵਾ ਸ਼ੀਰੋਹਰਾ
દસરાજા	ਦਸਰਾਜਾ
દસ્માયા	ਦਸ੍ਮਾਯਾ
દહા	ਦਹਾ
દહાના	ਦਹਾਨਾ
દાનુષ	ਦਾਨੁਸ਼
દારિકા	ਦਾਰਿਕਾ
દિક્ષી	ਦਿਕ੍ਸ਼ੀ
દિપક્ષી	ਦਿਪਕ੍ਸ਼ੀ
દિપમ્શું	ਦਿਪਮ੍ਸ਼ੁਂ
દિપાશ્રી	ਦਿਪਾਸ਼੍ਰੀ
દિપ્તા	ਦਿਪ੍ਤਾ
દિશના	ਦਿਸ਼ਨਾ
દીક્ષિકા	ਦੀਕ੍ਸ਼ਿਕਾ
દીપનકર	ਦੀਪਨਕਰ
દીપમાળા	ਦੀਪਮਾਲਾ
દીપાના	ਦੀਪਾਨਾ
દીપ્તિ	ਦੀਪ੍ਤਿ
દેબન્શી	ਦੇਬਨ੍ਸ਼ੀ
દેબસ્મિતા	ਦੇਬਸ੍ਮਿਤਾ
દેબાસીસ	ਦੇਬਾਸੀਸ
દેબોરહ	ਦੇਬੋਰਹ
દેબ્પ્રસાદ	ਦੇਬ੍ਪ੍ਰਸਾਦ
દેવ કુમાર	ਦੇਵ ਕੁਮਾਰ
દેવકલી	ਦੇਵਕਲੀ
દેવકી	ਦੇਵਕੀ
દેવતા	ਦੇਵਤਾ
દેવમતિ	ਦੇਵਮਤਿ
દેવર્સી	ਦੇਵਰ੍ਸੀ
દેવાંગી	ਦੇਵਾਂਗੀ
દેવાંશ	ਦੇਵਾਂਸ਼
દેવાજુતા	ਦੇਵਾਜੁਤਾ
દેવાદાર્શીની	ਦੇਵਾਦਾਰ੍ਸ਼ੀਨੀ
દેવાદીત્યા	ਦੇਵਾਦੀਤ੍ਯਾ
દેવાદ્યુમના	ਦੇਵਾਦ੍ਯੁਮਨਾ
દેવાનંદન	ਦੇਵਾਨੰਦਨ
દેવાપી	ਦੇਵਾਪੀ
દેવાલીના	ਦੇਵਾਲੀਨਾ
દેવિદાસ	ਦੇਵਿਦਾਸ
દેવિના	ਦੇਵਿਨਾ
દેવીકી	ਦੇਵੀਕੀ
દેવેન્દ્રનાથ	ਦੇਵੇਨ੍ਦ੍ਰਨਾਥ
દેવેન્દ્રશીકા	ਦੇਵੇਨ੍ਦ੍ਰਸ਼ੀਕਾ
દેવેશી	ਦੇਵੇਸ਼ੀ
દેવ્યમ	ਦੇਵ੍ਯਮ
દેવ્યાની	ਦੇਵ੍ਯਾਨੀ
દેવ્વાન્તી	ਦੇਵ੍ਵਾਨ੍ਤੀ
દેશવા	ਦੇਸ਼ਵਾ
દેશીકા	ਦੇਸ਼ੀਕਾ
દેસના	ਦੇਸਨਾ
દેસીકા	ਦੇਸੀਕਾ
દેહ્ય	ਦੇਹ੍ਯ
દૈત્ય	ਦੈਤ੍ਯ
દૈના	ਦੈਨਾ
દૈપાયન	ਦੈਪਾਯਨ
દૈવી	ਦੈਵੀ
ધક્શીતા	ਧਕ੍ਸ਼ੀਤਾ
ધક્ષતા	ਧਕ੍ਸ਼ਤਾ
ધન લક્ષ્મી	ਧਨ ਲਕ੍ਸ਼੍ਮੀ
ધનધાન્યકી	ਧਨਧਾਨ੍ਯਕੀ
ધનશિકા	ਧਨਸ਼ਿਕਾ
ધનિયા	ਧਨਿਯਾ
ધનુંર્ધારા	ਧਨੁਂਰ੍ਧਾਰਾ
ધમેન્દ્ર	ਧਮੇਨ੍ਦ੍ਰ
ધરમવીર	ਧਰਮਵੀਰ
ધરાસુતા	ਧਰਾਸੁਤਾ
ધર્મઅધ્યક્ષ	ਧਰ੍ਮਅਧ੍ਯਕ੍ਸ਼
ધર્મકીર્તિ	ਧਰ੍ਮਕੀਰ੍ਤਿ
ધર્મીશ્તા	ਧਰ੍ਮੀਸ਼੍ਤਾ
ધવલ્યા	ਧਵਲ੍ਯਾ
ધાર્શીકા	ਧਾਰ੍ਸ਼ੀਕਾ
ધાવીશી	ਧਾਵੀਸ਼ੀ
ધિરા	ਧਿਰਾ
ધીપ્ત્હા	ਧੀਪ੍ਤ੍ਹਾ
ધીમાહી	ਧੀਮਾਹੀ
ધૂન	ਧੂਨ
ધૈર્ય	ਧੈਰ੍ਯ
ધ્રીશીકા	ਧ੍ਰੀਸ਼ੀਕਾ
નંદ	ਨੰਦ
નંદકુમાર	ਨੰਦਕੁਮਾਰ
નંદગોપાલ	ਨੰਦਗੋਪਾਲ
નક્શ	ਨਕ੍ਸ਼
નક્ષાત્ર	ਨਕ੍ਸ਼ਾਤ੍ਰ
નગરજન	ਨਗਰਜਨ
નબ્હિજ	ਨਬ੍ਹਿਜ
નમસ્યૂ	ਨਮਸ੍ਯੂ
નમીતા	ਨਮੀਤਾ
નયાજ	ਨਯਾਜ
નયાસના	ਨਯਾਸਨਾ
નરીતા	ਨਰੀਤਾ
નર્મદા	ਨਰ੍ਮਦਾ
નવતેજ	ਨਵਤੇਜ
નવિન	ਨਵਿਨ
નાકીસકા	ਨਾਕੀਸਕਾ
નાકુશ	ਨਾਕੁਸ਼
નાગનાથ	ਨਾਗਨਾਥ
નાગાંજલી	ਨਾਗਾਂਜਲੀ
નાગાનંદિની	ਨਾਗਾਨੰਦਿਨੀ
નાગાર્જુન	ਨਾਗਾਰ੍ਜੁਨ
નાગેસ્વારી	ਨਾਗੇਸ੍ਵਾਰੀ
નાટકપ્રિય	ਨਾਟਕਪ੍ਰਿਯ
નાથ	ਨਾਥ
નાન્દુની	ਨਾਨ੍ਦੁਨੀ
નાભિ	ਨਾਭਿ
નાયક	ਨਾਯਕ
નાયકી	ਨਾਯਕੀ
નારંગ	ਨਾਰੰਗ
નારન	ਨਾਰਨ
નારાયન	ਨਾਰਾਯਨ
નાર્સપ્પા	ਨਾਰ੍ਸਪ੍ਪਾ
નાવાન્ય	ਨਾਵਾਨ੍ਯ
નાવાપ્રિયન	ਨਾਵਾਪ੍ਰਿਯਨ
નાશાલ	ਨਾਸ਼ਾਲ
નિકેતા	ਨਿਕੇਤਾ
નિખાલ	ਨਿਖਾਲ
નિખિલ	ਨਿਖਿਲ
નિધન	ਨਿਧਨ
નિપા	ਨਿਪਾ
નિબંધના	ਨਿਬੰਧਨਾ
નિમેશ	ਨਿਮੇਸ਼
નિરામઈ	ਨਿਰਾਮਈ
નિરામયા	ਨਿਰਾਮਯਾ
નિરૂપા	ਨਿਰੂਪਾ
નિલિની	ਨਿਲਿਨੀ
નિલ્લ	ਨਿਲ੍ਲ
નિશય	ਨਿਸ਼ਯ
નિશા	ਨਿਸ਼ਾ
નિશિ	ਨਿਸ਼ਿ
નિશિકા	ਨਿਸ਼ਿਕਾ
નિષ્ણાં	ਨਿਸ਼੍ਣਾਂ
નિહિત	ਨਿਹਿਤ
નીકુંજા	ਨੀਕੁਂਜਾ
નીકેશ્ય	ਨੀਕੇਸ਼੍ਯ
નીખેલ	ਨੀਖੇਲ
નીગી	ਨੀਗੀ
નીડી	ਨੀਡੀ
નીદિશ	ਨੀਦਿਸ਼
નીધા	ਨੀਧਾ
નીપા	ਨੀਪਾ
નીપુના	ਨੀਪੁਨਾ
નીબેદીતા	ਨੀਬੇਦੀਤਾ
નીરજ નયન	ਨੀਰਜ ਨਯਨ
નીરુધી	ਨੀਰੁਧੀ
નીરૈમાંથી	ਨੀਰੈਮਾਂਥੀ
નીર્મુકતા	ਨੀਰ੍ਮੁਕਤਾ
નીલંજન	ਨੀਲੰਜਨ
નીલાક્ષી	ਨੀਲਾਕ੍ਸ਼ੀ
નીલ્પ્રબ્ભા	ਨੀਲ੍ਪ੍ਰਬ੍ਭਾ
નીશીરા	ਨੀਸ਼ੀਰਾ
નીશોકા	ਨੀਸ਼ੋਕਾ
નીસ્ચીતા	ਨੀਸ੍ਚੀਤਾ
નીસ્ચીથા	ਨੀਸ੍ਚੀਥਾ
નેકા	ਨੇਕਾ
નેત્રતાવ	ਨੇਤ੍ਰਤਾਵ
નેમીચંદ	ਨੇਮੀਚੰਦ
નેવી	ਨੇਵੀ
નેશ્વારી	ਨੇਸ਼੍ਵਾਰੀ
નૈનીશા	ਨੈਨੀਸ਼ਾ
નૈમિષા	ਨੈਮਿਸ਼ਾ
નૈરુથી	ਨੈਰੁਥੀ
નૈલીકા	ਨੈਲੀਕਾ
નૌરિન	ਨੌਰਿਨ
પંકજલોચના	ਪੰਕਜਲੋਚਨਾ
પંકિત	ਪੰਕਿਤ
પંચમી	ਪੰਚਮੀ
પંડી	ਪੰਡੀ
પંથ	ਪੰਥ
પક્ષી	ਪਕ੍ਸ਼ੀ
પક્ષીન	ਪਕ੍ਸ਼ੀਨ
પઝ્હેની	ਪਝ੍ਹੇਨੀ
પણ-ગેશ	ਪਣ-ਗੇਸ਼
પત્ર	ਪਤ੍ਰ
પત્રલિકા	ਪਤ੍ਰਲਿਕਾ
પત્રીક	ਪਤ੍ਰੀਕ
પદમાંક્ષ્ય	ਪਦਮਾਂਕ੍ਸ਼੍ਯ
પદમાવતી	ਪਦਮਾਵਤੀ
પદ્મ	ਪਦ੍ਮ
પદ્માકર	ਪਦ੍ਮਾਕਰ
પનિતા	ਪਨਿਤਾ
પન્યશ્રી	ਪਨ੍ਯਸ਼੍ਰੀ
પયોશ્નીકા	ਪਯੋਸ਼੍ਨੀਕਾ
પરમ	ਪਰਮ
પરમિલા	ਪਰਮਿਲਾ
પરવાસૂ	ਪਰਵਾਸੂ
પરસમે	ਪਰਸਮੇ
પરસ્માઈ	ਪਰਸ੍ਮਾਈ
પરાકાષ	ਪਰਾਕਾਸ਼
પરાક્રમ	ਪਰਾਕ੍ਰਮ
પરિચય	ਪਰਿਚਯ
પરિષ	ਪਰਿਸ਼
પરીસા	ਪਰੀਸਾ
પર્જન્ય	ਪਰ੍ਜਨ੍ਯ
પર્નલ	ਪਰ੍ਨਲ
પર્વત	ਪਰ੍ਵਤ
પલાશરંજન	ਪਲਾਸ਼ਰੰਜਨ
પલોમી	ਪਲੋਮੀ
પલ્લબ	ਪਲ੍ਲਬ
પલ્લવિની	ਪਲ੍ਲਵਿਨੀ
પલ્લવી	ਪਲ੍ਲਵੀ
પવીશ્ના	ਪਵੀਸ਼੍ਨਾ
પહેલ	ਪਹੇਲ
પાઓલા	ਪਾਓਲਾ
પાગલાવન	ਪਾਗਲਾਵਨ
પાન્દિયન	ਪਾਨ੍ਦਿਯਨ
પારબ્રહ્મ	ਪਾਰਬ੍ਰਹ੍ਮ
પારવાથી	ਪਾਰਵਾਥੀ
પારાવ	ਪਾਰਾਵ
પાર્થવ	ਪਾਰ੍ਥਵ
પાર્થિવ	ਪਾਰ੍ਥਿਵ
પાર્થીવેન્દ્ર	ਪਾਰ੍ਥੀਵੇਨ੍ਦ੍ਰ
પાર્વતી નંદન	ਪਾਰ੍ਵਤੀ ਨੰਦਨ
પાર્વાથી	ਪਾਰ੍ਵਾਥੀ
પાવકી	ਪਾਵਕੀ
પાવના	ਪਾਵਨਾ
પાવાકી	ਪਾਵਾਕੀ
પિંગલા	ਪਿਂਗਲਾ
પીઅલ્લી	ਪੀਅਲ੍ਲੀ
પીતામ્બરા	ਪੀਤਾਮ੍ਬਰਾ
પીનલ	ਪੀਨਲ
પીયાશા	ਪੀਯਾਸ਼ਾ
પીર્નાવ	ਪੀਰ੍ਨਾਵ
પૂજન	ਪੂਜਨ
પૂર્ણલલીતા	ਪੂਰ੍ਣਲਲੀਤਾ
પૂર્નાચંદ્રા	ਪੂਰ੍ਨਾਚੰਦ੍ਰਾ
પૂર્નામદા	ਪੂਰ੍ਨਾਮਦਾ
પૂર્વ	ਪੂਰ੍ਵ
પૂર્વિકા	ਪੂਰ੍ਵਿਕਾ
પૂર્વીજ્હા	ਪੂਰ੍ਵੀਜ੍ਹਾ
પોંનન	ਪੋਂਨਨ
પોઉર્નીમાં	ਪੋਉਰ੍ਨੀਮਾਂ
પોન્થારા	ਪੋਨ੍ਥਾਰਾ
પોરોમાં	ਪੋਰੋਮਾਂ
પોષ	ਪੋਸ਼
પૌરવી	ਪੌਰਵੀ
પ્રંવુતા	ਪ੍ਰੰਵੁਤਾ
પ્રગતીશા	ਪ੍ਰਗਤੀਸ਼ਾ
પ્રગ્યા	ਪ੍ਰਗ੍ਯਾ
પ્રણાલી	ਪ੍ਰਣਾਲੀ
પ્રનાદા	ਪ੍ਰਨਾਦਾ
પ્રન્જા	ਪ੍ਰਨ੍ਜਾ
પ્રભાકર	ਪ੍ਰਭਾਕਰ
પ્રભાતી	ਪ੍ਰਭਾਤੀ
પ્રભારૂપા	ਪ੍ਰਭਾਰੂਪਾ
પ્રભાવતી	ਪ੍ਰਭਾਵਤੀ
પ્રભ્રીતી	ਪ੍ਰਭ੍ਰੀਤੀ
પ્રહાર્શીની	ਪ੍ਰਹਾਰ੍ਸ਼ੀਨੀ
પ્રહાસા	ਪ੍ਰਹਾਸਾ
પ્રાખ્યા	ਪ੍ਰਾਖ੍ਯਾ
પ્રાણવાપ્રિયા	ਪ੍ਰਾਣਵਾਪ੍ਰਿਯਾ
પ્રાનાદ	ਪ੍ਰਾਨਾਦ
ફણીશ	ਫਣੀਸ਼
ફલોની	ਫਲੋਨੀ
ફુલ્લન	ਫੁਲ੍ਲਨ
ફેની	ਫੇਨੀ
ફ્લાવીના	ਫ੍ਲਾਵੀਨਾ
બત્નાસીદ્ધીકારા	ਬਤ੍ਨਾਸੀਦ੍ਧੀਕਾਰਾ
બદરી	ਬਦਰੀ
બન્દીન	ਬਨ੍ਦੀਨ
બર્હન	ਬਰ੍ਹਨ
બલામુરુગન	ਬਲਾਮੁਰੁਗਨ
બલામ્બુ	ਬਲਾਮ੍ਬੁ
બલ્લભ	ਬਲ੍ਲਭ
બવિયન	ਬਵਿਯਨ
બસંતી	ਬਸੰਤੀ
બસૂધા	ਬਸੂਧਾ
બાટલી	ਬਾਟਲੀ
બાલાજી	ਬਾਲਾਜੀ
બાલારામ	ਬਾਲਾਰਾਮ
બાલેન્દ્ર	ਬਾਲੇਨ੍ਦ੍ਰ
બાહુબલી	ਬਾਹੁਬਲੀ
બાહુલ્ય	ਬਾਹੁਲ੍ਯ
બિંકા	ਬਿਂਕਾ
બિજય	ਬਿਜਯ
બિધાન	ਬਿਧਾਨ
બિનોય	ਬਿਨੋਯ
બિભવાસુ	ਬਿਭਵਾਸੁ
બિમલા	ਬਿਮਲਾ
બિમ્બ	ਬਿਮ੍ਬ
બિસાલા	ਬਿਸਾਲਾ
બીકાશ	ਬੀਕਾਸ਼
બીન્દુસાગર	ਬੀਨ੍ਦੁਸਾਗਰ
બીબોસ્વાન	ਬੀਬੋਸ੍ਵਾਨ
બીભાકર	ਬੀਭਾਕਰ
બીલ્વાની	ਬੀਲ੍ਵਾਨੀ
બીલ્વાનીલાયા	ਬੀਲ੍ਵਾਨੀਲਾਯਾ
બુધીપ્રિયા	ਬੁਧੀਪ੍ਰਿਯਾ
બૂમિકા	ਬੂਮਿਕਾ
બૃંદા	ਬੰਦਾ
બેનીતા	ਬੇਨੀਤਾ
બૈજયંતી	ਬੈਜਯੰਤੀ
બૈસાખી	ਬੈਸਾਖੀ
બૌમાંથી	ਬੌਮਾਂਥੀ
બ્રનુચિકા	ਬ੍ਰਨੁਚਿਕਾ
બ્રહ્માવતી	ਬ੍ਰਹ੍ਮਾਵਤੀ
બ્રિજબાલા	ਬ੍ਰਿਜਬਾਲਾ
ભગત	ਭਗਤ
ભગવંત	ਭਗਵੰਤ
ભદ્રંગ	ਭਦ੍ਰੰਗ
ભદ્રક	ਭਦ੍ਰਕ
ભદ્રકપિલ	ਭਦ੍ਰਕਪਿਲ
ભરાન	ਭਰਾਨ
ભર્તેશ	ਭਰ੍ਤੇਸ਼
ભવન	ਭਵਨ
ભવરોગસ્યાભેશાજા	ਭਵਰੋਗਸ੍ਯਾਭੇਸ਼ਾਜਾ
ભવાની સંકર	ਭਵਾਨੀ ਸੰਕਰ
ભાગીરત	ਭਾਗੀਰਤ
ભાગ્યશબરી	ਭਾਗ੍ਯਸ਼ਬਰੀ
ભાગ્યા	ਭਾਗ੍ਯਾ
ભાગ્યેશ	ਭਾਗ੍ਯੇਸ਼
ભાનુજ	ਭਾਨੁਜ
ભાનુપ્રિયા	ਭਾਨੁਪ੍ਰਿਯਾ
ભાનુમિત્ર	ਭਾਨੁਮਿਤ੍ਰ
ભારતી	ਭਾਰਤੀ
ભારવી	ਭਾਰਵੀ
ભારુ	ਭਾਰੁ
ભાર્ગવા	ਭਾਰ੍ਗਵਾ
ભાવાનીલ	ਭਾਵਾਨੀਲ
ભાવાપ્રિયા	ਭਾਵਾਪ੍ਰਿਯਾ
ભાવામોચની	ਭਾਵਾਮੋਚਨੀ
ભાવાર્થ	ਭਾਵਾਰ੍ਥ
ભાવાલન	ਭਾਵਾਲਨ
ભાવિક	ਭਾਵਿਕ
ભાવિન	ਭਾਵਿਨ
ભાવેશ	ਭਾਵੇਸ਼
ભાસુ	ਭਾਸੁ
ભિમાંવેગ	ਭਿਮਾਂਵੇਗ
ભીખી	ਭੀਖੀ
ભીમસેન	ਭੀਮਸੇਨ
ભીમાંન્શી	ਭੀਮਾਂਨ੍ਸ਼ੀ
ભીલાનગના	ਭੀਲਾਨਗਨਾ
ભુવૈનીકા	ਭੁਵੈਨੀਕਾ
ભૂતપાલા	ਭੂਤਪਾਲਾ
ભૂપેન્દ્ર	ਭੂਪੇਨ੍ਦ੍ਰ
ભૂમીશ	ਭੂਮੀਸ਼
ભૃગુ	ਭਗੁ
ભેવીન	ਭੇਵੀਨ
ભેસાજ	ਭੇਸਾਜ
ભોજા	ਭੋਜਾ
ભોલાનાથ	ਭੋਲਾਨਾਥ
મંગલા	ਮੰਗਲਾ
મંજુ પ્રસાદ	ਮੰਜੁ ਪ੍ਰਸਾਦ
મંજુનાથ	ਮੰਜੁਨਾਥ
મંજુબાલા	ਮੰਜੁਬਾਲਾ
મંજૂશા	ਮੰਜੂਸ਼ਾ
મંત	ਮੰਤ
મંત્રના	ਮੰਤ੍ਰਨਾ
મંથિકા	ਮੰਥਿਕਾ
મકર	ਮਕਰ
મણિરત્ના	ਮਣਿਰਤ੍ਨਾ
મત્સ્યેંદ્ર	ਮਤ੍ਸ੍ਯੇਂਦ੍ਰ
મદીન	ਮਦੀਨ
મદુર	ਮਦੁਰ
મધુ સ્મિતા	ਮਧੁ ਸ੍ਮਿਤਾ
મધુકાંત	ਮਧੁਕਾਂਤ
મધુદીપ	ਮਧੁਦੀਪ
મધુમાંલી	ਮਧੁਮਾਂਲੀ
મધુમાલતી	ਮਧੁਮਾਲਤੀ
મધુલા	ਮਧੁਲਾ
મધુલેખા	ਮਧੁਲੇਖਾ
મનનશ	ਮਨਨਸ਼
મનવિર	ਮਨਵਿਰ
મનસ્વિન	ਮਨਸ੍ਵਿਨ
મનસ્વિની	ਮਨਸ੍ਵਿਨੀ
મનિભૂષણ	ਮਨਿਭੂਸ਼ਣ
મનીતા	ਮਨੀਤਾ
મનીદીપ	ਮਨੀਦੀਪ
મનુજ	ਮਨੁਜ
મનોથ	ਮਨੋਥ
મનોભાવ	ਮਨੋਭਾਵ
મન્કુર	ਮਨ੍ਕੁਰ
મયુરીની	ਮਯੁਰੀਨੀ
મરીને	ਮਰੀਨੇ
મલયજ	ਮਲਯਜ
મલ્લિકા	ਮਲ੍ਲਿਕਾ
મલ્લિકાર્જુન	ਮਲ੍ਲਿਕਾਰ੍ਜੁਨ
મલ્લિગા	ਮਲ੍ਲਿਗਾ
મલ્લી	ਮਲ੍ਲੀ
મલ્લુ	ਮਲ੍ਲੁ
મસરા	ਮਸਰਾ
મહંથી	ਮਹੰਥੀ
મહાત્મન	ਮਹਾਤ੍ਮਨ
મહાનંદ	ਮਹਾਨੰਦ
મહાપુરુષ	ਮਹਾਪੁਰੁਸ਼
મહાબુદ્ધિ	ਮਹਾਬੁਦ੍ਧਿ
મહાર્થ	ਮਹਾਰ੍ਥ
મહાર્વીન	ਮਹਾਰ੍ਵੀਨ
મહાલીંગ	ਮਹਾਲੀਂਗ
મહાલ્યા	ਮਹਾਲ੍ਯਾ
મહાશ્રી	ਮਹਾਸ਼੍ਰੀ
મહિપતિ	ਮਹਿਪਤਿ
મહીથા	ਮਹੀਥਾ
મહેંદ્રા	ਮਹੇਂਦ੍ਰਾ
માંગેશ	ਮਾਂਗੇਸ਼
માંધુનીકા	ਮਾਂਧੁਨੀਕਾ
માંનાર્પ	ਮਾਂਨਾਰ੍ਪ
માંનીક્યા	ਮਾਂਨੀਕ੍ਯਾ
માંનીચ	ਮਾਂਨੀਚ
માંનીવ	ਮਾਂਨੀਵ
માંનુંસ્મીથા	ਮਾਂਨੁਂਸ੍ਮੀਥਾ
માંનોત	ਮਾਂਨੋਤ
માંન્ગીરી	ਮਾਂਨ੍ਗੀਰੀ
માંન્તીકા	ਮਾਂਨ੍ਤੀਕਾ
માંન્દામારી	ਮਾਂਨ੍ਦਾਮਾਰੀ
માંન્દારિકા	ਮਾਂਨ੍ਦਾਰਿਕਾ
માંલાવાશ્રી	ਮਾਂਲਾਵਾਸ਼੍ਰੀ
માતંગા	ਮਾਤੰਗਾ
માતેઃ	ਮਾਤੇ
માત્રે	ਮਾਤ੍ਰੇ
માથુર	ਮਾਥੁਰ
માધવ દાસ	ਮਾਧਵ ਦਾਸ
માધવિલતા	ਮਾਧਵਿਲਤਾ
માધાન	ਮਾਧਾਨ
માધુજ	ਮਾਧੁਜ
માનજ	ਮਾਨਜ
માનવિત	ਮਾਨਵਿਤ
માનીન્ત	ਮਾਨੀਨ੍ਤ
માન્દાવિક	ਮਾਨ੍ਦਾਵਿਕ
મારવી	ਮਾਰਵੀ
મારીરાજ	ਮਾਰੀਰਾਜ
મારુત	ਮਾਰੁਤ
માર્કાન્દાય	ਮਾਰ੍ਕਾਨ੍ਦਾਯ
માર્ગશી	ਮਾਰ੍ਗਸ਼ੀ
માર્ગી	ਮਾਰ੍ਗੀ
માર્દવ	ਮਾਰ੍ਦਵ
માર્મિક	ਮਾਰ੍ਮਿਕ
માલતી	ਮਾਲਤੀ
માલથી	ਮਾਲਥੀ
માલારવિલી	ਮਾਲਾਰਵਿਲੀ
માલારાવન	ਮਾਲਾਰਾਵਨ
માલિની	ਮਾਲਿਨੀ
માહિતા	ਮਾਹਿਤਾ
મેધાસ્વી	ਮੇਧਾਸ੍ਵੀ
મૈથીલ્ય	ਮੈਥੀਲ੍ਯ
મૈનાલી	ਮੈਨਾਲੀ
મૈનાવી	ਮੈਨਾਵੀ
મૈમત	ਮੈਮਤ
મૌલિકા	ਮੌਲਿਕਾ
મૌસુમ	ਮੌਸੁਮ
યજ્નારૂપ	ਯਜ੍ਨਾਰੂਪ
યતિકા	ਯਤਿਕਾ
યદુ	ਯਦੁ
યદુક્રિષ્ના	ਯਦੁਕ੍ਰਿਸ਼੍ਨਾ
યદુવીર	ਯਦੁਵੀਰ
યમ્યા	ਯਮ੍ਯਾ
યશિત	ਯਸ਼ਿਤ
યશોધર	ਯਸ਼ੋਧਰ
યશ્દીપ	ਯਸ਼੍ਦੀਪ
યશ્વી	ਯਸ਼੍ਵੀ
યાઝટ	ਯਾਝਟ
યાતિયાસા	ਯਾਤਿਯਾਸਾ
યામાજીત	ਯਾਮਾਜੀਤ
યાશીકા	ਯਾਸ਼ੀਕਾ
યાશ્રી	ਯਾਸ਼੍ਰੀ
યાસી	ਯਾਸੀ
યાહ્વી	ਯਾਹ੍ਵੀ
યીશાઈ	ਯੀਸ਼ਾਈ
યુકાશ્રી	ਯੁਕਾਸ਼੍ਰੀ
યુક્ત	ਯੁਕ੍ਤ
યુગ	ਯੁਗ
યુગંશ	ਯੁਗੰਸ਼
યુગન	ਯੁਗਨ
યુગ્મ	ਯੁਗ੍ਮ
યુધાજિત	ਯੁਧਾਜਿਤ
યુધિસઠિર	ਯੁਧਿਸਠਿਰ
યુનાય	ਯੁਨਾਯ
યુવંશ	ਯੁਵੰਸ਼
યુવાની	ਯੁਵਾਨੀ
યુવિક	ਯੁਵਿਕ
યૂરા	ਯੂਰਾ
યેધાંત	ਯੇਧਾਂਤ
યેનાક્ષી	ਯੇਨਾਕ੍ਸ਼ੀ
યોગજ	ਯੋਗਜ
યોગદા	ਯੋਗਦਾ
યોગના	ਯੋਗਨਾ
યોગાવી	ਯੋਗਾਵੀ
યોગી	ਯੋਗੀ
યોગ્યથા	ਯੋਗ੍ਯਥਾ
યોનેન્દ્ર	ਯੋਨੇਨ੍ਦ੍ਰ
યૌષા	ਯੌਸ਼ਾ
રંગનાથ	ਰੰਗਨਾਥ
રંતાજ	ਰੰਤਾਜ
રકશ્ન્ડા	ਰਕਸ਼੍ਨ੍ਡਾ
રકીશી	ਰਕੀਸ਼ੀ
રક્તકમળ	ਰਕ੍ਤਕਮਲ
રક્ષ્ય	ਰਕ੍ਸ਼੍ਯ
રઘુનાથ	ਰਘੁਨਾਥ
રજીની	ਰਜੀਨੀ
રતન	ਰਤਨ
રત્ના કુમાર	ਰਤ੍ਨਾ ਕੁਮਾਰ
રત્નાબલી	ਰਤ੍ਨਾਬਲੀ
રત્નાવલી	ਰਤ੍ਨਾਵਲੀ
રદીતે	ਰਦੀਤੇ
રનક	ਰਨਕ
રનવા	ਰਨਵਾ
રનામીતા	ਰਨਾਮੀਤਾ
રમિતા	ਰਮਿਤਾ
રમેશ	ਰਮੇਸ਼
રમ્બેશ	ਰਮ੍ਬੇਸ਼
રમ્યક	ਰਮ੍ਯਕ
રયાપ્પા	ਰਯਾਪ੍ਪਾ
રવિકાંત	ਰਵਿਕਾਂਤ
રવિકુમાર	ਰਵਿਕੁਮਾਰ
રવીતેજા	ਰਵੀਤੇਜਾ
રવીન	ਰਵੀਨ
રવીન્ધાર	ਰਵੀਨ੍ਧਾਰ
રવીશ	ਰਵੀਸ਼
રવેન	ਰਵੇਨ
રશેષ	ਰਸ਼ੇਸ਼
રશ્મી	ਰਸ਼੍ਮੀ
રસવંત	ਰਸਵੰਤ
રહલ	ਰਹਲ
રહસ્ય	ਰਹਸ੍ਯ
રાકવી	ਰਾਕਵੀ
રાખિ	ਰਾਖਿ
રાગાવર્દીની	ਰਾਗਾਵਰ੍ਦੀਨੀ
રાગ્વેદ	ਰਾਗ੍ਵੇਦ
રાજન	ਰਾਜਨ
રાજરમણ	ਰਾਜਰਮਣ
રાજલક્ષ્મી	ਰਾਜਲਕ੍ਸ਼੍ਮੀ
રાજસેકરણ	ਰਾਜਸੇਕਰਣ
રાજાન	ਰਾਜਾਨ
રાજિંદર	ਰਾਜਿਂਦਰ
રાજુસ	ਰਾਜੁਸ
રાજેંદ્ર	ਰਾਜੇਂਦ੍ਰ
રાજેશ્રી	ਰਾਜੇਸ਼੍ਰੀ
રાજ્કલા	ਰਾਜ੍ਕਲਾ
રાજ્યશ્રી	ਰਾਜ੍ਯਸ਼੍ਰੀ
રાજ્વિકા	ਰਾਜ੍ਵਿਕਾ
રાત્રિ	ਰਾਤ੍ਰਿ
રાધક	ਰਾਧਕ
રાધા	ਰਾਧਾ
રાનું	ਰਾਨੁਂ
રામ	ਰਾਮ
રામ  સેવક	ਰਾਮ  ਸੇਵਕ
રામનાથ	ਰਾਮਨਾਥ
રામરા	ਰਾਮਰਾ
રામસ્વરૂપ	ਰਾਮਸ੍ਵਰੂਪ
રામાંભાદ્રણ	ਰਾਮਾਂਭਾਦ੍ਰਣ
રામાધુતા	ਰਾਮਾਧੁਤਾ
રાવના	ਰਾਵਨਾ
રાસબિહારી	ਰਾਸਬਿਹਾਰੀ
રિન્કલ	ਰਿਨ੍ਕਲ
રિસા	ਰਿਸਾ
રીકાર્નાવ	ਰੀਕਾਰ੍ਨਾਵ
રીકીતા	ਰੀਕੀਤਾ
રીકીશા	ਰੀਕੀਸ਼ਾ
રીગ્વેદીતા	ਰੀਗ੍ਵੇਦੀਤਾ
રીથ	ਰੀਥ
રીથેકા	ਰੀਥੇਕਾ
રીધી	ਰੀਧੀ
રીનું	ਰੀਨੁਂ
રીન્સીન	ਰੀਨ੍ਸੀਨ
રીમા	ਰੀਮਾ
રીશીતા	ਰੀਸ਼ੀਤਾ
રીહાનના	ਰੀਹਾਨਨਾ
રેચિકા	ਰੇਚਿਕਾ
રેનેશ	ਰੇਨੇਸ਼
રેમિથા	ਰੇਮਿਥਾ
રેશમી	ਰੇਸ਼ਮੀ
રોનક	ਰੋਨਕ
લકી	ਲਕੀ
લક્ષિતા	ਲਕ੍ਸ਼ਿਤਾ
લક્ષ્મી શ્રીનિવાસ	ਲਕ੍ਸ਼੍ਮੀ ਸ਼੍ਰੀਨਿਵਾਸ
લક્ષ્મીદેવી	ਲਕ੍ਸ਼੍ਮੀਦੇਵੀ
લક્ષ્મીનાથ	ਲਕ੍ਸ਼੍ਮੀਨਾਥ
લગાન	ਲਗਾਨ
લજ્જા	ਲਜ੍ਜਾ
લજ્જાન	ਲਜ੍ਜਾਨ
લજ્જાવતી	ਲਜ੍ਜਾਵਤੀ
લતા	ਲਤਾ
લબોની	ਲਬੋਨੀ
લલિતામોહના	ਲਲਿਤਾਮੋਹਨਾ
લશિકા	ਲਸ਼ਿਕਾ
લાઈના	ਲਾਈਨਾ
લાકેશ	ਲਾਕੇਸ਼
લાક્શેતા	ਲਾਕ੍ਸ਼ੇਤਾ
લાચ્મન	ਲਾਚ੍ਮਨ
લાતીશ	ਲਾਤੀਸ਼
લાધી	ਲਾਧੀ
લારીસા	ਲਾਰੀਸਾ
લાર્મિકા	ਲਾਰ੍ਮਿਕਾ
લાલીતેશ	ਲਾਲੀਤੇਸ਼
લાલીત્યા	ਲਾਲੀਤ੍ਯਾ
લાલીમા	ਲਾਲੀਮਾ
લાવણ્ય	ਲਾਵਣ੍ਯ
લાવીશ	ਲਾਵੀਸ਼
લાસીવીન્રાજ	ਲਾਸੀਵੀਨ੍ਰਾਜ
લાસુશા	ਲਾਸੁਸ਼ਾ
લિંગાધ્યક્ષ	ਲਿਂਗਾਧ੍ਯਕ੍ਸ਼
લીકીથ	ਲੀਕੀਥ
લીથીકા	ਲੀਥੀਕਾ
લીનું	ਲੀਨੁਂ
લીન્નેત	ਲੀਨ੍ਨੇਤ
લીમીશા	ਲੀਮੀਸ਼ਾ
લીલાધર	ਲੀਲਾਧਰ
લીલાવર્તી	ਲੀਲਾਵਰ੍ਤੀ
લીશાંત	ਲੀਸ਼ਾਂਤ
લુંહાન	ਲੁਂਹਾਨ
લુકેશા	ਲੁਕੇਸ਼ਾ
લૂની	ਲੂਨੀ
લેઓરા	ਲੇਓਰਾ
લેખિત	ਲੇਖਿਤ
લેના	ਲੇਨਾ
લેમ્મીએ	ਲੇਮ੍ਮੀਏ
લોઉકિક	ਲੋਉਕਿਕ
લોકનાથ	ਲੋਕਨਾਥ
લોકનેત્ર	ਲੋਕਨੇਤ੍ਰ
લોકાજિત	ਲੋਕਾਜਿਤ
લોકેન્દ્ર	ਲੋਕੇਨ੍ਦ੍ਰ
લોક્ષી	ਲੋਕ੍ਸ਼ੀ
લોપેશ	ਲੋਪੇਸ਼
લોલા	ਲੋਲਾ
લોલિતા	ਲੋਲਿਤਾ
લોવ્યમ	ਲੋਵ੍ਯਮ
લોશીની	ਲੋਸ਼ੀਨੀ
લોહિની	ਲੋਹਿਨੀ
વંદિત	ਵੰਦਿਤ
વંશજા	ਵੰਸ਼ਜਾ
વંહી	ਵੰਹੀ
વકૃત	ਵਕਤ
વક્ષ	ਵਕ੍ਸ਼
વજરાંગ	ਵਜਰਾਂਗ
વજ્રબાહૂ	ਵਜ੍ਰਬਾਹੂ
વજ્રાકાયા	ਵਜ੍ਰਾਕਾਯਾ
વજ્રિન	ਵਜ੍ਰਿਨ
વજ્રેશ્વરી	ਵਜ੍ਰੇਸ਼੍ਵਰੀ
વનદેવ	ਵਨਦੇਵ
વનાની	ਵਨਾਨੀ
વયુનંદ	ਵਯੁਨੰਦ
વય્યા	ਵਯ੍ਯਾ
વરજોત્તામાં	ਵਰਜੋਤ੍ਤਾਮਾਂ
વરદરાજ	ਵਰਦਰਾਜ
વરદાન	ਵਰਦਾਨ
વરપ્રદા	ਵਰਪ੍ਰਦਾ
વરલક્ષ્મી	ਵਰਲਕ੍ਸ਼੍ਮੀ
વરિયાસ	ਵਰਿਯਾਸ
વર્ધીન	ਵਰ੍ਧੀਨ
વર્શિની	ਵਰ੍ਸ਼ਿਨੀ
વલાવન	ਵਲਾਵਨ
વલ્લભ	ਵਲ੍ਲਭ
વશીતા	ਵਸ਼ੀਤਾ
વસંતા	ਵਸੰਤਾ
વસતીન	ਵਸਤੀਨ
વસવી	ਵਸਵੀ
વસુલ	ਵਸੁਲ
વાક્પતિ	ਵਾਕ੍ਪਤਿ
વાચસ્પતિ	ਵਾਚਸ੍ਪਤਿ
વાચ્ય	ਵਾਚ੍ਯ
વાજ્રહાસ્તા	ਵਾਜ੍ਰਹਾਸ੍ਤਾ
વાનામાલી	ਵਾਨਾਮਾਲੀ
વાનાવારાયણ	ਵਾਨਾਵਾਰਾਯਣ
વાનૈપકા-વેરીન્દોન	ਵਾਨੈਪਕਾ-ਵੇਰੀਨ੍ਦੋਨ
વામન	ਵਾਮਨ
વામાંનીએ	ਵਾਮਾਂਨੀਏ
વાર	ਵਾਰ
વાલકય	ਵਾਲਕਯ
વાલી	ਵਾਲੀ
વાસંતાપ્રભા	ਵਾਸੰਤਾਪ੍ਰਭਾ
વાસુકી	ਵਾਸੁਕੀ
વાસુમાંથા	ਵਾਸੁਮਾਂਥਾ
વિઅર	ਵਿਅਰ
વિકાસીની	ਵਿਕਾਸੀਨੀ
વિકાસ્ની	ਵਿਕਾਸ੍ਨੀ
વિક્ષિત	ਵਿਕ੍ਸ਼ਿਤ
વિદ્વાથ	ਵਿਦ੍ਵਾਥ
વિધિ	ਵਿਧਿ
વિનતા	ਵਿਨਤਾ
વિબુષા	ਵਿਬੁਸ਼ਾ
વિભાવા	ਵਿਭਾਵਾ
વિમલા	ਵਿਮਲਾ
વિરબાહુ	ਵਿਰਬਾਹੁ
વિલાસિની	ਵਿਲਾਸਿਨੀ
વીક્ષા	ਵੀਕ੍ਸ਼ਾ
વીચિકા	ਵੀਚਿਕਾ
વીજીલા	ਵੀਜੀਲਾ
વીની	ਵੀਨੀ
વીમા	ਵੀਮਾ
વીરોત્તમ	ਵੀਰੋਤ੍ਤਮ
વેક્રાંત	ਵੇਕ੍ਰਾਂਤ
વેગવાહીની	ਵੇਗਵਾਹੀਨੀ
વેણુગોપાલ	ਵੇਣੁਗੋਪਾਲ
વેત્રિવાલ	ਵੇਤ੍ਰਿਵਾਲ
વેદાંશી	ਵੇਦਾਂਸ਼ੀ
વેદાત્મન	ਵੇਦਾਤ੍ਮਨ
વેદાત્મને	ਵੇਦਾਤ੍ਮਨੇ
વેદાર્થ	ਵੇਦਾਰ੍ਥ
વેદીષ	ਵੇਦੀਸ਼
વેધા	ਵੇਧਾ
વેધાસ	ਵੇਧਾਸ
વેધીકા	ਵੇਧੀਕਾ
વેનાહ	ਵੇਨਾਹ
વેનીધર	ਵੇਨੀਧਰ
વેન્કાત્શીવા	ਵੇਨ੍ਕਾਤ੍ਸ਼ੀਵਾ
વેન્નેલા	ਵੇਨ੍ਨੇਲਾ
વેલુ	ਵੇਲੁ
વેવેશા	ਵੇਵੇਸ਼ਾ
વૈજનાથ	ਵੈਜਨਾਥ
વૈદાહી	ਵੈਦਾਹੀ
વૈદ્યનાથ	ਵੈਦ੍ਯਨਾਥ
વૈધે	ਵੈਧੇ
વૈનાવિન	ਵੈਨਾਵਿਨ
વૈશાકા	ਵੈਸ਼ਾਕਾ
વૈશાખી	ਵੈਸ਼ਾਖੀ
વૈશાલી	ਵੈਸ਼ਾਲੀ
વૈશ્વિક	ਵੈਸ਼੍ਵਿਕ
વૈષ્ણવી	ਵੈਸ਼੍ਣਵੀ
વૈસાખી	ਵੈਸਾਖੀ
સંચાલી	ਸੰਚਾਲੀ
સંજય	ਸੰਜਯ
સંજીથા	ਸੰਜੀਥਾ
સંજુકતા	ਸੰਜੁਕਤਾ
સંતવાના	ਸੰਤਵਾਨਾ
સંદીતી	ਸੰਦੀਤੀ
સંદીપન	ਸੰਦੀਪਨ
સંભાવના	ਸੰਭਾਵਨਾ
સંયક્તા	ਸੰਯਕ੍ਤਾ
સંવિકા	ਸੰਵਿਕਾ
સંસ્કૃતિ	ਸੰਸ੍ਕਤਿ
સંસ્કૃતી	ਸੰਸ੍ਕਤੀ
સકલ	ਸਕਲ
સક્તીવેલ	ਸਕ੍ਤੀਵੇਲ
સક્શિક	ਸਕ੍ਸ਼ਿਕ
સક્શીન્યા	ਸਕ੍ਸ਼ੀਨ੍ਯਾ
સક્ષમ	ਸਕ੍ਸ਼ਮ
સચંદ્ર	ਸਚੰਦ੍ਰ
સજૂ	ਸਜੂ
સદગુરૂ	ਸਦਗੁਰੂ
સદબિંદુ	ਸਦਬਿਂਦੁ
સદરુ	ਸਦਰੁ
સદા શિવમ	ਸਦਾ ਸ਼ਿਵਮ
સદાશિવ	ਸਦਾਸ਼ਿਵ
સદિવા	ਸਦਿਵਾ
સદ્વિખા	ਸਦ੍ਵਿਖਾ
સનવ	ਸਨਵ
સનીલ	ਸਨੀਲ
સનેશ	ਸਨੇਸ਼
સનૈતા	ਸਨੈਤਾ
સપર્ણા	ਸਪਰ੍ਣਾ
સપુષ્પા	ਸਪੁਸ਼੍ਪਾ
સપ્તોર્શી	ਸਪ੍ਤੋਰ੍ਸ਼ੀ
સબરીનાથાન	ਸਬਰੀਨਾਥਾਨ
સભ્રાંત	ਸਭ੍ਰਾਂਤ
સમન્યુ	ਸਮਨ੍ਯੁ
સમબરણ	ਸਮਬਰਣ
સમભ્દ્ધા	ਸਮਭ੍ਦ੍ਧਾ
સમય	ਸਮਯ
સમરવીર	ਸਮਰਵੀਰ
સમાંર્ધ	ਸਮਾਂਰ੍ਧ
સમાધાન	ਸਮਾਧਾਨ
સમિયા	ਸਮਿਯਾ
સમીક્ક્સા	ਸਮੀਕ੍ਕ੍ਸਾ
સમીક્ષા	ਸਮੀਕ੍ਸ਼ਾ
સમ્બુદ્ધા	ਸਮ੍ਬੁਦ੍ਧਾ
સમ્યનાતન	ਸਮ੍ਯਨਾਤਨ
સમ્રીધ	ਸਮ੍ਰੀਧ
સમ્હીઠા	ਸਮ੍ਹੀਠਾ
સરલા	ਸਰਲਾ
સર્જના	ਸਰ੍ਜਨਾ
સહલાદ	ਸਹਲਾਦ
સહસ્ત્રજિત	ਸਹਸ੍ਤ੍ਰਜਿਤ
સહસ્વીની	ਸਹਸ੍ਵੀਨੀ
સહુરી	ਸਹੁਰੀ
સહૃદય	ਸਹਦਯ
સહેજ	ਸਹੇਜ
સહોજ	ਸਹੋਜ
સહ્ય	ਸਹ੍ਯ
સાંદીપની	ਸਾਂਦੀਪਨੀ
સાઈ અમર્ત્ય	ਸਾਈ ਅਮਰ੍ਤ੍ਯ
સાઈ કાર્તિક	ਸਾਈ ਕਾਰ੍ਤਿਕ
સાઈ દાસ	ਸਾਈ ਦਾਸ
સાઈ સુરિયા	ਸਾਈ ਸੁਰਿਯਾ
સાતેજ	ਸਾਤੇਜ
સાદ્રીશી	ਸਾਦ੍ਰੀਸ਼ੀ
સાધકા	ਸਾਧਕਾ
સાધન	ਸਾਧਨ
સાનંદના	ਸਾਨੰਦਨਾ
સાનવી તારીતા	ਸਾਨਵੀ ਤਾਰੀਤਾ
સાનાવી	ਸਾਨਾਵੀ
સાન્વી	ਸਾਨ੍ਵੀ
સાફલ્ય	ਸਾਫਲ੍ਯ
સાબી	ਸਾਬੀ
સામલી	ਸਾਮਲੀ
સામાન	ਸਾਮਾਨ
સારંગી	ਸਾਰੰਗੀ
સારસ	ਸਾਰਸ
સારાવતી	ਸਾਰਾਵਤੀ
સાલીની	ਸਾਲੀਨੀ
સાહસ્રપાત	ਸਾਹਸ੍ਰਪਾਤ
સાહુલ	ਸਾਹੁਲ
સેન્ડી	ਸੇਨ੍ਡੀ
સૈનિ	ਸੈਨਿ
સૈનું	ਸੈਨੁਂ
સૈય્યન	ਸੈਯ੍ਯਨ
સૈલેન્દ્ર	ਸੈਲੇਨ੍ਦ੍ਰ
સૈશા	ਸੈਸ਼ਾ
હંસરાજ	ਹੰਸਰਾਜ
હંસાવાથ્ય	ਹੰਸਾਵਾਥ੍ਯ
હંસિન	ਹੰਸਿਨ
હંસીની	ਹੰਸੀਨੀ
હઝેલ	ਹਝੇਲ
હનસીકા	ਹਨਸੀਕਾ
હનાર્વીન	ਹਨਾਰ੍ਵੀਨ
હનુમાન	ਹਨੁਮਾਨ
હમૃથા	ਹਮਥਾ
હમ્સિની	ਹਮ੍ਸਿਨੀ
હરશું	ਹਰਸ਼ੁਂ
હરા	ਹਰਾ
હરિઅક્સા	ਹਰਿਅਕ੍ਸਾ
હરિકિશન	ਹਰਿਕਿਸ਼ਨ
હરિદા	ਹਰਿਦਾ
હરિનાક્ષી	ਹਰਿਨਾਕ੍ਸ਼ੀ
હરિમંતી	ਹਰਿਮੰਤੀ
હરી	ਹਰੀ
હરી કિશન	ਹਰੀ ਕਿਸ਼ਨ
હરીકરણ	ਹਰੀਕਰਣ
હરીદર્પા	ਹਰੀਦਰ੍ਪਾ
હરીદાસાપ્રિયા	ਹਰੀਦਾਸਾਪ੍ਰਿਯਾ
હરીદીપ	ਹਰੀਦੀਪ
હરીધામ	ਹਰੀਧਾਮ
હરીવલ્લભ	ਹਰੀਵਲ੍ਲਭ
હરીશ્વ	ਹਰੀਸ਼੍ਵ
હર્લીના	ਹਰ੍ਲੀਨਾ
હર્શાશ્રી	ਹਰ੍ਸ਼ਾਸ਼੍ਰੀ
હર્શિક	ਹਰ੍ਸ਼ਿਕ
હર્ષ વીર	ਹਰ੍ਸ਼ ਵੀਰ
હર્ષિતા	ਹਰ੍ਸ਼ਿਤਾ
હર્સ્વીતા	ਹਰ੍ਸ੍ਵੀਤਾ
હલેય	ਹਲੇਯ
હવીસા	ਹਵੀਸਾ
હશન	ਹਸ਼ਨ
હસીક	ਹਸੀਕ
હસીથા	ਹਸੀਥਾ
હસ્મીથા	ਹਸ੍ਮੀਥਾ
હાકેશ	ਹਾਕੇਸ਼
હાનીકા	ਹਾਨੀਕਾ
હાર્શીની	ਹਾਰ੍ਸ਼ੀਨੀ
હાહન	ਹਾਹਨ
હિડિંબા	ਹਿਡਿਂਬਾ
હિતાંશી	ਹਿਤਾਂਸ਼ੀ
હિતેક્ષા	ਹਿਤੇਕ੍ਸ਼ਾ
હિતેન્દ્ર	ਹਿਤੇਨ੍ਦ੍ਰ
હિનલ	ਹਿਨਲ
હિનેશ	ਹਿਨੇਸ਼
હિમાકાર	ਹਿਮਾਕਾਰ
હિમાઘ્ના	ਹਿਮਾਘ੍ਨਾ
હિમાલ	ਹਿਮਾਲ
હિશા	ਹਿਸ਼ਾ
હિશેતા	ਹਿਸ਼ੇਤਾ
હીમીર	ਹੀਮੀਰ
હીરકની	ਹੀਰਕਨੀ
હીરાન્યાપ્પા	ਹੀਰਾਨ੍ਯਾਪ੍ਪਾ
હીર્નાક્ષી	ਹੀਰ੍ਨਾਕ੍ਸ਼ੀ
હીલ્લેય	ਹੀਲ੍ਲੇਯ
હુમીશા	ਹੁਮੀਸ਼ਾ
હુમૈલા	ਹੁਮੈਲਾ
હેઇઅન	ਹੇਇਅਨ
હેત	ਹੇਤ
હેતની	ਹੇਤਨੀ
હેતવ	ਹੇਤਵ
હેત્વિક	ਹੇਤ੍ਵਿਕ
હેમંત	ਹੇਮੰਤ
હેમદેવ	ਹੇਮਦੇਵ
હેમલતા	ਹੇਮਲਤਾ
હેમા	ਹੇਮਾ
હેમાઁગી	ਹੇਮਾਁਗੀ
હેમાંગા	ਹੇਮਾਂਗਾ
હેમાકેશ	ਹੇਮਾਕੇਸ਼
હેમાલા	ਹੇਮਾਲਾ
હેમાલી	ਹੇਮਾਲੀ
હેમાવતી	ਹੇਮਾਵਤੀ
હેમીતા	ਹੇਮੀਤਾ
હેયન	ਹੇਯਨ
હેશીકા	ਹੇਸ਼ੀਕਾ
હોનહાર	ਹੋਨਹਾਰ
હ્રિથિક	ਹ੍ਰਿਥਿਕ
હ્રીત્વિકા	ਹ੍ਰੀਤ੍ਵਿਕਾ
હ્રીદાન	ਹ੍ਰੀਦਾਨ
હ્રીવાન	ਹ੍ਰੀਵਾਨ
હ્રીશાંત	ਹ੍ਰੀਸ਼ਾਂਤ
હ્રીશાબ	ਹ੍ਰੀਸ਼ਾਬ
હ્રીશુલ	ਹ੍ਰੀਸ਼ੁਲ
હ્રુધાઈ	ਹ੍ਰੁਧਾਈ
#
#
# Territory names from CLDR
એસેન્શન આઇલેન્ડ	ਏਸੇਨ੍ਸ਼ਨ ਆਇਲੇਨ੍ਡ
ઍંડોરા	ਏਂਡੋਰਾ
યુનાઇટેડ આરબ અમીરાત	ਯੁਨਾਇਟੇਡ ਆਰਬ ਅਮੀਰਾਤ
અફઘાનિસ્તાન	ਅਫਘਾਨਿਸ੍ਤਾਨ
એન્ટીગુઆ અને બર્મુડા	ਏਨ੍ਟੀਗੁਆ ਅਨੇ ਬਰ੍ਮੁਡਾ
ઍંગ્વિલા	ਏਂਗ੍ਵਿਲਾ
અલ્બેનિયા	ਅਲ੍ਬੇਨਿਯਾ
આર્મેનિયા	ਆਰ੍ਮੇਨਿਯਾ
અંગોલા	ਅਂਗੋਲਾ
એન્ટાર્કટિકા	ਏਨ੍ਟਾਰ੍ਕਟਿਕਾ
આર્જેન્ટીના	ਆਰ੍ਜੇਨ੍ਟੀਨਾ
અમેરીકન સમોઆ	ਅਮੇਰੀਕਨ ਸਮੋਆ
ઑસ્ટ્રિયા	ਓਸ੍ਟ੍ਰਿਯਾ
ઑસ્ટ્રેલિયા	ਓਸ੍ਟ੍ਰੇਲਿਯਾ
અરુબા	ਅਰੁਬਾ
એલેંડ ટાપુઓ	ਏਲੇਂਡ ਟਾਪੁਓ
અઝરબૈજાન	ਅਝਰਬੈਜਾਨ
બોસ્નિયા અને હર્ઝેગોવિના	ਬੋਸ੍ਨਿਯਾ ਅਨੇ ਹਰ੍ਝੇਗੋਵਿਨਾ
બાર્બાડોસ	ਬਾਰ੍ਬਾਡੋਸ
બાંગ્લાદેશ	ਬਾਂਗ੍ਲਾਦੇਸ਼
બેલ્જીયમ	ਬੇਲ੍ਜੀਯਮ
બુર્કિના ફાસો	ਬੁਰ੍ਕਿਨਾ ਫਾਸੋ
બલ્ગેરિયા	ਬਲ੍ਗੇਰਿਯਾ
બેહરીન	ਬੇਹਰੀਨ
બુરુંડી	ਬੁਰੁਂਡੀ
બેનિન	ਬੇਨਿਨ
સેન્ટ બાર્થેલેમી	ਸੇਨ੍ਟ ਬਾਰ੍ਥੇਲੇਮੀ
બર્મુડા	ਬਰ੍ਮੁਡਾ
બ્રુનેઇ	ਬ੍ਰੁਨੇਇ
બોલિવિયા	ਬੋਲਿਵਿਯਾ
કેરેબિયન નેધરલેન્ડ્ઝ	ਕੇਰੇਬਿਯਨ ਨੇਧਰਲੇਨ੍ਡ੍ਝ
બ્રાઝિલ	ਬ੍ਰਾਝਿਲ
બહામાસ	ਬਹਾਮਾਸ
ભૂટાન	ਭੂਟਾਨ
બૌવેત આઇલેન્ડ	ਬੌਵੇਤ ਆਇਲੇਨ੍ਡ
બોત્સ્વાના	ਬੋਤ੍ਸ੍ਵਾਨਾ
બેલારુસ	ਬੇਲਾਰੁਸ
બેલીઝ	ਬੇਲੀਝ
કેનેડા	ਕੇਨੇਡਾ
કોકોઝ (કીલીંગ) આઇલેન્ડ્સ	ਕੋਕੋਝ (ਕੀਲੀਂਗ) ਆਇਲੇਨ੍ਡ੍ਸ
કોંગો - કિંશાસા	ਕੋਂਗੋ - ਕਿਂਸ਼ਾਸਾ
કોંગો (ડીઆરસી)	ਕੋਂਗੋ (ਡੀਆਰਸੀ)
સેન્ટ્રલ આફ્રિકન રીપબ્લિક	ਸੇਨ੍ਟ੍ਰਲ ਆਫ੍ਰਿਕਨ ਰੀਪਬ੍ਲਿਕ
કોંગો - બ્રાઝાવિલે	ਕੋਂਗੋ - ਬ੍ਰਾਝਾਵਿਲੇ
કોંગો (પ્રજાસત્તાક)	ਕੋਂਗੋ (ਪ੍ਰਜਾਸਤ੍ਤਾਕ)
સ્વિટ્ઝર્લૅન્ડ	ਸ੍ਵਿਟ੍ਝਰ੍ਲੈਨ੍ਡ
કોટ ડી આઇવરી	ਕੋਟ ਡੀ ਆਇਵਰੀ
આઇવરી કોસ્ટ	ਆਇਵਰੀ ਕੋਸ੍ਟ
કુક આઇલેન્ડ્સ	ਕੁਕ ਆਇਲੇਨ੍ਡ੍ਸ
ચિલી	ਚਿਲੀ
કૅમરૂન	ਕੈਮਰੂਨ
ચીન	ਚੀਨ
કોલમ્બિયા	ਕੋਲਮ੍ਬਿਯਾ
ક્લિપરટન આઇલેન્ડ	ਕ੍ਲਿਪਰਟਨ ਆਇਲੇਨ੍ਡ
કોસ્ટા રિકા	ਕੋਸ੍ਟਾ ਰਿਕਾ
ક્યુબા	ਕ੍ਯੁਬਾ
કૅપ વર્ડે	ਕੈਪ ਵਰ੍ਡੇ
કુરાકાઓ	ਕੁਰਾਕਾਓ
ક્રિસમસ આઇલેન્ડ	ਕ੍ਰਿਸਮਸ ਆਇਲੇਨ੍ਡ
સાયપ્રસ	ਸਾਯਪ੍ਰਸ
ચેક રીપબ્લિક	ਚੇਕ ਰੀਪਬ੍ਲਿਕ
જર્મની	ਜਰ੍ਮਨੀ
ડિએગો ગારસિઆ	ਡਿਏਗੋ ਗਾਰਸਿਆ
જીબૌટી	ਜੀਬੌਟੀ
ડેનમાર્ક	ਡੇਨਮਾਰ੍ਕ
ડોમિનિકા	ਡੋਮਿਨਿਕਾ
ડોમિનિકન રીપબ્લિક	ਡੋਮਿਨਿਕਨ ਰੀਪਬ੍ਲਿਕ
અલ્જીરિયા	ਅਲ੍ਜੀਰਿਯਾ
સ્યુટા અને મેલિલા	ਸ੍ਯੁਟਾ ਅਨੇ ਮੇਲਿਲਾ
એક્વાડોર	ਏਕ੍ਵਾਡੋਰ
એસ્ટોનિયા	ਏਸ੍ਟੋਨਿਯਾ
ઇજિપ્ત	ਇਜਿਪ੍ਤ
પશ્ચિમી સહારા	ਪਸ਼੍ਚਿਮੀ ਸਹਾਰਾ
એરિટ્રિયા	ਏਰਿਟ੍ਰਿਯਾ
સ્પેન	ਸ੍ਪੇਨ
ઇથિઓપિયા	ਇਥਿਓਪਿਯਾ
યુરોપિયન સંઘ	ਯੁਰੋਪਿਯਨ ਸੰਘ
ફિનલેન્ડ	ਫਿਨਲੇਨ੍ਡ
ફીજી	ਫੀਜੀ
ફૉકલેન્ડ ટાપુઓ	ਫੌਕਲੇਨ੍ਡ ਟਾਪੁਓ
ફૉકલેન્ડ ટાપુઓ (ઇસ્લાસ માલવિનસ)	ਫੌਕਲੇਨ੍ਡ ਟਾਪੁਓ (ਇਸ੍ਲਾਸ ਮਾਲਵਿਨਸ)
માઇક્રોનેશિયા	ਮਾਇਕ੍ਰੋਨੇਸ਼ਿਯਾ
ફૅરો ટાપુઓ	ਫੈਰੋ ਟਾਪੁਓ
ફ્રાંસ	ਫ੍ਰਾਂਸ
ગેબન	ਗੇਬਨ
યુનાઇટેડ કિંગડમ	ਯੁਨਾਇਟੇਡ ਕਿਂਗਡਮ
ગ્રેનેડા	ਗ੍ਰੇਨੇਡਾ
જ્યોર્જીયા	ਜ੍ਯੋਰ੍ਜੀਯਾ
ફ્રેંચ ગયાના	ਫ੍ਰੇਂਚ ਗਯਾਨਾ
ગ્વેર્નસે	ਗ੍ਵੇਰ੍ਨਸੇ
ઘાના	ਘਾਨਾ
જીબ્રાલ્ટર	ਜੀਬ੍ਰਾਲ੍ਟਰ
ગ્રીનલેન્ડ	ਗ੍ਰੀਨਲੇਨ੍ਡ
ગેમ્બિયા	ਗੇਮ੍ਬਿਯਾ
ગિની	ਗਿਨੀ
ગ્વાડેલોપ	ਗ੍ਵਾਡੇਲੋਪ
ઇક્વેટોરિયલ ગિની	ਇਕ੍ਵੇਟੋਰਿਯਲ ਗਿਨੀ
ગ્રીસ	ਗ੍ਰੀਸ
દક્ષિણ જ્યોર્જીયા અને દક્ષિણ સેન્ડવિચ આઇલેન્ડ્સ	ਦਕ੍ਸ਼ਿਣ ਜ੍ਯੋਰ੍ਜੀਯਾ ਅਨੇ ਦਕ੍ਸ਼ਿਣ ਸੇਨ੍ਡਵਿਚ ਆਇਲੇਨ੍ਡ੍ਸ
ગ્વાટેમાલા	ਗ੍ਵਾਟੇਮਾਲਾ
ગ્વામ	ਗ੍ਵਾਮ
ગિની-બિસાઉ	ਗਿਨੀ-ਬਿਸਾਉ
ગયાના	ਗਯਾਨਾ
હોંગકોંગ SAR ચીન	ਹੋਂਗਕੋਂਗ SAR ਚੀਨ
હોંગ કોંગ	ਹੋਂਗ ਕੋਂਗ
હર્ડ અને મેકડોનાલ્ડ આઇલેન્ડ્સ	ਹਰ੍ਡ ਅਨੇ ਮੇਕਡੋਨਾਲ੍ਡ ਆਇਲੇਨ੍ਡ੍ਸ
હોન્ડુરસ	ਹੋਨ੍ਡੁਰਸ
ક્રોએશિયા	ਕ੍ਰੋਏਸ਼ਿਯਾ
હૈતિ	ਹੈਤਿ
હંગેરી	ਹੰਗੇਰੀ
કૅનેરી ટાપુઓ	ਕੈਨੇਰੀ ਟਾਪੁਓ
ઇન્ડોનેશિયા	ਇਨ੍ਡੋਨੇਸ਼ਿਯਾ
આયર્લેન્ડ	ਆਯਰ੍ਲੇਨ੍ਡ
ઇઝરાઇલ	ਇਝਰਾਇਲ
આઈલ ઓફ મૅન	ਆਈਲ ਓਫ ਮੈਨ
ભારત	ਭਾਰਤ
બ્રિટિશ ઇન્ડિયન ઓશન ટેરિટરી	ਬ੍ਰਿਟਿਸ਼ ਇਨ੍ਡਿਯਨ ਓਸ਼ਨ ਟੇਰਿਟਰੀ
ઇરાક	ਇਰਾਕ
ઈરાન	ਈਰਾਨ
આઇસલેન્ડ	ਆਇਸਲੇਨ੍ਡ
ઇટાલી	ਇਟਾਲੀ
જર્સી	ਜਰ੍ਸੀ
જમૈકા	ਜਮੈਕਾ
જોર્ડન	ਜੋਰ੍ਡਨ
જાપાન	ਜਾਪਾਨ
કેન્યા	ਕੇਨ੍ਯਾ
કિર્ગિઝ્સ્તાન	ਕਿਰ੍ਗਿਝ੍ਸ੍ਤਾਨ
કંબોડિયા	ਕੰਬੋਡਿਯਾ
કિરિબાટી	ਕਿਰਿਬਾਟੀ
કોમોરસ	ਕੋਮੋਰਸ
સેન્ટ કિટ્સ અને નેવિસ	ਸੇਨ੍ਟ ਕਿਟ੍ਸ ਅਨੇ ਨੇਵਿਸ
ઉત્તર કોરિયા	ਉਤ੍ਤਰ ਕੋਰਿਯਾ
દક્ષિણ કોરિયા	ਦਕ੍ਸ਼ਿਣ ਕੋਰਿਯਾ
કુવૈત	ਕੁਵੈਤ
કેમેન ટાપુઓ	ਕੇਮੇਨ ਟਾਪੁਓ
કઝાકિસ્તાન	ਕਝਾਕਿਸ੍ਤਾਨ
લાઓસ	ਲਾਓਸ
લેબનોન	ਲੇਬਨੋਨ
સેન્ટ લુસિયા	ਸੇਨ੍ਟ ਲੁਸਿਯਾ
લૈચટેંસ્ટેઇન	ਲੈਚਟੇਂਸ੍ਟੇਇਨ
શ્રીલંકા	ਸ਼੍ਰੀਲੰਕਾ
લાઇબેરિયા	ਲਾਇਬੇਰਿਯਾ
લેસોથો	ਲੇਸੋਥੋ
લિથુઆનિયા	ਲਿਥੁਆਨਿਯਾ
લક્ઝમબર્ગ	ਲਕ੍ਝਮਬਰ੍ਗ
લાત્વિયા	ਲਾਤ੍ਵਿਯਾ
લિબિયા	ਲਿਬਿਯਾ
મોરોક્કો	ਮੋਰੋਕ੍ਕੋ
મોનાકો	ਮੋਨਾਕੋ
મોલડોવા	ਮੋਲਡੋਵਾ
મૉન્ટેંનેગ્રો	ਮੌਨ੍ਟੇਂਨੇਗ੍ਰੋ
સેન્ટ માર્ટિન	ਸੇਨ੍ਟ ਮਾਰ੍ਟਿਨ
મેડાગાસ્કર	ਮੇਡਾਗਾਸ੍ਕਰ
માર્શલ આઇલેન્ડ્સ	ਮਾਰ੍ਸ਼ਲ ਆਇਲੇਨ੍ਡ੍ਸ
મેસેડોનિયા	ਮੇਸੇਡੋਨਿਯਾ
મેસેડોનિયા (FYROM)	ਮੇਸੇਡੋਨਿਯਾ (FYROM)
માલી	ਮਾਲੀ
મ્યાંમાર (બર્મા)	ਮ੍ਯਾਂਮਾਰ (ਬਰ੍ਮਾ)
મંગોલિયા	ਮੰਗੋਲਿਯਾ
મકાઉ SAR ચીન	ਮਕਾਉ SAR ਚੀਨ
મકાઉ	ਮਕਾਉ
ઉત્તરીય મારિયાના આઇલેન્ડ્સ	ਉਤ੍ਤਰੀਯ ਮਾਰਿਯਾਨਾ ਆਇਲੇਨ੍ਡ੍ਸ
માર્ટીનીક	ਮਾਰ੍ਟੀਨੀਕ
મૌરિટાનિયા	ਮੌਰਿਟਾਨਿਯਾ
મોંટસેરાત	ਮੋਂਟਸੇਰਾਤ
માલ્ટા	ਮਾਲ੍ਟਾ
મોરિશિયસ	ਮੋਰਿਸ਼ਿਯਸ
માલદિવ્સ	ਮਾਲਦਿਵ੍ਸ
માલાવી	ਮਾਲਾਵੀ
મેક્સિકો	ਮੇਕ੍ਸਿਕੋ
મલેશિયા	ਮਲੇਸ਼ਿਯਾ
મોઝામ્બિક	ਮੋਝਾਮ੍ਬਿਕ
નામિબિયા	ਨਾਮਿਬਿਯਾ
ન્યુ સેલેડોનિયા	ਨ੍ਯੁ ਸੇਲੇਡੋਨਿਯਾ
નાઇજર	ਨਾਇਜਰ
નોરફૉક ટાપુ	ਨੋਰਫੌਕ ਟਾਪੁ
નાઇજીરીયા	ਨਾਇਜੀਰੀਯਾ
નિકારાગુઆ	ਨਿਕਾਰਾਗੁਆ
નેધરલેન્ડ	ਨੇਧਰਲੇਨ੍ਡ
નૉર્વે	ਨੌਰ੍ਵੇ
નેપાળ	ਨੇਪਾਲ
નૌરુ	ਨੌਰੁ
નીયુ	ਨੀਯੁ
ન્યુઝીલેન્ડ	ਨ੍ਯੁਝੀਲੇਨ੍ਡ
ઓમાન	ਓਮਾਨ
પનામા	ਪਨਾਮਾ
પેરુ	ਪੇਰੁ
ફ્રેંચ પોલિનેશિયા	ਫ੍ਰੇਂਚ ਪੋਲਿਨੇਸ਼ਿਯਾ
પાપુઆ ન્યૂ ગિની	ਪਾਪੁਆ ਨ੍ਯੂ ਗਿਨੀ
ફિલીપાઇન્સ	ਫਿਲੀਪਾਇਨ੍ਸ
પાકિસ્તાન	ਪਾਕਿਸ੍ਤਾਨ
પોલેંડ	ਪੋਲੇਂਡ
સેન્ટ પિયર અને મીક્વેલન	ਸੇਨ੍ਟ ਪਿਯਰ ਅਨੇ ਮੀਕ੍ਵੇਲਨ
પીટકૈર્ન આઇલેન્ડ્સ	ਪੀਟਕੈਰ੍ਨ ਆਇਲੇਨ੍ਡ੍ਸ
પ્યુઅર્ટો રિકો	ਪ੍ਯੁਅਰ੍ਟੋ ਰਿਕੋ
પેલેસ્ટિનિયન ટેરિટરી	ਪੇਲੇਸ੍ਟਿਨਿਯਨ ਟੇਰਿਟਰੀ
પેલેસ્ટાઇન	ਪੇਲੇਸ੍ਟਾਇਨ
પોર્ટુગલ	ਪੋਰ੍ਟੁਗਲ
પલાઉ	ਪਲਾਉ
પેરાગ્વે	ਪੇਰਾਗ੍ਵੇ
કતાર	ਕਤਾਰ
આઉટલાઈન્ગ ઓશનિયા	ਆਉਟਲਾਈਨ੍ਗ ਓਸ਼ਨਿਯਾ
રીયુનિયન	ਰੀਯੁਨਿਯਨ
રોમાનિયા	ਰੋਮਾਨਿਯਾ
સર્બિયા	ਸਰ੍ਬਿਯਾ
રશિયા	ਰਸ਼ਿਯਾ
રવાંડા	ਰਵਾਂਡਾ
સાઉદી અરેબિયા	ਸਾਉਦੀ ਅਰੇਬਿਯਾ
સોલોમન આઇલેન્ડ્સ	ਸੋਲੋਮਨ ਆਇਲੇਨ੍ਡ੍ਸ
સેશેલ્સ	ਸੇਸ਼ੇਲ੍ਸ
સુદાન	ਸੁਦਾਨ
સ્વીડન	ਸ੍ਵੀਡਨ
સિંગાપુર	ਸਿਂਗਾਪੁਰ
સેન્ટ હેલેના	ਸੇਨ੍ਟ ਹੇਲੇਨਾ
સ્લોવેનિયા	ਸ੍ਲੋਵੇਨਿਯਾ
સ્વાલબર્ડ અને જેન મેયન	ਸ੍ਵਾਲਬਰ੍ਡ ਅਨੇ ਜੇਨ ਮੇਯਨ
સ્લોવેકિયા	ਸ੍ਲੋਵੇਕਿਯਾ
સીએરા લેઓન	ਸੀਏਰਾ ਲੇਓਨ
સૅન મેરિનો	ਸੈਨ ਮੇਰਿਨੋ
સેનેગલ	ਸੇਨੇਗਲ
સોમાલિયા	ਸੋਮਾਲਿਯਾ
સુરીનામ	ਸੁਰੀਨਾਮ
દક્ષિણ સુદાન	ਦਕ੍ਸ਼ਿਣ ਸੁਦਾਨ
સાઓ ટૉમ અને પ્રિંસિપે	ਸਾਓ ਟੌਮ ਅਨੇ ਪ੍ਰਿਂਸਿਪੇ
એલ સેલ્વાડોર	ਏਲ ਸੇਲ੍ਵਾਡੋਰ
સિંટ માર્ટેન	ਸਿਂਟ ਮਾਰ੍ਟੇਨ
સીરિયા	ਸੀਰਿਯਾ
સ્વાઝિલેન્ડ	ਸ੍ਵਾਝਿਲੇਨ੍ਡ
ત્રિસ્તાન દા કુન્હા	ਤ੍ਰਿਸ੍ਤਾਨ ਦਾ ਕੁਨ੍ਹਾ
તુર્ક્સ અને કાઇકોસ ટાપુઓ	ਤੁਰ੍ਕ੍ਸ ਅਨੇ ਕਾਇਕੋਸ ਟਾਪੁਓ
ચાડ	ਚਾਡ
ફ્રેંચ સદર્ન ટેરિટરીઝ	ਫ੍ਰੇਂਚ ਸਦਰ੍ਨ ਟੇਰਿਟਰੀਝ
ટોગો	ਟੋਗੋ
થાઇલેંડ	ਥਾਇਲੇਂਡ
તાજીકિસ્તાન	ਤਾਜੀਕਿਸ੍ਤਾਨ
ટોકેલાઉ	ਟੋਕੇਲਾਉ
તિમોર-લેસ્તે	ਤਿਮੋਰ-ਲੇਸ੍ਤੇ
પૂર્વ તિમોર	ਪੂਰ੍ਵ ਤਿਮੋਰ
તુર્કમેનિસ્તાન	ਤੁਰ੍ਕਮੇਨਿਸ੍ਤਾਨ
ટ્યુનિશિયા	ਟ੍ਯੁਨਿਸ਼ਿਯਾ
ટોંગા	ਟੋਂਗਾ
તુર્કી	ਤੁਰ੍ਕੀ
ટ્રિનીદાદ અને ટોબેગો	ਟ੍ਰਿਨੀਦਾਦ ਅਨੇ ਟੋਬੇਗੋ
તુવાલુ	ਤੁਵਾਲੁ
તાઇવાન	ਤਾਇਵਾਨ
તાંઝાનિયા	ਤਾਂਝਾਨਿਯਾ
યુક્રેન	ਯੁਕ੍ਰੇਨ
યુગાંડા	ਯੁਗਾਂਡਾ
સંયુક્ત રાજ્ય આઉટલાઇંગ આયલેન્ડ્સ	ਸੰਯੁਕ੍ਤ ਰਾਜ੍ਯ ਆਉਟਲਾਇਂਗ ਆਯਲੇਨ੍ਡ੍ਸ
સંયુકત રાજ્ય અમેરિકા	ਸੰਯੁਕਤ ਰਾਜ੍ਯ ਅਮੇਰਿਕਾ
ઉરુગ્વે	ਉਰੁਗ੍ਵੇ
ઉઝ્બેકિસ્તાન	ਉਝ੍ਬੇਕਿਸ੍ਤਾਨ
વેટિકન સિટી	ਵੇਟਿਕਨ ਸਿਟੀ
સેન્ટ વિન્સેટ અને ગ્રેનેડીન્સ	ਸੇਨ੍ਟ ਵਿਨ੍ਸੇਟ ਅਨੇ ਗ੍ਰੇਨੇਡੀਨ੍ਸ
વેનેઝુએલા	ਵੇਨੇਝੁਏਲਾ
બ્રિટિશ વર્જિન ટાપુઓ	ਬ੍ਰਿਟਿਸ਼ ਵਰ੍ਜਿਨ ਟਾਪੁਓ
વિયેતનામ	ਵਿਯੇਤਨਾਮ
વાનુઆતુ	ਵਾਨੁਆਤੁ
વેલીસ અને ફ્યુટુના	ਵੇਲੀਸ ਅਨੇ ਫ੍ਯੁਟੁਨਾ
સમોઆ	ਸਮੋਆ
કોસોવો	ਕੋਸੋਵੋ
યેમેન	ਯੇਮੇਨ
મેયોટ	ਮੇਯੋਟ
દક્ષિણ આફ્રિકા	ਦਕ੍ਸ਼ਿਣ ਆਫ੍ਰਿਕਾ
ઝામ્બિયા	ਝਾਮ੍ਬਿਯਾ
ઝિમ્બાબ્વે	ਝਿਮ੍ਬਾਬ੍ਵੇ
અજ્ઞાત પ્રદેશ	ਅਜ੍ਞਾਤ ਪ੍ਰਦੇਸ਼
