# Baby names
અંશ	అంశ
અકન્ગ્ષા	అకన్గ్షా
અકશીની	అకశీనీ
અકસરા	అకసరా
અકાર્યસુતા	అకార్యసుతా
અકાલકા	అకాలకా
અકિતા	అకితా
અક્ષધા	అక్షధా
અક્ષ્યા	అక్ష్యా
અક્સા	అక్సా
અગ્નિશિખા	అగ్నిశిఖా
અગ્રીમા	అగ్రీమా
અચલેંદ્ર	అచలేంద్ర
અજન્તા	అజన్తా
અજમુખી	అజముఖీ
અજિયા	అజియా
અજીતા	అజీతా
અડ્યાદવૈતા	అడ్యాదవైతా
અદવૈકા	అదవైకా
અદિતરાજ	అదితరాజ
અદિત્યેશ	అదిత్యేశ
અદીતીયા	అదీతీయా
અદીરા	అదీరా
અદેન્ય	అదేన్య
અદ્રિતા	అద్రితా
અદ્રિતી	అద్రితీ
અદ્વય	అద్వయ
અદ્વિકા	అద్వికా
અદ્વેત	అద్వేత
અદ્વૈયા	అద్వైయా
અધીર	అధీర
અધીરતા	అధీరతా
અધ્યાત્મ	అధ్యాత్మ
અબિનય	అబినయ
અબિભવા	అబిభవా
અબીનાવ	అబీనావ
અબીશા	అబీశా
અબીસેશન	అబీసేశన
અબ્બીર	అబ్బీర
અભિજાત	అభిజాత
અભિજ્ઞાન	అభిజ్ఞాన
અભિનું	అభినుం
અભિપ્રિથિ	అభిప్రిథి
અભિમોદા	అభిమోదా
અભિરુચિ	అభిరుచి
અભિવાદન	అభివాదన
અભિસુમત	అభిసుమత
અભિસોકા	అభిసోకా
અભીકાંક્ષા	అభీకాంక్షా
અભીચંદ્ર	అభీచంద్ర
અભીજુન	అభీజున
અભીધર્મ	అభీధర్మ
અભીલેશ	అభీలేశ
અભુ	అభు
અભ્થા	అభ్థా
અભ્રકાસિન	అభ్రకాసిన
અરધ્યાય	అరధ్యాయ
અલંકારાપ્રિયા	అలంకారాప్రియా
અલંક્રિતા	అలంక్రితా
અહીના	అహీనా
આંદાલ	ఆందాల
આંશી	ఆంశీ
આએઇન્દ્રિ	ఆఏఇన్ద్రి
આકર્ષ	ఆకర్ష
આકાંક્ષ	ఆకాంక్ష
આકામ્પન	ఆకామ్పన
આકાશ	ఆకాశ
આકાશી	ఆకాశీ
આકેશ	ఆకేశ
આત્મજ	ఆత్మజ
આત્રયી	ఆత్రయీ
આદાવન	ఆదావన
આદિકવિ	ఆదికవి
આદિકેશ	ఆదికేశ
આદિતિય	ఆదితియ
આદિત્વ	ఆదిత్వ
આદિદેવ	ఆదిదేవ
આદિશ	ఆదిశ
આદિશંકર	ఆదిశంకర
આદિસેશ	ఆదిసేశ
આદીત્રી	ఆదీత్రీ
આદીલ	ఆదీల
આદ્યા	ఆద్యా
આનંદતા	ఆనందతా
આનાધીતા	ఆనాధీతా
આનુષ	ఆనుష
આમાંની	ఆమాంనీ
આયાતી	ఆయాతీ
આયુધ	ఆయుధ
આરવી	ఆరవీ
આરા	ఆరా
આરાડ્યા	ఆరాడ్యా
આરાધક	ఆరాధక
આરાધના	ఆరాధనా
આરુન્ય	ఆరున్య
આરુપા	ఆరుపా
આરોચન	ఆరోచన
આર્થ	ఆర్థ
આર્ય્થ્ય	ఆర్య్థ్య
આલય	ఆలయ
આલિશા	ఆలిశా
આલેઃયા	ఆలేఃయా
આલ્યા	ఆల్యా
આવાની	ఆవానీ
આવ્યા	ఆవ్యా
આશાલી	ఆశాలీ
આશીર્વાદ	ఆశీర్వాద
આસ્યા	ఆస్యా
આસ્વી	ఆస్వీ
આહ્નીક	ఆహ్నీక
ઇંદિરા	ఇందిరా
ઇંદિવર	ఇందివర
ઇંદુલેક્ષ	ఇందులేక్ష
ઇંદુશેખર	ఇందుశేఖర
ઇતિ	ఇతి
ઇતિશ્રી	ఇతిశ్రీ
ઇદિત્રી	ఇదిత్రీ
ઇનકી	ఇనకీ
ઇન્કિત	ఇన్కిత
ઇન્ગનામ	ఇన్గనామ
ઇન્દ્રતેજ	ఇన్ద్రతేజ
ઇન્દ્રન	ఇన్ద్రన
ઇન્દ્રેશ	ఇన్ద్రేశ
ઇભાન	ఇభాన
ઇભ્યા	ఇభ్యా
ઇયેનગર	ఇయేనగర
ઇલવરસન	ఇలవరసన
ઇલિસા	ఇలిసా
ઇવાન	ఇవాన
ઇશા	ఇశా
ઇશાયુ	ఇశాయు
ઇસાર	ఇసార
ઇસીરી	ఇసీరీ
ઈઝ્રીને	ఈఝ్రీనే
ઈનિઅવેલન	ఈనిఅవేలన
ઈનિયવન	ఈనియవన
ઈન્દુસ	ఈన్దుస
ઈરીશ	ఈరీశ
ઈલ્વિકા	ఈల్వికా
ઈશાંત	ఈశాంత
ઈશિત	ఈశిత
ઈશ્મીતા	ఈశ్మీతా
ઈશ્વ	ఈశ్వ
ઈસાઈ	ఈసాఈ
ઉજય	ఉజయ
ઉજાગર	ఉజాగర
ઉજાસ	ఉజాస
ઉજીત્ર	ఉజీత్ర
ઉજેન્દ્ર	ఉజేన్ద్ర
ઉજ્જાનિની	ఉజ్జానినీ
ઉજ્જ્વાલા	ఉజ్జ్వాలా
ઉત્કર્શ્રાજ	ఉత్కర్శ్రాజ
ઉત્કલ	ఉత్కల
ઉત્કલીતા	ఉత్కలీతా
ઉત્કશાના	ఉత్కశానా
ઉત્પત્તિ	ఉత్పత్తి
ઉત્પલ	ఉత్పల
ઉત્વિક	ఉత్విక
ઉત્સા	ఉత్సా
ઉથીશા	ఉథీశా
ઉદંત	ఉదంత
ઉદયાચલ	ఉదయాచల
ઉદરથી	ఉదరథీ
ઉદાર્શ	ఉదార్శ
ઉદેય	ఉదేయ
ઉદ્વંશ	ఉద్వంశ
ઉધાયારની	ఉధాయారనీ
ઉપજય	ఉపజయ
ઉપદા	ఉపదా
ઉપનાયિક	ఉపనాయిక
ઉપાગુપ્તા	ఉపాగుప్తా
ઉપેન્દ્રન	ఉపేన్ద్రన
ઉભય	ఉభయ
ઉમાંપુત્ર	ఉమాంపుత్ర
ઉમાપત્ય	ఉమాపత్య
ઉમિકા	ఉమికా
ઉમેશ	ఉమేశ
ઉરિશિલ્લા	ఉరిశిల్లా
ઉર્નીક	ఉర్నీక
ઉર્મિલ	ఉర్మిల
ઉર્મિલા	ఉర్మిలా
ઉર્મી	ఉర్మీ
ઉર્વીશા	ఉర్వీశా
ઉલ્લાસીથા	ఉల్లాసీథా
ઉસહાસ	ఉసహాస
ઉસ્લુંનન	ఉస్లుంనన
ઊર્જિત	ఊర్జిత
એઇલા	ఏఇలా
એકદંતન	ఏకదంతన
એકન્ષા	ఏకన్షా
એકાંશ	ఏకాంశ
એકાચક્ર	ఏకాచక్ర
એકાવિરા	ఏకావిరా
એકીશ	ఏకీశ
એકેસ્વારા	ఏకేస్వారా
એક્શીકા	ఏక్శీకా
એદોમ	ఏదోమ
એપ્શીતા	ఏప్శీతా
એલાવારાસન	ఏలావారాసన
એલેના	ఏలేనా
એવાની	ఏవానీ
એવોન	ఏవోన
એશંકા	ఏశంకా
એશાન્ય	ఏశాన్య
ઐસીરી	ఐసీరీ
ઓજ્જસ્વીન	ఓజ్జస్వీన
ઓદથી	ఓదథీ
ઓનિશ	ఓనిశ
ઓનીર	ఓనీర
ઓન્નેશા	ఓన్నేశా
ઓબલેશ	ఓబలేశ
ઓમપતિ	ఓమపతి
ઓમવતી	ఓమవతీ
ઓમિષા	ఓమిషా
ઓવીએ	ఓవీఏ
ઓહા	ఓహా
કંકના	కంకనా
કંજમ	కంజమ
કંઠ	కంఠ
કંવર	కంవర
કતીરેશન	కతీరేశన
કથીર	కథీర
કદિતુલા	కదితులా
કનક	కనక
કનીસા	కనీసా
કનુષ	కనుష
કપિલા	కపిలా
કમલનયન	కమలనయన
કમલાબંધુ	కమలాబంధు
કરબી	కరబీ
કરીના	కరీనా
કરીશા	కరీశా
કરીસમાં	కరీసమాం
કરુન્યા	కరున్యా
કર્ણ	కర్ణ
કર્તીગા	కర్తీగా
કર્નાપ્રિયા	కర్నాప్రియా
કર્નીકા	కర్నీకా
કર્નીશ	కర్నీశ
કલમજીરરન્જિનિ	కలమజీరరన్జిని
કલાતર	కలాతర
કલાપક	కలాపక
કલાપ્રિયા	కలాప్రియా
કલૈસેલવી	కలైసేలవీ
કલ્પ	కల్ప
કલ્પેશ	కల్పేశ
કવચ	కవచ
કવિનયા	కవినయా
કવીપ્રનીતા	కవీప్రనీతా
કશિશ	కశిశ
કશ્યપ	కశ్యప
કસ્તૂરી	కస్తూరీ
કહન	కహన
કાંવ	కాంవ
કાજળ	కాజళ
કાત્યયાની	కాత్యయానీ
કાદમ્બિની	కాదమ్బినీ
કાનાસુ	కానాసు
કાન્જીરા	కాన్జీరా
કામાખ્યા	కామాఖ్యా
કામિકા	కామికా
કામીક	కామీక
કામેરીના	కామేరీనా
કાયંશ	కాయంశ
કાયલવિલી	కాయలవిలీ
કારૂકા	కారూకా
કાલપી	కాలపీ
કાલિંદી	కాలిందీ
કાલિરંજન	కాలిరంజన
કાવ્યંશ	కావ్యంశ
કાષ્ઠ	కాష్ఠ
કિન્નેરા	కిన్నేరా
કિર્તિત	కిర్తిత
કિશા	కిశా
કેતવ	కేతవ
કેતિકા	కేతికా
કેતીત	కేతీత
કેદારનાથ	కేదారనాథ
કેનિષા	కేనిషా
કેયા	కేయా
કેયાન	కేయాన
કેલ્વીન	కేల్వీన
કેવલકુમાર	కేవలకుమార
કેવિકા	కేవికా
કેવ્લીના	కేవ్లీనా
કેશિકા	కేశికా
કેશિન	కేశిన
કેશોરી	కేశోరీ
કેસવા	కేసవా
કૈરવી	కైరవీ
કૈલાશચંદ્ર	కైలాశచంద్ర
કૌશિક	కౌశిక
કૌશેય	కౌశేయ
કૌસ્તુભી	కౌస్తుభీ
ખરાધ્વામ્સીને	ఖరాధ్వామ్సీనే
ખાદીર	ఖాదీర
ખાવ્યા	ఖావ్యా
ખુશ્બૂ	ఖుశ్బూ
ખેજલ	ఖేజల
ગંગા	గంగా
ગંગિકા	గంగికా
ગંગી	గంగీ
ગંગેયા	గంగేయా
ગંગેશ	గంగేశ
ગંદિરા	గందిరా
ગંધા	గంధా
ગંધાર	గంధార
ગજપતિ	గజపతి
ગ઼ુનસૂંદરી	గునసూందరీ
ગાંધામધના	గాంధామధనా
ગાયન	గాయన
ગાલવ	గాలవ
ગીતિકા	గీతికా
ગીતીશા	గీతీశా
ગીતેશ	గీతేశ
ગીત્શ	గీత్శ
ગીરિષા	గీరిషా
ગીર્જેશ	గీర్జేశ
ગીવીથા	గీవీథా
ગીહિતી	గీహితీ
ગુણવાથી	గుణవాథీ
ગુદાકેશ	గుదాకేశ
ગુનાક્ષી	గునాక్షీ
ગુનાનીધી	గునానీధీ
ગુનિના	గునినా
ગુનીત	గునీత
ગુરનામ	గురనామ
ગુરીશ	గురీశ
ગુરુશરણ	గురుశరణ
ગોપાલ કૃષ્ણન	గోపాల కృష్ణన
ગોવરી	గోవరీ
ગોવ્થમી	గోవ్థమీ
ગૌરિકાંત	గౌరికాంత
ગૌરેશ	గౌరేశ
ગૌર્યનવી	గౌర్యనవీ
ગ્યાનવી	గ్యానవీ
ગ્રહિત	గ్రహిత
ઘટા	ఘటా
ઘનાનંદ	ఘనానంద
ઘુંગરૂ	ఘుంగరూ
ચંચલાદવાલા	చంచలాదవాలా
ચંચારી	చంచారీ
ચંચારીક	చంచారీక
ચંદિકા	చందికా
ચંદ્ર ભાન	చంద్ర భాన
ચંદ્રકિરણ	చంద్రకిరణ
ચંદ્રકીર્તી	చంద్రకీర్తీ
ચંદ્રબિંદુ	చంద్రబిందు
ચક્રદેવ	చక్రదేవ
ચક્રિક	చక్రిక
ચન્દ્રવદન	చన్ద్రవదన
ચન્દ્રહાસ	చన్ద్రహాస
ચમેલી	చమేలీ
ચરક	చరక
ચરણજીત	చరణజీత
ચરણરજ	చరణరజ
ચરિત	చరిత
ચરુલા	చరులా
ચસ્મીતા	చస్మీతా
ચાકરીન	చాకరీన
ચાને	చానే
ચાન્નક્કા	చాన్నక్కా
ચાન્નાય	చాన్నాయ
ચારીકા	చారీకా
ચારુદત્ત	చారుదత్త
ચારુલતા	చారులతా
ચારુશીલા	చారుశీలా
ચિંટૂ	చింటూ
ચિતહેશ	చితహేశ
ચિત્કલા	చిత్కలా
ચિત્તસ્વરૂપ	చిత్తస్వరూప
ચિત્રકુન્દાલા	చిత్రకున్దాలా
ચિત્રલ	చిత్రల
ચિત્રેશ	చిత్రేశ
ચિદાત્મા	చిదాత్మా
ચિધાત્મા	చిధాత్మా
ચિન્મય	చిన్మయ
ચિર્ત્રંગ	చిర్త్రంగ
ચીન્નીઃ	చీన్నీః
ચેથના	చేథనా
ચેનના	చేననా
ચૈતન	చైతన
ચૈત્રી	చైత్రీ
ચોલામિત્ર	చోలామిత్ర
ચૌનતા	చౌనతా
છાયા	ఛాయా
જગતપાલ	జగతపాల
જગદગુરુવે	జగదగురువే
જગદીપ	జగదీప
જગન	జగన
જગિશ	జగిశ
જગ્ગેર	జగ్గేర
જગ્સના	జగ్సనా
જનતા	జనతా
જનાદેવ	జనాదేవ
જનાર્દનન	జనార్దనన
જનિતા	జనితా
જન્મ	జన్మ
જમ્બાવતી	జమ్బావతీ
જય ગોપાલ	జయ గోపాల
જયંતાસેના	జయంతాసేనా
જયદા	జయదా
જયન	జయన
જયમેન	జయమేన
જયલક્ષ્મી	జయలక్ష్మీ
જયલલીથા	జయలలీథా
જયશેખર	జయశేఖర
જયહરી	జయహరీ
જયાકીર્તન	జయాకీర్తన
જયાપાદમાં	జయాపాదమాం
જયાલક્ષ્મી	జయాలక్ష్మీ
જય્મીની	జయ్మీనీ
જલાગંધા	జలాగంధా
જલાર્ક	జలార్క
જલ્પેશ	జల్పేశ
જશપાલ	జశపాల
જસ્લીના	జస్లీనా
જસ્વીથા	జస్వీథా
જસ્સીચા	జస్సీచా
જહાંગીર	జహాంగీర
જાગ્રત	జాగ్రత
જાગ્રવ	జాగ్రవ
જાઝીમ	జాఝీమ
જાતાવેદાસ	జాతావేదాస
જાનકીરમન	జానకీరమన
જાનવી	జానవీ
જાનહાન	జానహాన
જાન્વી	జాన్వీ
જામીની	జామీనీ
જાલેંદ્ર	జాలేంద్ర
જાહનવી	జాహనవీ
જિનાભદ્ર	జినాభద్ర
જિલેશ	జిలేశ
જિલ્પા	జిల్పా
જીગર	జీగర
જીતીશ	జీతీశ
જીન	జీన
જીન્શીત	జీన్శీత
જીમૂત	జీమూత
જીલવ	జీలవ
જીવા	జీవా
જીવિકા	జీవికా
જીવેશ	జీవేశ
જીશના	జీశనా
જીશું	జీశుం
જુનીતા	జునీతా
જેગપ્રીયાન	జేగప్రీయాన
જેતલ	జేతల
જેનીતા	జేనీతా
જેબીશા	జేబీశా
જૈચંદ	జైచంద
જૈચરણ	జైచరణ
જૈદેવ	జైదేవ
જૈસંકર	జైసంకర
જૈસ્યા	జైస్యా
જોયાત્રી	జోయాత్రీ
જોવાકી	జోవాకీ
જોવિતા	జోవితా
જોસ્યા	జోస్యా
જ્ઞાન	జ్ఞాన
જ્ઞાનાલ	జ్ఞానాల
જ્યોસ્તના	జ్యోస్తనా
ઝંકાર	ఝంకార
ઝરલ	ఝరల
ઝાએઈ	ఝాఏఈ
ઝારા	ఝారా
ઝિનૂક	ఝినూక
ઝુબીન	ఝుబీన
ઝુલિએર	ఝులిఏర
ઝેનીલ	ఝేనీల
ઠરાનીકા	ఠరానీకా
ડાલી	డాలీ
તંગમ	తంగమ
તક્ષક	తక్షక
તથાથાન	తథాథాన
તનવી	తనవీ
તનવીર	తనవీర
તનિશ્ક	తనిశ్క
તનુપા	తనుపా
તન્નિષ્ઠા	తన్నిష్ఠా
તન્વી શ્રી	తన్వీ శ్రీ
તપસેન્દ્ર	తపసేన్ద్ర
તપસ્વિની	తపస్వినీ
તમન	తమన
તમન્ના	తమన్నా
તમોનષ	తమోనష
તયા	తయా
તરણ	తరణ
તરનીજા	తరనీజా
તરુણી	తరుణీ
તરુશ્રી	తరుశ్రీ
તરોશ	తరోశ
તશા	తశా
તસ્મિ	తస్మి
તસ્ય	తస్య
તાનક	తానక
તાના	తానా
તાની	తానీ
તાનીશતા	తానీశతా
તાન્વી	తాన్వీ
તાન્વેશા	తాన్వేశా
તામસી	తామసీ
તામીલ્મરણ	తామీల్మరణ
તારક	తారక
તારકેશ	తారకేశ
તારકેશ્વર	తారకేశ్వర
તારાનીસેન	తారానీసేన
તારોક	తారోక
તાલંક	తాలంక
તાલીન	తాలీన
તાવીનીશ	తావీనీశ
તિક્શીકા	తిక్శీకా
તિજિલ	తిజిల
તિતિર	తితిర
તિનકા	తినకా
તિર્થાયાદ	తిర్థాయాద
તિલકા	తిలకా
તિલોત્તમા	తిలోత్తమా
તીમિત	తీమిత
તીમીતા	తీమీతా
તીયાસા	తీయాసా
તીરુગ્નાનમ	తీరుగ్నానమ
તીરુમેની	తీరుమేనీ
તીર્થરાજ	తీర్థరాజ
તીશા	తీశా
તુકારામ	తుకారామ
તુન્ગાર	తున్గార
તુલસા	తులసా
તૃષા	తృషా
તેજસી	తేజసీ
તેજસ્વીતા	తేజస్వీతా
તેજસ્વીની	తేజస్వీనీ
તેજેસ્વીની	తేజేస్వీనీ
તેજોભાદ્ર	తేజోభాద్ర
તેર્ષમ	తేర్షమ
તેહીહ્યા	తేహీహ్యా
તોમોગના	తోమోగనా
તોશાની	తోశానీ
તોશીન	తోశీన
તૌરુસ	తౌరుస
ત્રિકાયા	త్రికాయా
ત્રિધાત્રી	త్రిధాత్రీ
ત્રિનાથ	త్రినాథ
ત્રિભુવન	త్రిభువన
ત્રિમૂર્તિ	త్రిమూర్తి
ત્રિયા	త్రియా
ત્રિવેન્દ્ર	త్రివేన్ద్ర
ત્રિશુલાંક	త్రిశులాంక
ત્રિષર	త్రిషర
ત્રીનેશ	త్రీనేశ
ત્રીભુવન	త్రీభువన
ત્રીલોકાત્માને	త్రీలోకాత్మానే
ત્રીવીક્રમાં	త్రీవీక్రమాం
ત્રીવીદ	త్రీవీద
ત્રેયા	త్రేయా
થનીરિકા	థనీరికా
થાનીકા	థానీకా
થાનીષા	థానీషా
થાનીસરી	థానీసరీ
થાન્યસ્રી	థాన్యస్రీ
થામીલારાસન	థామీలారాసన
થારન્યા	థారన్యా
થેન્મોલી	థేన్మోలీ
થ્રાયા	థ్రాయా
દક્શીકા	దక్శీకా
દક્ષિત	దక్షిత
દક્ષેષ	దక్షేష
દજ્શી	దజ్శీ
દધીચિ	దధీచి
દયસરા	దయసరా
દયાકર	దయాకర
દયાનીશ્કા	దయానీశ్కా
દરસાથ	దరసాథ
દરહાસ	దరహాస
દરિદ્રીયાનાશીની	దరిద్రీయానాశీనీ
દર્શિકા	దర్శికా
દર્સીકા	దర్సీకా
દલજીત	దలజీత
દલ્શેર	దల్శేర
દશાગ્રીવા શીરોહરા	దశాగ్రీవా శీరోహరా
દસરાજા	దసరాజా
દસ્માયા	దస్మాయా
દહા	దహా
દહાના	దహానా
દાનુષ	దానుష
દારિકા	దారికా
દિક્ષી	దిక్షీ
દિપક્ષી	దిపక్షీ
દિપમ્શું	దిపమ్శుం
દિપાશ્રી	దిపాశ్రీ
દિપ્તા	దిప్తా
દિશના	దిశనా
દીક્ષિકા	దీక్షికా
દીપનકર	దీపనకర
દીપમાળા	దీపమాళా
દીપાના	దీపానా
દીપ્તિ	దీప్తి
દેબન્શી	దేబన్శీ
દેબસ્મિતા	దేబస్మితా
દેબાસીસ	దేబాసీస
દેબોરહ	దేబోరహ
દેબ્પ્રસાદ	దేబ్ప్రసాద
દેવ કુમાર	దేవ కుమార
દેવકલી	దేవకలీ
દેવકી	దేవకీ
દેવતા	దేవతా
દેવમતિ	దేవమతి
દેવર્સી	దేవర్సీ
દેવાંગી	దేవాంగీ
દેવાંશ	దేవాంశ
દેવાજુતા	దేవాజుతా
દેવાદાર્શીની	దేవాదార్శీనీ
દેવાદીત્યા	దేవాదీత్యా
દેવાદ્યુમના	దేవాద్యుమనా
દેવાનંદન	దేవానందన
દેવાપી	దేవాపీ
દેવાલીના	దేవాలీనా
દેવિદાસ	దేవిదాస
દેવિના	దేవినా
દેવીકી	దేవీకీ
દેવેન્દ્રનાથ	దేవేన్ద్రనాథ
દેવેન્દ્રશીકા	దేవేన్ద్రశీకా
દેવેશી	దేవేశీ
દેવ્યમ	దేవ్యమ
દેવ્યાની	దేవ్యానీ
દેવ્વાન્તી	దేవ్వాన్తీ
દેશવા	దేశవా
દેશીકા	దేశీకా
દેસના	దేసనా
દેસીકા	దేసీకా
દેહ્ય	దేహ్య
દૈત્ય	దైత్య
દૈના	దైనా
દૈપાયન	దైపాయన
દૈવી	దైవీ
ધક્શીતા	ధక్శీతా
ધક્ષતા	ధక్షతా
ધન લક્ષ્મી	ధన లక్ష్మీ
ધનધાન્યકી	ధనధాన్యకీ
ધનશિકા	ధనశికా
ધનિયા	ధనియా
ધનુંર્ધારા	ధనుంర్ధారా
ધમેન્દ્ર	ధమేన్ద్ర
ધરમવીર	ధరమవీర
ધરાસુતા	ధరాసుతా
ધર્મઅધ્યક્ષ	ధర్మఅధ్యక్ష
ધર્મકીર્તિ	ధర్మకీర్తి
ધર્મીશ્તા	ధర్మీశ్తా
ધવલ્યા	ధవల్యా
ધાર્શીકા	ధార్శీకా
ધાવીશી	ధావీశీ
ધિરા	ధిరా
ધીપ્ત્હા	ధీప్త్హా
ધીમાહી	ధీమాహీ
ધૂન	ధూన
ધૈર્ય	ధైర్య
ધ્રીશીકા	ధ్రీశీకా
નંદ	నంద
નંદકુમાર	నందకుమార
નંદગોપાલ	నందగోపాల
નક્શ	నక్శ
નક્ષાત્ર	నక్షాత్ర
નગરજન	నగరజన
નબ્હિજ	నబ్హిజ
નમસ્યૂ	నమస్యూ
નમીતા	నమీతా
નયાજ	నయాజ
નયાસના	నయాసనా
નરીતા	నరీతా
નર્મદા	నర్మదా
નવતેજ	నవతేజ
નવિન	నవిన
નાકીસકા	నాకీసకా
નાકુશ	నాకుశ
નાગનાથ	నాగనాథ
નાગાંજલી	నాగాంజలీ
નાગાનંદિની	నాగానందినీ
નાગાર્જુન	నాగార్జున
નાગેસ્વારી	నాగేస్వారీ
નાટકપ્રિય	నాటకప్రియ
નાથ	నాథ
નાન્દુની	నాన్దునీ
નાભિ	నాభి
નાયક	నాయక
નાયકી	నాయకీ
નારંગ	నారంగ
નારન	నారన
નારાયન	నారాయన
નાર્સપ્પા	నార్సప్పా
નાવાન્ય	నావాన్య
નાવાપ્રિયન	నావాప్రియన
નાશાલ	నాశాల
નિકેતા	నికేతా
નિખાલ	నిఖాల
નિખિલ	నిఖిల
નિધન	నిధన
નિપા	నిపా
નિબંધના	నిబంధనా
નિમેશ	నిమేశ
નિરામઈ	నిరామఈ
નિરામયા	నిరామయా
નિરૂપા	నిరూపా
નિલિની	నిలినీ
નિલ્લ	నిల్ల
નિશય	నిశయ
નિશા	నిశా
નિશિ	నిశి
નિશિકા	నిశికా
નિષ્ણાં	నిష్ణాం
નિહિત	నిహిత
નીકુંજા	నీకుంజా
નીકેશ્ય	నీకేశ్య
નીખેલ	నీఖేల
નીગી	నీగీ
નીડી	నీడీ
નીદિશ	నీదిశ
નીધા	నీధా
નીપા	నీపా
નીપુના	నీపునా
નીબેદીતા	నీబేదీతా
નીરજ નયન	నీరజ నయన
નીરુધી	నీరుధీ
નીરૈમાંથી	నీరైమాంథీ
નીર્મુકતા	నీర్ముకతా
નીલંજન	నీలంజన
નીલાક્ષી	నీలాక్షీ
નીલ્પ્રબ્ભા	నీల్ప్రబ్భా
નીશીરા	నీశీరా
નીશોકા	నీశోకా
નીસ્ચીતા	నీస్చీతా
નીસ્ચીથા	నీస్చీథా
નેકા	నేకా
નેત્રતાવ	నేత్రతావ
નેમીચંદ	నేమీచంద
નેવી	నేవీ
નેશ્વારી	నేశ్వారీ
નૈનીશા	నైనీశా
નૈમિષા	నైమిషా
નૈરુથી	నైరుథీ
નૈલીકા	నైలీకా
નૌરિન	నౌరిన
પંકજલોચના	పంకజలోచనా
પંકિત	పంకిత
પંચમી	పంచమీ
પંડી	పండీ
પંથ	పంథ
પક્ષી	పక్షీ
પક્ષીન	పక్షీన
પઝ્હેની	పఝ్హేనీ
પણ-ગેશ	పణ-గేశ
પત્ર	పత్ర
પત્રલિકા	పత్రలికా
પત્રીક	పత్రీక
પદમાંક્ષ્ય	పదమాంక్ష్య
પદમાવતી	పదమావతీ
પદ્મ	పద్మ
પદ્માકર	పద్మాకర
પનિતા	పనితా
પન્યશ્રી	పన్యశ్రీ
પયોશ્નીકા	పయోశ్నీకా
પરમ	పరమ
પરમિલા	పరమిలా
પરવાસૂ	పరవాసూ
પરસમે	పరసమే
પરસ્માઈ	పరస్మాఈ
પરાકાષ	పరాకాష
પરાક્રમ	పరాక్రమ
પરિચય	పరిచయ
પરિષ	పరిష
પરીસા	పరీసా
પર્જન્ય	పర్జన్య
પર્નલ	పర్నల
પર્વત	పర్వత
પલાશરંજન	పలాశరంజన
પલોમી	పలోమీ
પલ્લબ	పల్లబ
પલ્લવિની	పల్లవినీ
પલ્લવી	పల్లవీ
પવીશ્ના	పవీశ్నా
પહેલ	పహేల
પાઓલા	పాఓలా
પાગલાવન	పాగలావన
પાન્દિયન	పాన్దియన
પારબ્રહ્મ	పారబ్రహ్మ
પારવાથી	పారవాథీ
પારાવ	పారావ
પાર્થવ	పార్థవ
પાર્થિવ	పార్థివ
પાર્થીવેન્દ્ર	పార్థీవేన్ద్ర
પાર્વતી નંદન	పార్వతీ నందన
પાર્વાથી	పార్వాథీ
પાવકી	పావకీ
પાવના	పావనా
પાવાકી	పావాకీ
પિંગલા	పింగలా
પીઅલ્લી	పీఅల్లీ
પીતામ્બરા	పీతామ్బరా
પીનલ	పీనల
પીયાશા	పీయాశా
પીર્નાવ	పీర్నావ
પૂજન	పూజన
પૂર્ણલલીતા	పూర్ణలలీతా
પૂર્નાચંદ્રા	పూర్నాచంద్రా
પૂર્નામદા	పూర్నామదా
પૂર્વ	పూర్వ
પૂર્વિકા	పూర్వికా
પૂર્વીજ્હા	పూర్వీజ్హా
પોંનન	పోంనన
પોઉર્નીમાં	పోఉర్నీమాం
પોન્થારા	పోన్థారా
પોરોમાં	పోరోమాం
પોષ	పోష
પૌરવી	పౌరవీ
પ્રંવુતા	ప్రంవుతా
પ્રગતીશા	ప్రగతీశా
પ્રગ્યા	ప్రగ్యా
પ્રણાલી	ప్రణాలీ
પ્રનાદા	ప్రనాదా
પ્રન્જા	ప్రన్జా
પ્રભાકર	ప్రభాకర
પ્રભાતી	ప్రభాతీ
પ્રભારૂપા	ప్రభారూపా
પ્રભાવતી	ప్రభావతీ
પ્રભ્રીતી	ప్రభ్రీతీ
પ્રહાર્શીની	ప్రహార్శీనీ
પ્રહાસા	ప్రహాసా
પ્રાખ્યા	ప్రాఖ్యా
પ્રાણવાપ્રિયા	ప్రాణవాప్రియా
પ્રાનાદ	ప్రానాద
ફણીશ	ఫణీశ
ફલોની	ఫలోనీ
ફુલ્લન	ఫుల్లన
ફેની	ఫేనీ
ફ્લાવીના	ఫ్లావీనా
બત્નાસીદ્ધીકારા	బత్నాసీద్ధీకారా
બદરી	బదరీ
બન્દીન	బన్దీన
બર્હન	బర్హన
બલામુરુગન	బలామురుగన
બલામ્બુ	బలామ్బు
બલ્લભ	బల్లభ
બવિયન	బవియన
બસંતી	బసంతీ
બસૂધા	బసూధా
બાટલી	బాటలీ
બાલાજી	బాలాజీ
બાલારામ	బాలారామ
બાલેન્દ્ર	బాలేన్ద్ర
બાહુબલી	బాహుబలీ
બાહુલ્ય	బాహుల్య
બિંકા	బింకా
બિજય	బిజయ
બિધાન	బిధాన
બિનોય	బినోయ
બિભવાસુ	బిభవాసు
બિમલા	బిమలా
બિમ્બ	బిమ్బ
બિસાલા	బిసాలా
બીકાશ	బీకాశ
બીન્દુસાગર	బీన్దుసాగర
બીબોસ્વાન	బీబోస్వాన
બીભાકર	బీభాకర
બીલ્વાની	బీల్వానీ
બીલ્વાનીલાયા	బీల్వానీలాయా
બુધીપ્રિયા	బుధీప్రియా
બૂમિકા	బూమికా
બૃંદા	బృందా
બેનીતા	బేనీతా
બૈજયંતી	బైజయంతీ
બૈસાખી	బైసాఖీ
બૌમાંથી	బౌమాంథీ
બ્રનુચિકા	బ్రనుచికా
બ્રહ્માવતી	బ్రహ్మావతీ
બ્રિજબાલા	బ్రిజబాలా
ભગત	భగత
ભગવંત	భగవంత
ભદ્રંગ	భద్రంగ
ભદ્રક	భద్రక
ભદ્રકપિલ	భద్రకపిల
ભરાન	భరాన
ભર્તેશ	భర్తేశ
ભવન	భవన
ભવરોગસ્યાભેશાજા	భవరోగస్యాభేశాజా
ભવાની સંકર	భవానీ సంకర
ભાગીરત	భాగీరత
ભાગ્યશબરી	భాగ్యశబరీ
ભાગ્યા	భాగ్యా
ભાગ્યેશ	భాగ్యేశ
ભાનુજ	భానుజ
ભાનુપ્રિયા	భానుప్రియా
ભાનુમિત્ર	భానుమిత్ర
ભારતી	భారతీ
ભારવી	భారవీ
ભારુ	భారు
ભાર્ગવા	భార్గవా
ભાવાનીલ	భావానీల
ભાવાપ્રિયા	భావాప్రియా
ભાવામોચની	భావామోచనీ
ભાવાર્થ	భావార్థ
ભાવાલન	భావాలన
ભાવિક	భావిక
ભાવિન	భావిన
ભાવેશ	భావేశ
ભાસુ	భాసు
ભિમાંવેગ	భిమాంవేగ
ભીખી	భీఖీ
ભીમસેન	భీమసేన
ભીમાંન્શી	భీమాంన్శీ
ભીલાનગના	భీలానగనా
ભુવૈનીકા	భువైనీకా
ભૂતપાલા	భూతపాలా
ભૂપેન્દ્ર	భూపేన్ద్ర
ભૂમીશ	భూమీశ
ભૃગુ	భృగు
ભેવીન	భేవీన
ભેસાજ	భేసాజ
ભોજા	భోజా
ભોલાનાથ	భోలానాథ
મંગલા	మంగలా
મંજુ પ્રસાદ	మంజు ప్రసాద
મંજુનાથ	మంజునాథ
મંજુબાલા	మంజుబాలా
મંજૂશા	మంజూశా
મંત	మంత
મંત્રના	మంత్రనా
મંથિકા	మంథికా
મકર	మకర
મણિરત્ના	మణిరత్నా
મત્સ્યેંદ્ર	మత్స్యేంద్ర
મદીન	మదీన
મદુર	మదుర
મધુ સ્મિતા	మధు స్మితా
મધુકાંત	మధుకాంత
મધુદીપ	మధుదీప
મધુમાંલી	మధుమాంలీ
મધુમાલતી	మధుమాలతీ
મધુલા	మధులా
મધુલેખા	మధులేఖా
મનનશ	మననశ
મનવિર	మనవిర
મનસ્વિન	మనస్విన
મનસ્વિની	మనస్వినీ
મનિભૂષણ	మనిభూషణ
મનીતા	మనీతా
મનીદીપ	మనీదీప
મનુજ	మనుజ
મનોથ	మనోథ
મનોભાવ	మనోభావ
મન્કુર	మన్కుర
મયુરીની	మయురీనీ
મરીને	మరీనే
મલયજ	మలయజ
મલ્લિકા	మల్లికా
મલ્લિકાર્જુન	మల్లికార్జున
મલ્લિગા	మల్లిగా
મલ્લી	మల్లీ
મલ્લુ	మల్లు
મસરા	మసరా
મહંથી	మహంథీ
મહાત્મન	మహాత్మన
મહાનંદ	మహానంద
મહાપુરુષ	మహాపురుష
મહાબુદ્ધિ	మహాబుద్ధి
મહાર્થ	మహార్థ
મહાર્વીન	మహార్వీన
મહાલીંગ	మహాలీంగ
મહાલ્યા	మహాల్యా
મહાશ્રી	మహాశ్రీ
મહિપતિ	మహిపతి
મહીથા	మహీథా
મહેંદ્રા	మహేంద్రా
માંગેશ	మాంగేశ
માંધુનીકા	మాంధునీకా
માંનાર્પ	మాంనార్ప
માંનીક્યા	మాంనీక్యా
માંનીચ	మాంనీచ
માંનીવ	మాంనీవ
માંનુંસ્મીથા	మాంనుంస్మీథా
માંનોત	మాంనోత
માંન્ગીરી	మాంన్గీరీ
માંન્તીકા	మాంన్తీకా
માંન્દામારી	మాంన్దామారీ
માંન્દારિકા	మాంన్దారికా
માંલાવાશ્રી	మాంలావాశ్రీ
માતંગા	మాతంగా
માતેઃ	మాతేః
માત્રે	మాత్రే
માથુર	మాథుర
માધવ દાસ	మాధవ దాస
માધવિલતા	మాధవిలతా
માધાન	మాధాన
માધુજ	మాధుజ
માનજ	మానజ
માનવિત	మానవిత
માનીન્ત	మానీన్త
માન્દાવિક	మాన్దావిక
મારવી	మారవీ
મારીરાજ	మారీరాజ
મારુત	మారుత
માર્કાન્દાય	మార్కాన్దాయ
માર્ગશી	మార్గశీ
માર્ગી	మార్గీ
માર્દવ	మార్దవ
માર્મિક	మార్మిక
માલતી	మాలతీ
માલથી	మాలథీ
માલારવિલી	మాలారవిలీ
માલારાવન	మాలారావన
માલિની	మాలినీ
માહિતા	మాహితా
મેધાસ્વી	మేధాస్వీ
મૈથીલ્ય	మైథీల్య
મૈનાલી	మైనాలీ
મૈનાવી	మైనావీ
મૈમત	మైమత
મૌલિકા	మౌలికా
મૌસુમ	మౌసుమ
યજ્નારૂપ	యజ్నారూప
યતિકા	యతికా
યદુ	యదు
યદુક્રિષ્ના	యదుక్రిష్నా
યદુવીર	యదువీర
યમ્યા	యమ్యా
યશિત	యశిత
યશોધર	యశోధర
યશ્દીપ	యశ్దీప
યશ્વી	యశ్వీ
યાઝટ	యాఝట
યાતિયાસા	యాతియాసా
યામાજીત	యామాజీత
યાશીકા	యాశీకా
યાશ્રી	యాశ్రీ
યાસી	యాసీ
યાહ્વી	యాహ్వీ
યીશાઈ	యీశాఈ
યુકાશ્રી	యుకాశ్రీ
યુક્ત	యుక్త
યુગ	యుగ
યુગંશ	యుగంశ
યુગન	యుగన
યુગ્મ	యుగ్మ
યુધાજિત	యుధాజిత
યુધિસઠિર	యుధిసఠిర
યુનાય	యునాయ
યુવંશ	యువంశ
યુવાની	యువానీ
યુવિક	యువిక
યૂરા	యూరా
યેધાંત	యేధాంత
યેનાક્ષી	యేనాక్షీ
યોગજ	యోగజ
યોગદા	యోగదా
યોગના	యోగనా
યોગાવી	యోగావీ
યોગી	యోగీ
યોગ્યથા	యోగ్యథా
યોનેન્દ્ર	యోనేన్ద్ర
યૌષા	యౌషా
રંગનાથ	రంగనాథ
રંતાજ	రంతాజ
રકશ્ન્ડા	రకశ్న్డా
રકીશી	రకీశీ
રક્તકમળ	రక్తకమళ
રક્ષ્ય	రక్ష్య
રઘુનાથ	రఘునాథ
રજીની	రజీనీ
રતન	రతన
રત્ના કુમાર	రత్నా కుమార
રત્નાબલી	రత్నాబలీ
રત્નાવલી	రత్నావలీ
રદીતે	రదీతే
રનક	రనక
રનવા	రనవా
રનામીતા	రనామీతా
રમિતા	రమితా
રમેશ	రమేశ
રમ્બેશ	రమ్బేశ
રમ્યક	రమ్యక
રયાપ્પા	రయాప్పా
રવિકાંત	రవికాంత
રવિકુમાર	రవికుమార
રવીતેજા	రవీతేజా
રવીન	రవీన
રવીન્ધાર	రవీన్ధార
રવીશ	రవీశ
રવેન	రవేన
રશેષ	రశేష
રશ્મી	రశ్మీ
રસવંત	రసవంత
રહલ	రహల
રહસ્ય	రహస్య
રાકવી	రాకవీ
રાખિ	రాఖి
રાગાવર્દીની	రాగావర్దీనీ
રાગ્વેદ	రాగ్వేద
રાજન	రాజన
રાજરમણ	రాజరమణ
રાજલક્ષ્મી	రాజలక్ష్మీ
રાજસેકરણ	రాజసేకరణ
રાજાન	రాజాన
રાજિંદર	రాజిందర
રાજુસ	రాజుస
રાજેંદ્ર	రాజేంద్ర
રાજેશ્રી	రాజేశ్రీ
રાજ્કલા	రాజ్కలా
રાજ્યશ્રી	రాజ్యశ్రీ
રાજ્વિકા	రాజ్వికా
રાત્રિ	రాత్రి
રાધક	రాధక
રાધા	రాధా
રાનું	రానుం
રામ	రామ
રામ  સેવક	రామ  సేవక
રામનાથ	రామనాథ
રામરા	రామరా
રામસ્વરૂપ	రామస్వరూప
રામાંભાદ્રણ	రామాంభాద్రణ
રામાધુતા	రామాధుతా
રાવના	రావనా
રાસબિહારી	రాసబిహారీ
રિન્કલ	రిన్కల
રિસા	రిసా
રીકાર્નાવ	రీకార్నావ
રીકીતા	రీకీతా
રીકીશા	రీకీశా
રીગ્વેદીતા	రీగ్వేదీతా
રીથ	రీథ
રીથેકા	రీథేకా
રીધી	రీధీ
રીનું	రీనుం
રીન્સીન	రీన్సీన
રીમા	రీమా
રીશીતા	రీశీతా
રીહાનના	రీహాననా
રેચિકા	రేచికా
રેનેશ	రేనేశ
રેમિથા	రేమిథా
રેશમી	రేశమీ
રોનક	రోనక
લકી	లకీ
લક્ષિતા	లక్షితా
લક્ષ્મી શ્રીનિવાસ	లక్ష్మీ శ్రీనివాస
લક્ષ્મીદેવી	లక్ష్మీదేవీ
લક્ષ્મીનાથ	లక్ష్మీనాథ
લગાન	లగాన
લજ્જા	లజ్జా
લજ્જાન	లజ్జాన
લજ્જાવતી	లజ్జావతీ
લતા	లతా
લબોની	లబోనీ
લલિતામોહના	లలితామోహనా
લશિકા	లశికా
લાઈના	లాఈనా
લાકેશ	లాకేశ
લાક્શેતા	లాక్శేతా
લાચ્મન	లాచ్మన
લાતીશ	లాతీశ
લાધી	లాధీ
લારીસા	లారీసా
લાર્મિકા	లార్మికా
લાલીતેશ	లాలీతేశ
લાલીત્યા	లాలీత్యా
લાલીમા	లాలీమా
લાવણ્ય	లావణ్య
લાવીશ	లావీశ
લાસીવીન્રાજ	లాసీవీన్రాజ
લાસુશા	లాసుశా
લિંગાધ્યક્ષ	లింగాధ్యక్ష
લીકીથ	లీకీథ
લીથીકા	లీథీకా
લીનું	లీనుం
લીન્નેત	లీన్నేత
લીમીશા	లీమీశా
લીલાધર	లీలాధర
લીલાવર્તી	లీలావర్తీ
લીશાંત	లీశాంత
લુંહાન	లుంహాన
લુકેશા	లుకేశా
લૂની	లూనీ
લેઓરા	లేఓరా
લેખિત	లేఖిత
લેના	లేనా
લેમ્મીએ	లేమ్మీఏ
લોઉકિક	లోఉకిక
લોકનાથ	లోకనాథ
લોકનેત્ર	లోకనేత్ర
લોકાજિત	లోకాజిత
લોકેન્દ્ર	లోకేన్ద్ర
લોક્ષી	లోక్షీ
લોપેશ	లోపేశ
લોલા	లోలా
લોલિતા	లోలితా
લોવ્યમ	లోవ్యమ
લોશીની	లోశీనీ
લોહિની	లోహినీ
વંદિત	వందిత
વંશજા	వంశజా
વંહી	వంహీ
વકૃત	వకృత
વક્ષ	వక్ష
વજરાંગ	వజరాంగ
વજ્રબાહૂ	వజ్రబాహూ
વજ્રાકાયા	వజ్రాకాయా
વજ્રિન	వజ్రిన
વજ્રેશ્વરી	వజ్రేశ్వరీ
વનદેવ	వనదేవ
વનાની	వనానీ
વયુનંદ	వయునంద
વય્યા	వయ్యా
વરજોત્તામાં	వరజోత్తామాం
વરદરાજ	వరదరాజ
વરદાન	వరదాన
વરપ્રદા	వరప్రదా
વરલક્ષ્મી	వరలక్ష్మీ
વરિયાસ	వరియాస
વર્ધીન	వర్ధీన
વર્શિની	వర్శినీ
વલાવન	వలావన
વલ્લભ	వల్లభ
વશીતા	వశీతా
વસંતા	వసంతా
વસતીન	వసతీన
વસવી	వసవీ
વસુલ	వసుల
વાક્પતિ	వాక్పతి
વાચસ્પતિ	వాచస్పతి
વાચ્ય	వాచ్య
વાજ્રહાસ્તા	వాజ్రహాస్తా
વાનામાલી	వానామాలీ
વાનાવારાયણ	వానావారాయణ
વાનૈપકા-વેરીન્દોન	వానైపకా-వేరీన్దోన
વામન	వామన
વામાંનીએ	వామాంనీఏ
વાર	వార
વાલકય	వాలకయ
વાલી	వాలీ
વાસંતાપ્રભા	వాసంతాప్రభా
વાસુકી	వాసుకీ
વાસુમાંથા	వాసుమాంథా
વિઅર	విఅర
વિકાસીની	వికాసీనీ
વિકાસ્ની	వికాస్నీ
વિક્ષિત	విక్షిత
વિદ્વાથ	విద్వాథ
વિધિ	విధి
વિનતા	వినతా
વિબુષા	విబుషా
વિભાવા	విభావా
વિમલા	విమలా
વિરબાહુ	విరబాహు
વિલાસિની	విలాసినీ
વીક્ષા	వీక్షా
વીચિકા	వీచికా
વીજીલા	వీజీలా
વીની	వీనీ
વીમા	వీమా
વીરોત્તમ	వీరోత్తమ
વેક્રાંત	వేక్రాంత
વેગવાહીની	వేగవాహీనీ
વેણુગોપાલ	వేణుగోపాల
વેત્રિવાલ	వేత్రివాల
વેદાંશી	వేదాంశీ
વેદાત્મન	వేదాత్మన
વેદાત્મને	వేదాత్మనే
વેદાર્થ	వేదార్థ
વેદીષ	వేదీష
વેધા	వేధా
વેધાસ	వేధాస
વેધીકા	వేధీకా
વેનાહ	వేనాహ
વેનીધર	వేనీధర
વેન્કાત્શીવા	వేన్కాత్శీవా
વેન્નેલા	వేన్నేలా
વેલુ	వేలు
વેવેશા	వేవేశా
વૈજનાથ	వైజనాథ
વૈદાહી	వైదాహీ
વૈદ્યનાથ	వైద్యనాథ
વૈધે	వైధే
વૈનાવિન	వైనావిన
વૈશાકા	వైశాకా
વૈશાખી	వైశాఖీ
વૈશાલી	వైశాలీ
વૈશ્વિક	వైశ్విక
વૈષ્ણવી	వైష్ణవీ
વૈસાખી	వైసాఖీ
સંચાલી	సంచాలీ
સંજય	సంజయ
સંજીથા	సంజీథా
સંજુકતા	సంజుకతా
સંતવાના	సంతవానా
સંદીતી	సందీతీ
સંદીપન	సందీపన
સંભાવના	సంభావనా
સંયક્તા	సంయక్తా
સંવિકા	సంవికా
સંસ્કૃતિ	సంస్కృతి
સંસ્કૃતી	సంస్కృతీ
સકલ	సకల
સક્તીવેલ	సక్తీవేల
સક્શિક	సక్శిక
સક્શીન્યા	సక్శీన్యా
સક્ષમ	సక్షమ
સચંદ્ર	సచంద్ర
સજૂ	సజూ
સદગુરૂ	సదగురూ
સદબિંદુ	సదబిందు
સદરુ	సదరు
સદા શિવમ	సదా శివమ
સદાશિવ	సదాశివ
સદિવા	సదివా
સદ્વિખા	సద్విఖా
સનવ	సనవ
સનીલ	సనీల
સનેશ	సనేశ
સનૈતા	సనైతా
સપર્ણા	సపర్ణా
સપુષ્પા	సపుష్పా
સપ્તોર્શી	సప్తోర్శీ
સબરીનાથાન	సబరీనాథాన
સભ્રાંત	సభ్రాంత
સમન્યુ	సమన్యు
સમબરણ	సమబరణ
સમભ્દ્ધા	సమభ్ద్ధా
સમય	సమయ
સમરવીર	సమరవీర
સમાંર્ધ	సమాంర్ధ
સમાધાન	సమాధాన
સમિયા	సమియా
સમીક્ક્સા	సమీక్క్సా
સમીક્ષા	సమీక్షా
સમ્બુદ્ધા	సమ్బుద్ధా
સમ્યનાતન	సమ్యనాతన
સમ્રીધ	సమ్రీధ
સમ્હીઠા	సమ్హీఠా
સરલા	సరలా
સર્જના	సర్జనా
સહલાદ	సహలాద
સહસ્ત્રજિત	సహస్త్రజిత
સહસ્વીની	సహస్వీనీ
સહુરી	సహురీ
સહૃદય	సహృదయ
સહેજ	సహేజ
સહોજ	సహోజ
સહ્ય	సహ్య
સાંદીપની	సాందీపనీ
સાઈ અમર્ત્ય	సాఈ అమర్త్య
સાઈ કાર્તિક	సాఈ కార్తిక
સાઈ દાસ	సాఈ దాస
સાઈ સુરિયા	సాఈ సురియా
સાતેજ	సాతేజ
સાદ્રીશી	సాద్రీశీ
સાધકા	సాధకా
સાધન	సాధన
સાનંદના	సానందనా
સાનવી તારીતા	సానవీ తారీతా
સાનાવી	సానావీ
સાન્વી	సాన్వీ
સાફલ્ય	సాఫల్య
સાબી	సాబీ
સામલી	సామలీ
સામાન	సామాన
સારંગી	సారంగీ
સારસ	సారస
સારાવતી	సారావతీ
સાલીની	సాలీనీ
સાહસ્રપાત	సాహస్రపాత
સાહુલ	సాహుల
સેન્ડી	సేన్డీ
સૈનિ	సైని
સૈનું	సైనుం
સૈય્યન	సైయ్యన
સૈલેન્દ્ર	సైలేన్ద్ర
સૈશા	సైశా
હંસરાજ	హంసరాజ
હંસાવાથ્ય	హంసావాథ్య
હંસિન	హంసిన
હંસીની	హంసీనీ
હઝેલ	హఝేల
હનસીકા	హనసీకా
હનાર્વીન	హనార్వీన
હનુમાન	హనుమాన
હમૃથા	హమృథా
હમ્સિની	హమ్సినీ
હરશું	హరశుం
હરા	హరా
હરિઅક્સા	హరిఅక్సా
હરિકિશન	హరికిశన
હરિદા	హరిదా
હરિનાક્ષી	హరినాక్షీ
હરિમંતી	హరిమంతీ
હરી	హరీ
હરી કિશન	హరీ కిశన
હરીકરણ	హరీకరణ
હરીદર્પા	హరీదర్పా
હરીદાસાપ્રિયા	హరీదాసాప్రియా
હરીદીપ	హరీదీప
હરીધામ	హరీధామ
હરીવલ્લભ	హరీవల్లభ
હરીશ્વ	హరీశ్వ
હર્લીના	హర్లీనా
હર્શાશ્રી	హర్శాశ్రీ
હર્શિક	హర్శిక
હર્ષ વીર	హర్ష వీర
હર્ષિતા	హర్షితా
હર્સ્વીતા	హర్స్వీతా
હલેય	హలేయ
હવીસા	హవీసా
હશન	హశన
હસીક	హసీక
હસીથા	హసీథా
હસ્મીથા	హస్మీథా
હાકેશ	హాకేశ
હાનીકા	హానీకా
હાર્શીની	హార్శీనీ
હાહન	హాహన
હિડિંબા	హిడింబా
હિતાંશી	హితాంశీ
હિતેક્ષા	హితేక్షా
હિતેન્દ્ર	హితేన్ద్ర
હિનલ	హినల
હિનેશ	హినేశ
હિમાકાર	హిమాకార
હિમાઘ્ના	హిమాఘ్నా
હિમાલ	హిమాల
હિશા	హిశా
હિશેતા	హిశేతా
હીમીર	హీమీర
હીરકની	హీరకనీ
હીરાન્યાપ્પા	హీరాన్యాప్పా
હીર્નાક્ષી	హీర్నాక్షీ
હીલ્લેય	హీల్లేయ
હુમીશા	హుమీశా
હુમૈલા	హుమైలా
હેઇઅન	హేఇఅన
હેત	హేత
હેતની	హేతనీ
હેતવ	హేతవ
હેત્વિક	హేత్విక
હેમંત	హేమంత
હેમદેવ	హేమదేవ
હેમલતા	హేమలతా
હેમા	హేమా
હેમાઁગી	హేమాఁగీ
હેમાંગા	హేమాంగా
હેમાકેશ	హేమాకేశ
હેમાલા	హేమాలా
હેમાલી	హేమాలీ
હેમાવતી	హేమావతీ
હેમીતા	హేమీతా
હેયન	హేయన
હેશીકા	హేశీకా
હોનહાર	హోనహార
હ્રિથિક	హ్రిథిక
હ્રીત્વિકા	హ్రీత్వికా
હ્રીદાન	హ్రీదాన
હ્રીવાન	హ్రీవాన
હ્રીશાંત	హ్రీశాంత
હ્રીશાબ	హ్రీశాబ
હ્રીશુલ	హ్రీశుల
હ્રુધાઈ	హ్రుధాఈ
#
#
# Territory names from CLDR
એસેન્શન આઇલેન્ડ	ఏసేన్శన ఆఇలేన్డ
ઍંડોરા	ఎండోరా
યુનાઇટેડ આરબ અમીરાત	యునాఇటేడ ఆరబ అమీరాత
અફઘાનિસ્તાન	అఫఘానిస్తాన
એન્ટીગુઆ અને બર્મુડા	ఏన్టీగుఆ అనే బర్ముడా
ઍંગ્વિલા	ఎంగ్విలా
અલ્બેનિયા	అల్బేనియా
આર્મેનિયા	ఆర్మేనియా
અંગોલા	అంగోలా
એન્ટાર્કટિકા	ఏన్టార్కటికా
આર્જેન્ટીના	ఆర్జేన్టీనా
અમેરીકન સમોઆ	అమేరీకన సమోఆ
ઑસ્ટ્રિયા	ఒస్ట్రియా
ઑસ્ટ્રેલિયા	ఒస్ట్రేలియా
અરુબા	అరుబా
એલેંડ ટાપુઓ	ఏలేండ టాపుఓ
અઝરબૈજાન	అఝరబైజాన
બોસ્નિયા અને હર્ઝેગોવિના	బోస్నియా అనే హర్ఝేగోవినా
બાર્બાડોસ	బార్బాడోస
બાંગ્લાદેશ	బాంగ్లాదేశ
બેલ્જીયમ	బేల్జీయమ
બુર્કિના ફાસો	బుర్కినా ఫాసో
બલ્ગેરિયા	బల్గేరియా
બેહરીન	బేహరీన
બુરુંડી	బురుండీ
બેનિન	బేనిన
સેન્ટ બાર્થેલેમી	సేన్ట బార్థేలేమీ
બર્મુડા	బర్ముడా
બ્રુનેઇ	బ్రునేఇ
બોલિવિયા	బోలివియా
કેરેબિયન નેધરલેન્ડ્ઝ	కేరేబియన నేధరలేన్డ్ఝ
બ્રાઝિલ	బ్రాఝిల
બહામાસ	బహామాస
ભૂટાન	భూటాన
બૌવેત આઇલેન્ડ	బౌవేత ఆఇలేన్డ
બોત્સ્વાના	బోత్స్వానా
બેલારુસ	బేలారుస
બેલીઝ	బేలీఝ
કેનેડા	కేనేడా
કોકોઝ (કીલીંગ) આઇલેન્ડ્સ	కోకోఝ (కీలీంగ) ఆఇలేన్డ్స
કોંગો - કિંશાસા	కోంగో - కింశాసా
કોંગો (ડીઆરસી)	కోంగో (డీఆరసీ)
સેન્ટ્રલ આફ્રિકન રીપબ્લિક	సేన్ట్రల ఆఫ్రికన రీపబ్లిక
કોંગો - બ્રાઝાવિલે	కోంగో - బ్రాఝావిలే
કોંગો (પ્રજાસત્તાક)	కోంగో (ప్రజాసత్తాక)
સ્વિટ્ઝર્લૅન્ડ	స్విట్ఝర్లెన్డ
કોટ ડી આઇવરી	కోట డీ ఆఇవరీ
આઇવરી કોસ્ટ	ఆఇవరీ కోస్ట
કુક આઇલેન્ડ્સ	కుక ఆఇలేన్డ్స
ચિલી	చిలీ
કૅમરૂન	కెమరూన
ચીન	చీన
કોલમ્બિયા	కోలమ్బియా
ક્લિપરટન આઇલેન્ડ	క్లిపరటన ఆఇలేన్డ
કોસ્ટા રિકા	కోస్టా రికా
ક્યુબા	క్యుబా
કૅપ વર્ડે	కెప వర్డే
કુરાકાઓ	కురాకాఓ
ક્રિસમસ આઇલેન્ડ	క్రిసమస ఆఇలేన్డ
સાયપ્રસ	సాయప్రస
ચેક રીપબ્લિક	చేక రీపబ్లిక
જર્મની	జర్మనీ
ડિએગો ગારસિઆ	డిఏగో గారసిఆ
જીબૌટી	జీబౌటీ
ડેનમાર્ક	డేనమార్క
ડોમિનિકા	డోమినికా
ડોમિનિકન રીપબ્લિક	డోమినికన రీపబ్లిక
અલ્જીરિયા	అల్జీరియా
સ્યુટા અને મેલિલા	స్యుటా అనే మేలిలా
એક્વાડોર	ఏక్వాడోర
એસ્ટોનિયા	ఏస్టోనియా
ઇજિપ્ત	ఇజిప్త
પશ્ચિમી સહારા	పశ్చిమీ సహారా
એરિટ્રિયા	ఏరిట్రియా
સ્પેન	స్పేన
ઇથિઓપિયા	ఇథిఓపియా
યુરોપિયન સંઘ	యురోపియన సంఘ
ફિનલેન્ડ	ఫినలేన్డ
ફીજી	ఫీజీ
ફૉકલેન્ડ ટાપુઓ	ఫొకలేన్డ టాపుఓ
ફૉકલેન્ડ ટાપુઓ (ઇસ્લાસ માલવિનસ)	ఫొకలేన్డ టాపుఓ (ఇస్లాస మాలవినస)
માઇક્રોનેશિયા	మాఇక్రోనేశియా
ફૅરો ટાપુઓ	ఫెరో టాపుఓ
ફ્રાંસ	ఫ్రాంస
ગેબન	గేబన
યુનાઇટેડ કિંગડમ	యునాఇటేడ కింగడమ
ગ્રેનેડા	గ్రేనేడా
જ્યોર્જીયા	జ్యోర్జీయా
ફ્રેંચ ગયાના	ఫ్రేంచ గయానా
ગ્વેર્નસે	గ్వేర్నసే
ઘાના	ఘానా
જીબ્રાલ્ટર	జీబ్రాల్టర
ગ્રીનલેન્ડ	గ్రీనలేన్డ
ગેમ્બિયા	గేమ్బియా
ગિની	గినీ
ગ્વાડેલોપ	గ్వాడేలోప
ઇક્વેટોરિયલ ગિની	ఇక్వేటోరియల గినీ
ગ્રીસ	గ్రీస
દક્ષિણ જ્યોર્જીયા અને દક્ષિણ સેન્ડવિચ આઇલેન્ડ્સ	దక్షిణ జ్యోర్జీయా అనే దక్షిణ సేన్డవిచ ఆఇలేన్డ్స
ગ્વાટેમાલા	గ్వాటేమాలా
ગ્વામ	గ్వామ
ગિની-બિસાઉ	గినీ-బిసాఉ
ગયાના	గయానా
હોંગકોંગ SAR ચીન	హోంగకోంగ SAR చీన
હોંગ કોંગ	హోంగ కోంగ
હર્ડ અને મેકડોનાલ્ડ આઇલેન્ડ્સ	హర్డ అనే మేకడోనాల్డ ఆఇలేన్డ్స
હોન્ડુરસ	హోన్డురస
ક્રોએશિયા	క్రోఏశియా
હૈતિ	హైతి
હંગેરી	హంగేరీ
કૅનેરી ટાપુઓ	కెనేరీ టాపుఓ
ઇન્ડોનેશિયા	ఇన్డోనేశియా
આયર્લેન્ડ	ఆయర్లేన్డ
ઇઝરાઇલ	ఇఝరాఇల
આઈલ ઓફ મૅન	ఆఈల ఓఫ మెన
ભારત	భారత
બ્રિટિશ ઇન્ડિયન ઓશન ટેરિટરી	బ్రిటిశ ఇన్డియన ఓశన టేరిటరీ
ઇરાક	ఇరాక
ઈરાન	ఈరాన
આઇસલેન્ડ	ఆఇసలేన్డ
ઇટાલી	ఇటాలీ
જર્સી	జర్సీ
જમૈકા	జమైకా
જોર્ડન	జోర్డన
જાપાન	జాపాన
કેન્યા	కేన్యా
કિર્ગિઝ્સ્તાન	కిర్గిఝ్స్తాన
કંબોડિયા	కంబోడియా
કિરિબાટી	కిరిబాటీ
કોમોરસ	కోమోరస
સેન્ટ કિટ્સ અને નેવિસ	సేన్ట కిట్స అనే నేవిస
ઉત્તર કોરિયા	ఉత్తర కోరియా
દક્ષિણ કોરિયા	దక్షిణ కోరియా
કુવૈત	కువైత
કેમેન ટાપુઓ	కేమేన టాపుఓ
કઝાકિસ્તાન	కఝాకిస్తాన
લાઓસ	లాఓస
લેબનોન	లేబనోన
સેન્ટ લુસિયા	సేన్ట లుసియా
લૈચટેંસ્ટેઇન	లైచటేంస్టేఇన
શ્રીલંકા	శ్రీలంకా
લાઇબેરિયા	లాఇబేరియా
લેસોથો	లేసోథో
લિથુઆનિયા	లిథుఆనియా
લક્ઝમબર્ગ	లక్ఝమబర్గ
લાત્વિયા	లాత్వియా
લિબિયા	లిబియా
મોરોક્કો	మోరోక్కో
મોનાકો	మోనాకో
મોલડોવા	మోలడోవా
મૉન્ટેંનેગ્રો	మొన్టేంనేగ్రో
સેન્ટ માર્ટિન	సేన్ట మార్టిన
મેડાગાસ્કર	మేడాగాస్కర
માર્શલ આઇલેન્ડ્સ	మార్శల ఆఇలేన్డ్స
મેસેડોનિયા	మేసేడోనియా
મેસેડોનિયા (FYROM)	మేసేడోనియా (FYROM)
માલી	మాలీ
મ્યાંમાર (બર્મા)	మ్యాంమార (బర్మా)
મંગોલિયા	మంగోలియా
મકાઉ SAR ચીન	మకాఉ SAR చీన
મકાઉ	మకాఉ
ઉત્તરીય મારિયાના આઇલેન્ડ્સ	ఉత్తరీయ మారియానా ఆఇలేన్డ్స
માર્ટીનીક	మార్టీనీక
મૌરિટાનિયા	మౌరిటానియా
મોંટસેરાત	మోంటసేరాత
માલ્ટા	మాల్టా
મોરિશિયસ	మోరిశియస
માલદિવ્સ	మాలదివ్స
માલાવી	మాలావీ
મેક્સિકો	మేక్సికో
મલેશિયા	మలేశియా
મોઝામ્બિક	మోఝామ్బిక
નામિબિયા	నామిబియా
ન્યુ સેલેડોનિયા	న్యు సేలేడోనియా
નાઇજર	నాఇజర
નોરફૉક ટાપુ	నోరఫొక టాపు
નાઇજીરીયા	నాఇజీరీయా
નિકારાગુઆ	నికారాగుఆ
નેધરલેન્ડ	నేధరలేన్డ
નૉર્વે	నొర్వే
નેપાળ	నేపాళ
નૌરુ	నౌరు
નીયુ	నీయు
ન્યુઝીલેન્ડ	న్యుఝీలేన్డ
ઓમાન	ఓమాన
પનામા	పనామా
પેરુ	పేరు
ફ્રેંચ પોલિનેશિયા	ఫ్రేంచ పోలినేశియా
પાપુઆ ન્યૂ ગિની	పాపుఆ న్యూ గినీ
ફિલીપાઇન્સ	ఫిలీపాఇన్స
પાકિસ્તાન	పాకిస్తాన
પોલેંડ	పోలేండ
સેન્ટ પિયર અને મીક્વેલન	సేన్ట పియర అనే మీక్వేలన
પીટકૈર્ન આઇલેન્ડ્સ	పీటకైర్న ఆఇలేన్డ్స
પ્યુઅર્ટો રિકો	ప్యుఅర్టో రికో
પેલેસ્ટિનિયન ટેરિટરી	పేలేస్టినియన టేరిటరీ
પેલેસ્ટાઇન	పేలేస్టాఇన
પોર્ટુગલ	పోర్టుగల
પલાઉ	పలాఉ
પેરાગ્વે	పేరాగ్వే
કતાર	కతార
આઉટલાઈન્ગ ઓશનિયા	ఆఉటలాఈన్గ ఓశనియా
રીયુનિયન	రీయునియన
રોમાનિયા	రోమానియా
સર્બિયા	సర్బియా
રશિયા	రశియా
રવાંડા	రవాండా
સાઉદી અરેબિયા	సాఉదీ అరేబియా
સોલોમન આઇલેન્ડ્સ	సోలోమన ఆఇలేన్డ్స
સેશેલ્સ	సేశేల్స
સુદાન	సుదాన
સ્વીડન	స్వీడన
સિંગાપુર	సింగాపుర
સેન્ટ હેલેના	సేన్ట హేలేనా
સ્લોવેનિયા	స్లోవేనియా
સ્વાલબર્ડ અને જેન મેયન	స్వాలబర్డ అనే జేన మేయన
સ્લોવેકિયા	స్లోవేకియా
સીએરા લેઓન	సీఏరా లేఓన
સૅન મેરિનો	సెన మేరినో
સેનેગલ	సేనేగల
સોમાલિયા	సోమాలియా
સુરીનામ	సురీనామ
દક્ષિણ સુદાન	దక్షిణ సుదాన
સાઓ ટૉમ અને પ્રિંસિપે	సాఓ టొమ అనే ప్రింసిపే
એલ સેલ્વાડોર	ఏల సేల్వాడోర
સિંટ માર્ટેન	సింట మార్టేన
સીરિયા	సీరియా
સ્વાઝિલેન્ડ	స్వాఝిలేన్డ
ત્રિસ્તાન દા કુન્હા	త్రిస్తాన దా కున్హా
તુર્ક્સ અને કાઇકોસ ટાપુઓ	తుర్క్స అనే కాఇకోస టాపుఓ
ચાડ	చాడ
ફ્રેંચ સદર્ન ટેરિટરીઝ	ఫ్రేంచ సదర్న టేరిటరీఝ
ટોગો	టోగో
થાઇલેંડ	థాఇలేండ
તાજીકિસ્તાન	తాజీకిస్తాన
ટોકેલાઉ	టోకేలాఉ
તિમોર-લેસ્તે	తిమోర-లేస్తే
પૂર્વ તિમોર	పూర్వ తిమోర
તુર્કમેનિસ્તાન	తుర్కమేనిస్తాన
ટ્યુનિશિયા	ట్యునిశియా
ટોંગા	టోంగా
તુર્કી	తుర్కీ
ટ્રિનીદાદ અને ટોબેગો	ట్రినీదాద అనే టోబేగో
તુવાલુ	తువాలు
તાઇવાન	తాఇవాన
તાંઝાનિયા	తాంఝానియా
યુક્રેન	యుక్రేన
યુગાંડા	యుగాండా
સંયુક્ત રાજ્ય આઉટલાઇંગ આયલેન્ડ્સ	సంయుక్త రాజ్య ఆఉటలాఇంగ ఆయలేన్డ్స
સંયુકત રાજ્ય અમેરિકા	సంయుకత రాజ్య అమేరికా
ઉરુગ્વે	ఉరుగ్వే
ઉઝ્બેકિસ્તાન	ఉఝ్బేకిస్తాన
વેટિકન સિટી	వేటికన సిటీ
સેન્ટ વિન્સેટ અને ગ્રેનેડીન્સ	సేన్ట విన్సేట అనే గ్రేనేడీన్స
વેનેઝુએલા	వేనేఝుఏలా
બ્રિટિશ વર્જિન ટાપુઓ	బ్రిటిశ వర్జిన టాపుఓ
વિયેતનામ	వియేతనామ
વાનુઆતુ	వానుఆతు
વેલીસ અને ફ્યુટુના	వేలీస అనే ఫ్యుటునా
સમોઆ	సమోఆ
કોસોવો	కోసోవో
યેમેન	యేమేన
મેયોટ	మేయోట
દક્ષિણ આફ્રિકા	దక్షిణ ఆఫ్రికా
ઝામ્બિયા	ఝామ్బియా
ઝિમ્બાબ્વે	ఝిమ్బాబ్వే
અજ્ઞાત પ્રદેશ	అజ్ఞాత ప్రదేశ
