# Baby names
ಅಕಾರ್ಯಸುತಾ	ଅକାର୍ଯସୁତା
ಅಕ್ಶಿತೀ	ଅକ୍ଶିତୀ
ಅಕ್ಷಥಾ	ଅକ୍ଷଥା
ಅಕ್ಷೀ	ଅକ୍ଷୀ
ಅಗ್ನಿಜ್ವಾಳಾ	ଅଗ୍ନିଜ୍ଵାଳା
ಅಗ್ರತಾ	ଅଗ୍ରତା
ಅಘನ್ಯ	ଅଘନ୍ଯ
ಅಚ್ಯುತಾನ	ଅଚ୍ଯୁତାନ
ಅಜಸ್ಥಾ	ଅଜସ୍ଥା
ಅದವೈಕಾ	ଅଦଵୈକା
ಅದಾಮ	ଅଦାମ
ಅದಿಥಾ	ଅଦିଥା
ಅದೀಕ್ಯಾ	ଅଦୀକ୍ଯା
ಅದೀತೀಯ	ଅଦୀତୀଯ
ಅದ್ರಿತಾ	ଅଦ୍ରିତା
ಅದ್ರಿಯನ	ଅଦ୍ରିଯନ
ಅದ್ರೀಶ	ଅଦ୍ରୀଶ
ಅದ್ಶಯಾ	ଅଦ୍ଶଯା
ಅಧರ್ಷ	ଅଧର୍ଷ
ಅಧಾವನ	ଅଧାଵନ
ಅಧಿನೀ	ଅଧିନୀ
ಅಧ್ಯುತ	ଅଧ୍ଯୁତ
ಅಧ್ರೀತಾ	ଅଧ୍ରୀତା
ಅನಿಯಾ	ଅନିଯା
ಅಬೀನಂದಾ	ଅବୀନଂଦା
ಅಬೀರಾಮ	ଅବୀରାମ
ಅಬೀಶ	ଅବୀଶ
ಅಬೀಸೇಶನ	ଅବୀସେଶନ
ಅಬ್ಜಾಯೋನೀ	ଅବ୍ଜାଯୋନୀ
ಅಬ್ಬೀರ	ଅବ୍ବୀର
ಅಭರಾಮ	ଅଭରାମ
ಅಭಿಜನ	ଅଭିଜନ
ಅಭಿಜ್ಞಾ	ଅଭିଜ୍ଞା
ಅಭಿಜ್ಞಾನ	ଅଭିଜ୍ଞାନ
ಅಭಿನಾ	ଅଭିନା
ಅಭಿನಿವೇಶ	ଅଭିନିଵେଶ
ಅಭಿನುಂ	ଅଭିନୁଂ
ಅಭಿಮ	ଅଭିମ
ಅಭಿರಾತ	ଅଭିରାତ
ಅಭಿರುಚಿ	ଅଭିରୁଚି
ಅಭಿರುಪಾ	ଅଭିରୁପା
ಅಭಿಷೇಕ	ଅଭିଷେକ
ಅಭಿಹೀತಾ	ଅଭିହୀତା
ಅಭೀಕರ್ಷ	ଅଭୀକର୍ଷ
ಅಭೀಜೀಥ	ଅଭୀଜୀଥ
ಅಭೀದೀ	ଅଭୀଦୀ
ಅಭೀಧಾ	ଅଭୀଧା
ಅಭೀಪುಜ	ଅଭୀପୁଜ
ಅಭೀಶ್ರೇಯ	ଅଭୀଶ୍ରେଯ
ಅಭೀಸಿರಾತ	ଅଭୀସିରାତ
ಅಭ್ಯುದಯ	ଅଭ୍ଯୁଦଯ
ಅಭ್ರಕಾಸಿನ	ଅଭ୍ରକାସିନ
ಅಸಿರಾ	ଅସିରା
ಅಹಂಕಾರಾ	ଅହଂକାରା
ಅಹ್ರ್ಮ್ಶುಲ್ಲಾ	ଅହ୍ର୍ମ୍ଶୁଲ୍ଲା
ಅಹ್ಲಾದಾಜನನೀ	ଅହ୍ଲାଦାଜନନୀ
ಆಕರ್ಷಕ	ଆକର୍ଷକ
ಆತಿಶ	ଆତିଶ
ಆದರ್ಶಾ	ଆଦର୍ଶା
ಆದಿನಾಥ	ଆଦିନାଥ
ಆದಿಪುರುಷ	ଆଦିପୁରୁଷ
ಆದ್ಯಾ	ଆଦ୍ଯା
ಆಧಿರಾ	ଆଧିରା
ಆಧಿರಾಇ	ଆଧିରାଇ
ಆಧೀರೇನ	ଆଧୀରେନ
ಆನಂದತಾ	ଆନଂଦତା
ಆನಂದಿತ	ଆନଂଦିତ
ಆನೀಕ	ଆନୀକ
ಆನೀಕಾ	ଆନୀକା
ಆಪೇಕ್ಷಾ	ଆପେକ୍ଷା
ಆಭಾತ	ଆଭାତ
ಆಯಾಂಶ	ଆଯାଂଶ
ಆಯುಷ	ଆଯୁଷ
ಆಯುಸ	ଆଯୁସ
ಆರಾತ್ರಿಕಾ	ଆରାତ୍ରିକା
ಆರಾಥನಾ	ଆରାଥନା
ಆರಾಧಕ	ଆରାଧକ
ಆರೀವ	ଆରୀଵ
ಆರುನ್ಯ	ଆରୁନ୍ଯ
ಆರೋಹೀ	ଆରୋହୀ
ಆರ್ಜವ	ଆର୍ଜଵ
ಆರ್ನವ	ଆର୍ନଵ
ಆರ್ಪಿತ	ଆର୍ପିତ
ಆರ್ಯಮನ	ଆର୍ଯମନ
ಆರ್ಯವೀರ	ଆର୍ଯଵୀର
ಆಲೋಕಾ	ଆଲୋକା
ಆವೀಶ	ଆଵୀଶ
ಆಸರಾ	ଆସରା
ಆಸ್ಯಾ	ଆସ୍ଯା
ಆಹಾನ	ଆହାନ
ಆಹ್ನೀಕ	ଆହ୍ନୀକ
ಇಂದುಕಲಾ	ଇଂଦୁକଲା
ಇಂದುಲಾಲಾ	ଇଂଦୁଲାଲା
ಇತಿಶ್ರೀ	ଇତିଶ୍ରୀ
ಇನೀಯನ	ଇନୀଯନ
ಇನ್ದೀವರ	ଇନ୍ଦୀଵର
ಇನ್ದುಕಾಂತಾ	ଇନ୍ଦୁକାଂତା
ಇನ್ದುಜ	ଇନ୍ଦୁଜ
ಇನ್ದುದಾರ	ଇନ୍ଦୁଦାର
ಇನ್ದುಶ್ರೀ	ଇନ୍ଦୁଶ୍ରୀ
ಇನ್ದ್ರಕಾಂತಾ	ଇନ୍ଦ୍ରକାଂତା
ಇನ್ದ್ರಜಿತ	ଇନ୍ଦ୍ରଜିତ
ಇನ್ದ್ರದತ್ತ	ଇନ୍ଦ୍ରଦତ୍ତ
ಇನ್ದ್ರವದನ	ଇନ୍ଦ୍ରଵଦନ
ಇನ್ಧು	ଇନ୍ଧୁ
ಇಯಲೀಸಾಈ	ଇଯଲୀସାଈ
ಇಯ್ಯಾಪ್ಪನ	ଇଯ୍ଯାପ୍ପନ
ಇರಾವತೀ	ଇରାଵତୀ
ಇರೇಶ	ଇରେଶ
ಇಶೀ	ଇଶୀ
ಇಸಕೀ	ଇସକୀ
ಇಸೀತಾ	ଇସୀତା
ಈನ್ದುಸ	ଈନ୍ଦୁସ
ಈರಾವಾಜ	ଈରାଵାଜ
ಈಲಾಕ್ಕೀಯಾ	ଈଲାକ୍କୀଯା
ಈಶಾನಾ	ଈଶାନା
ಈಶುಕ	ଈଶୁକ
ಈಶ್ತರ	ଈଶ୍ତର
ಈಶ್ವರದತ್ತ	ଈଶ୍ଵରଦତ୍ତ
ಈಹಮ	ଈହମ
ಉಜೇಶ	ଉଜେଶ
ಉಜ್ಜಾನಿನೀ	ଉଜ୍ଜାନିନୀ
ಉಜ್ವಳ	ଉଜ୍ଵଳ
ಉಜ್ಹಾಲಾ	ଉଜ୍ହାଲା
ಉತ್ಕರ್ಷ	ଉତ୍କର୍ଷ
ಉತ್ಕರ್ಷಾ	ଉତ୍କର୍ଷା
ಉತ್ತಮ	ଉତ୍ତମ
ಉತ್ತಿಯಾ	ଉତ୍ତିଯା
ಉತ್ಪಲ	ଉତ୍ପଲ
ಉತ್ಪಲಾಕ್ಷ	ଉତ୍ପଲାକ୍ଷ
ಉತ್ಪಲಾಭಾ	ଉତ୍ପଲାଭା
ಉದಯಾ	ଉଦଯା
ಉದಾರ್ಚೀಸ	ଉଦାର୍ଚୀସ
ಉದಾರ್ಶ	ଉଦାର୍ଶ
ಉದೇಯ	ଉଦେଯ
ಉದ್ದೀಪ	ଉଦ୍ଦୀପ
ಉಧವ	ଉଧଵ
ಉಧ್ಗೀತಾ	ଉଧ୍ଗୀତା
ಉನ್ಮಾ	ଉନ୍ମା
ಉಪಂಗ	ଉପଂଗ
ಉಪನಂದಾ	ଉପନଂଦା
ಉಪನಾಯಿಕ	ଉପନାଯିକ
ಉಪಮನ್ಯು	ଉପମନ୍ଯୁ
ಉಪಮಾ	ଉପମା
ಉಪಲ	ଉପଲ
ಉಪಾಂಶು	ଉପାଂଶୁ
ಉಫ್ತಮ	ଉଫ୍ତମ
ಉಮೇದ	ଉମେଦ
ಉರವಶೀ	ଉରଵଶୀ
ಉರುಗಾಯ	ଉରୁଗାଯ
ಉರ್ಜೀತಾ	ଉର୍ଜୀତା
ಉರ್ಮಿಲ	ଉର୍ମିଲ
ಉರ್ಮಿಲಾ	ଉର୍ମିଲା
ಉಲಗಾಪ್ಪನ	ଉଲଗାପ୍ପନ
ಉಲ್ಕಾ	ଉଲ୍କା
ಉಲ್ಕೇಶ	ଉଲ୍କେଶ
ಉಲ್ಲಾಸಿತ	ଉଲ୍ଲାସିତ
ಉಲ್ಲಾಸೀಥಾ	ଉଲ୍ଲାସୀଥା
ಉಷಾ	ଉଷା
ಉಷ್ಮಾ	ଉଷ୍ମା
ಉಸ್ಲುಂನನ	ଉସ୍ଲୁଂନନ
ಋತಿಕಾ	ଋତିକା
ಏಈರಮ	ଏଈରମ
ಏಕತಾ	ଏକତା
ಏಕನ್ಷಾ	ଏକନ୍ଷା
ಏಕೇಸ್ವಾರ	ଏକେସ୍ଵାର
ಏಕ್ವಿರಾ	ଏକ୍ଵିରା
ಏಲಾವೇನ್ಧನ	ଏଲାଵେନ୍ଧନ
ಏಲೀಲೀ	ଏଲୀଲୀ
ಏಲೇಥಿಯಾ	ଏଲେଥିଯା
ಏವರಜ	ଏଵରଜ
ಏಶಾನಿಕಾ	ଏଶାନିକା
ಏಸ್ವರದೀತ್ಯ	ଏସ୍ଵରଦୀତ୍ଯ
ಏಹೀತ	ଏହୀତ
ಐನ್ಗೀನೀ	ଐନ୍ଗୀନୀ
ಐಷಾ	ଐଷା
ಓಜಸ್ವಿನೀ	ଓଜସ୍ଵିନୀ
ಓಜಸ್ವೀ	ଓଜସ୍ଵୀ
ಓಜಸ್ವೀತಾ	ଓଜସ୍ଵୀତା
ಓನೀರ	ଓନୀର
ಓಮಕಾರ	ଓମକାର
ಓಮಕಾರೀ	ଓମକାରୀ
ಓಮನಾ	ଓମନା
ಓರಿಓನ	ଓରିଓନ
ಓವೀನ	ଓଵୀନ
ಓಶೀನ	ଓଶୀନ
ಔಶಿಗ	ଔଶିଗ
ಕಂಠ	କଂଠ
ಕಂಠನ	କଂଠନ
ಕಟರೀನಾ	କଟରୀନା
ಕತಾನ	କତାନ
ಕತಾವ್ಯಾ	କତାଵ୍ଯା
ಕಥ್ಯನೀ	କଥ୍ଯନୀ
ಕನಕ	କନକ
ಕನಕಾಬತೀ	କନକାବତୀ
ಕನೀಜಾ	କନୀଜା
ಕನ್ವಕ	କନ୍ଵକ
ಕಪಾಲಿನೀ	କପାଲିନୀ
ಕಪೀಲೇಶ	କପୀଲେଶ
ಕಮಲಕಾಂತ	କମଲକାଂତ
ಕಮಲನಾಥ	କମଲନାଥ
ಕಮಲಾ ಸಮಭಾವ	କମଲା ସମଭାଵ
ಕಮಲಾಕ್ಷೀ	କମଲାକ୍ଷୀ
ಕಯಾಲ್ವೀಝ್ಹೀ	କଯାଲ୍ଵୀଝ୍ହୀ
ಕಯೋಶ	କଯୋଶ
ಕರನ	କରନ
ಕರಾಲಾ	କରାଲା
ಕರುನಾಕರ	କରୁନାକର
ಕರ್ತೀಗಾ	କର୍ତୀଗା
ಕರ್ತೀಶಾ	କର୍ତୀଶା
ಕಲರನೀ	କଲରନୀ
ಕಲಹನ	କଲହନ
ಕಲಾಧರ	କଲାଧର
ಕಲಾಪಕ	କଲାପକ
ಕಲಾಪಿನೀ	କଲାପିନୀ
ಕಲಾಸಾವೇರೀ	କଲାସାଵେରୀ
ಕಲ್ಪಕ	କଲ୍ପକ
ಕಲ್ಪಿತಾ	କଲ୍ପିତା
ಕಲ್ಪೇಶ	କଲ୍ପେଶ
ಕವನೀ	କଵନୀ
ಕವಿತ	କଵିତ
ಕಶ್ವೀ	କଶ୍ଵୀ
ಕಸ್ತುರ	କସ୍ତୁର
ಕಾಂಚನಾ	କାଂଚନା
ಕಾಂವ	କାଂଵ
ಕಾದಮ್ಬಿನೀ	କାଦମ୍ବିନୀ
ಕಾನನಬಾಲಾ	କାନନବାଲା
ಕಾನಾಕಾದರೀ	କାନାକାଦରୀ
ಕಾನೀತಾ	କାନୀତା
ಕಾನೀನ	କାନୀନ
ಕಾನೀಶ್ಕಾರ	କାନୀଶ୍କାର
ಕಾನುಶೀ	କାନୁଶୀ
ಕಾನ್ಚಾನಾಧ್ವಾಜಾ	କାନ୍ଚାନାଧ୍ଵାଜା
ಕಾಮಮಾಂ	କାମମାଂ
ಕಾಮಾ	କାମା
ಕಾಮೇರೀನಾ	କାମେରୀନା
ಕಾಮೇಶ್ವರೀ	କାମେଶ୍ଵରୀ
ಕಾಯಲವಿಲೀ	କାଯଲଵିଲୀ
ಕಾರುಣ್ಯ	କାରୁଣ୍ଯ
ಕಾರುಣ್ಯ ಪ್ರಕಾಶ	କାରୁଣ୍ଯ ପ୍ରକାଶ
ಕಾರೂಕಾ	କାରୂକା
ಕಾರ್ತಿಕೇಯನ	କାର୍ତିକେଯନ
ಕಾರ್ತೇಕೇಯಾ	କାର୍ତେକେଯା
ಕಾಲಿದಾಸ	କାଲିଦାସ
ಕಾಲಿಮೋಹನ	କାଲିମୋହନ
ಕಾವ್ಯನ	କାଵ୍ଯନ
ಕಾವ್ಯಶ್ರೀ	କାଵ୍ଯଶ୍ରୀ
ಕಾವ್ಯಸ್ರೀ	କାଵ୍ଯସ୍ରୀ
ಕಾಷ್ಠ	କାଷ୍ଠ
ಕಿಂಜಲ	କିଂଜଲ
ಕೀಅರಾ	କୀଅରା
ಕೇತನ	କେତନ
ಕೇಯಾ	କେଯା
ಕೇಲಾಕಾ	କେଲାକା
ಕೇವಲ	କେଵଲ
ಕೇಶೀ	କେଶୀ
ಕೇಸರೀಸುತ	କେସରୀସୁତ
ಕೇಸವಾ	କେସଵା
ಕೇಸವಾರಾಜ	କେସଵାରାଜ
ಕೈರವ	କୈରଵ
ಕೈಲಾಶಅಧಿಪತಿ	କୈଲାଶଅଧିପତି
ಕೌಶಿಕಾ	କୌଶିକା
ಕೌಸುಧೀ	କୌସୁଧୀ
ಕೌಸ್ತುಭೀ	କୌସ୍ତୁଭୀ
ಖಗೇನ್ದ್ರ	ଖଗେନ୍ଦ୍ର
ಖನಕ	ଖନକ
ಖನಿಕಾ	ଖନିକା
ಖಾಜಿತ	ଖାଜିତ
ಖುಜಾರಾ	ଖୁଜାରା
ಖುಶ್ಬೂ	ଖୁଶ୍ବୂ
ಗಂಗಜ	ଗଂଗଜ
ಗಂಧರ್ವವಿದ್ಯಾ	ଗଂଧର୍ଵଵିଦ୍ଯା
ಗಜಗಾಮಿನೀ	ଗଜଗାମିନୀ
ಗಜಪತಿ	ଗଜପତି
ಗಜರಾಜ	ଗଜରାଜ
ಗಜಾಧರ	ଗଜାଧର
ಗಣಕ	ଗଣକ
ಗಣಪತ	ଗଣପତ
ಗಣಿತಾ	ଗଣିତା
ಗಣ್ಯಾ	ଗଣ୍ଯା
ಗತಿತಾ	ଗତିତା
ಗನಾಕ್ಷೀ	ଗନାକ୍ଷୀ
ಗನೇಂದ್ರ	ଗନେଂଦ୍ର
ಗನ್ಗವಾಥೀ	ଗନ୍ଗଵାଥୀ
ಗರವೀ	ଗରଵୀ
ಗರಿಮಾ	ଗରିମା
ಗರ್ಜನ	ଗର୍ଜନ
ಗರ್ವಿತ	ଗର୍ଵିତ
ಗರ್ವಿತಾ	ଗର୍ଵିତା
ಗಹನಾ	ଗହନା
ಗಾಥಾ	ଗାଥା
ಗಾವ್ಯಾ	ଗାଵ୍ଯା
ಗಿರಾ	ଗିରା
ಗಿರಿಕ	ଗିରିକ
ಗಿರಿಜಾನಂದನ	ଗିରିଜାନଂଦନ
ಗಿರ್ವಾನ	ଗିର୍ଵାନ
ಗೀರೀಚಂದ್ರ	ଗୀରୀଚଂଦ୍ର
ಗೀರ್ವೇನ	ଗୀର୍ଵେନ
ಗೀಸೇಲೇ	ଗୀସେଲେ
ಗುನವಂತೀ	ଗୁନଵଂତୀ
ಗುನಾರತ್ನಾ	ଗୁନାରତ୍ନା
ಗುನಾವತೀ	ଗୁନାଵତୀ
ಗುನಾಸೇಕರಣ	ଗୁନାସେକରଣ
ಗುನೀತ	ଗୁନୀତ
ಗುನ್ಜೀತಾ	ଗୁନ୍ଜୀତା
ಗುನ್ದಾಪಾ	ଗୁନ୍ଦାପା
ಗುನ್ರೇಖಾ	ଗୁନ୍ରେଖା
ಗುರುದೂತ್ತ	ଗୁରୁଦୂତ୍ତ
ಗುರುಬಚನ	ଗୁରୁବଚନ
ಗುರುರಾಜ	ଗୁରୁରାଜ
ಗುಲಜಾರೀಲಾಲ	ଗୁଲଜାରୀଲାଲ
ಗುಲಮೋಹರ	ଗୁଲମୋହର
ಗುಲ್ಜನ	ଗୁଲ୍ଜନ
ಗುಹಾನ	ଗୁହାନ
ಗೇಶನಾ	ଗେଶନା
ಗೋಕೀಲಾ	ଗୋକୀଲା
ಗೋತಮ	ଗୋତମ
ಗೋಮಾಂಥೀ	ଗୋମାଂଥୀ
ಗೋಮ್ಯಾಸರೀ	ଗୋମ୍ଯାସରୀ
ಗೋವಿಂದಾ	ଗୋଵିଂଦା
ಗೋವಿನ್ದೀ	ଗୋଵିନ୍ଦୀ
ಗೋವೀನೇಶ	ଗୋଵୀନେଶ
ಘನಾವೀ	ଘନାଵୀ
ಚಂಚಾರೀಕ	ଚଂଚାରୀକ
ಚಂಡಮುಂಡವಿನಾಶಿನೀ	ଚଂଡମୁଂଡଵିନାଶିନୀ
ಚಂದನಾ	ଚଂଦନା
ಚಂದಸರೀ	ଚଂଦସରୀ
ಚಂದ್ರಕಂತೀ	ଚଂଦ୍ରକଂତୀ
ಚಂದ್ರಕಾಂತ	ଚଂଦ୍ରକାଂତ
ಚಂದ್ರಕೀ	ଚଂଦ୍ରକୀ
ಚಂದ್ರಕೀರ್ತೀ	ଚଂଦ୍ରକୀର୍ତୀ
ಚಂದ್ರಚುರ	ଚଂଦ୍ରଚୁର
ಚಂದ್ರಥಾ	ଚଂଦ୍ରଥା
ಚಂದ್ರನ್ಶುಂ	ଚଂଦ୍ରନ୍ଶୁଂ
ಚಂದ್ರಮುಖೀ	ଚଂଦ୍ରମୁଖୀ
ಚಂದ್ರರಾಜ	ଚଂଦ୍ରରାଜ
ಚಂದ್ರಲೇಕ್ಷಾ	ଚଂଦ୍ରଲେକ୍ଷା
ಚಂದ್ರಿಮಾ	ଚଂଦ୍ରିମା
ಚಂದ್ರು	ଚଂଦ୍ରୁ
ಚಂಧು	ଚଂଧୁ
ಚಕೋರೀ	ଚକୋରୀ
ಚಕ್ರಾಹೀಂ	ଚକ୍ରାହୀଂ
ಚಕ್ಷಸ	ଚକ୍ଷସ
ಚತುರ್ಬಹಾವೇ	ଚତୁର୍ବହାଵେ
ಚನ್ದ್ರಜ್ಯೋತಿ	ଚନ୍ଦ୍ରଜ୍ଯୋତି
ಚನ್ದ್ರವದನ	ଚନ୍ଦ୍ରଵଦନ
ಚನ್ದ್ರಸಹೋದಾರೀ	ଚନ୍ଦ୍ରସହୋଦାରୀ
ಚರುಲಾ	ଚରୁଲା
ಚಾತುರ್ಯ	ଚାତୁର୍ଯ
ಚಾನಾಸ್ಯಾ	ଚାନାସ୍ଯା
ಚಾನ್ದಿನೀ	ଚାନ୍ଦିନୀ
ಚಾನ್ನಕ್ಕಾ	ଚାନ୍ନକ୍କା
ಚಾಯನಾ	ଚାଯନା
ಚಾರುದತ್ತ	ଚାରୁଦତ୍ତ
ಚಾರುಪ್ರಭಾ	ଚାରୁପ୍ରଭା
ಚಾರ್ವೀ	ଚାର୍ଵୀ
ಚಿಂತ್ಯಾ	ଚିଂତ୍ଯା
ಚಿತಾಯು	ଚିତାଯୁ
ಚಿತ್ತರಂಜನೀ	ଚିତ୍ତରଂଜନୀ
ಚಿತ್ತಸ್ವರೂಪ	ଚିତ୍ତସ୍ଵରୂପ
ಚಿತ್ತೇಶ	ଚିତ୍ତେଶ
ಚಿತ್ರಂಶ	ଚିତ୍ରଂଶ
ಚಿತ್ರಕುನ್ಧಾಲಾ	ଚିତ୍ରକୁନ୍ଧାଲା
ಚಿತ್ರಬಾನಾ	ଚିତ୍ରବାନା
ಚಿತ್ರಾದೇವೀ	ଚିତ୍ରାଦେଵୀ
ಚಿತ್ರಾನೀ	ଚିତ୍ରାନୀ
ಚಿತ್ರೀನೀ	ଚିତ୍ରୀନୀ
ಚಿದಂಬರಮ	ଚିଦଂବରମ
ಚಿದಾನಂದಾ	ଚିଦାନଂଦା
ಚಿನಾರ	ଚିନାର
ಚೀನ್ಕಲ	ଚୀନ୍କଲ
ಚೀನ್ನಾಮಾಂಸ್ತೀಕಾ	ଚୀନ୍ନାମାଂସ୍ତୀକା
ಚೀನ್ನೀಃ	ଚୀନ୍ନୀଃ
ಚೇತಕ	ଚେତକ
ಚೇತನ್ದೀಪ	ଚେତନ୍ଦୀପ
ಚೈತ್ರಯೇಶ	ଚୈତ୍ରଯେଶ
ಚೋಲನ	ଚୋଲନ
ಛೋಟು	ଛୋଟୁ
ಜಗತವೀರ	ଜଗତଵୀର
ಜಗದಬಂದು	ଜଗଦବଂଦୁ
ಜಗ್ವೀರ	ଜଗ୍ଵୀର
ಜನತಾ	ଜନତା
ಜನೀಶಾ	ଜନୀଶା
ಜನ್ಮೇಶ	ଜନ୍ମେଶ
ಜಪೇಶ	ଜପେଶ
ಜಪ್ತೇಶ	ଜପ୍ତେଶ
ಜಬಿನೇ	ଜବିନେ
ಜಮಾಂದಾಗ್ನ್ಯ ಮಹಾದಾರ್ಪಾ	ଜମାଂଦାଗ୍ନ୍ଯ ମହାଦାର୍ପା
ಜಯ ಪ್ರಕಾಶ	ଜଯ ପ୍ରକାଶ
ಜಯಂತಾ	ଜଯଂତା
ಜಯಚಂದ	ଜଯଚଂଦ
ಜಯಪ್ರಭಾ	ଜଯପ୍ରଭା
ಜಯಾ ಕುಮಾರೀ	ଜଯା କୁମାରୀ
ಜಯಾಕೀರ್ಥೀ	ଜଯାକୀର୍ଥୀ
ಜಯಾಸಂಕರ	ଜଯାସଂକର
ಜಯೀನ	ଜଯୀନ
ಜಯೇನ್ದ್ರ	ଜଯେନ୍ଦ୍ର
ಜಯ್ಮೀನೀ	ଜଯ୍ମୀନୀ
ಜಲಜ	ଜଲଜ
ಜಲದ	ଜଲଦ
ಜಲಧೀಜಾ	ଜଲଧୀଜା
ಜಲಾರ್ಕ	ଜଲାର୍କ
ಜಲ್ಪೂರ್ನಾ	ଜଲ୍ପୂର୍ନା
ಜವಾಹರೀ	ଜଵାହରୀ
ಜಶವಂತ	ଜଶଵଂତ
ಜಶೋದಾ	ଜଶୋଦା
ಜಶ್ಮೀನಾ	ଜଶ୍ମୀନା
ಜಸಜೀತ	ଜସଜୀତ
ಜಸಬೀರ	ଜସବୀର
ಜಸಮಿತ	ଜସମିତ
ಜಸರಾಜ	ଜସରାଜ
ಜಸವೀರ	ଜସଵୀର
ಜಸೀಮಾ	ଜସୀମା
ಜಸ್ಕೀರಿತ	ଜସ୍କୀରିତ
ಜಸ್ಮಿಕಾ	ଜସ୍ମିକା
ಜಸ್ಮೀಥ್ಯಾ	ଜସ୍ମୀଥ୍ଯା
ಜಹನಕ	ଜହନକ
ಜಾಂಸೀ	ଜାଂସୀ
ಜಾಗ	ଜାଗ
ಜಾಗವೀ	ଜାଗଵୀ
ಜಾಗೃತಿ	ଜାଗୃତି
ಜಾನಕೀಭೂಷಣ	ଜାନକୀଭୂଷଣ
ಜಾನಕೀರಮನ	ଜାନକୀରମନ
ಜಾನಾ	ଜାନା
ಜಾನ್ವೀ	ଜାନ୍ଵୀ
ಜಾಪಕ	ଜାପକ
ಜಾಹೀ	ଜାହୀ
ಜಿಜ್ಞಾಸಾ	ଜିଜ୍ଞାସା
ಜಿತೇನ್ದ್ರಿಯ	ଜିତେନ୍ଦ୍ରିଯ
ಜಿಶ್ನು	ଜିଶ୍ନୁ
ಜೀಗೇನ	ଜୀଗେନ
ಜೀಜ್ಞಾಶಾ	ଜୀଜ୍ଞାଶା
ಜೀತನ	ଜୀତନ
ಜೀತಾಕಮ	ଜୀତାକମ
ಜೀತಾವಾರಆಶಯೇ	ଜୀତାଵାରଆଶଯେ
ಜೀನ್ದಾಲ	ଜୀନ୍ଦାଲ
ಜೀಯಾಂಶೀ	ଜୀଯାଂଶୀ
ಜೀವೀ	ଜୀଵୀ
ಜೀಶನಾ	ଜୀଶନା
ಜೇನ್ನಯ	ଜେନ୍ନଯ
ಜೇಯಾನ್ದ್ರಣ	ଜେଯାନ୍ଦ୍ରଣ
ಜೇರ್ರೀಷ	ଜେର୍ରୀଷ
ಜೇರ್ಶೀಕಾ	ଜେର୍ଶୀକା
ಜೈಚಾನ್ದ್ರಣ	ଜୈଚାନ୍ଦ୍ରଣ
ಜೈನ	ଜୈନ
ಜೈಸಲ	ଜୈସଲ
ಜೈಹಾಸೀನೀ	ଜୈହାସୀନୀ
ಜೋಸ್ಯಾ	ଜୋସ୍ଯା
ಜ್ಞಾನದೇವ	ଜ୍ଞାନଦେଵ
ಜ್ಞಾನಾ	ଜ୍ଞାନା
ಜ್ಞಾನಾಲ	ଜ୍ଞାନାଲ
ಜ್ಞಾನೇಶ್ವರೀ	ଜ୍ଞାନେଶ୍ଵରୀ
ಜ್ಯೋತಿರ್ಮೋಯೀ	ଜ୍ଯୋତିର୍ମୋଯୀ
ಜ್ಯೋತಿಷಮತಿ	ଜ୍ଯୋତିଷମତି
ಜ್ಯೋಥೀರ್ಮಾಈ	ଜ୍ଯୋଥୀର୍ମାଈ
ಜ್ಹಂಕರ	ଜ୍ହଂକର
ಜ್ಹಿಲ	ଜ୍ହିଲ
ಝರಲ	ଝରଲ
ಝವಿಯನ	ଝଵିଯନ
ಝಾರಾ	ଝାରା
ಝೀಣೀ	ଝୀଣୀ
ಝೇನೀತ	ଝେନୀତ
ಝೇನೀಶಾ	ଝେନୀଶା
ಝ್ಯನಾ	ଝ୍ଯନା
ಟಿಮ್ಮೀ	ଟିମ୍ମୀ
ಠುಮಕೀ	ଠୁମକୀ
ಠುಮರೀ	ଠୁମରୀ
ಡಿಮ್ಪೀ	ଡିମ୍ପୀ
ತಂಗವೇಲ	ତଂଗଵେଲ
ತಂತ್ರ	ତଂତ୍ର
ತಂಸೀ	ତଂସୀ
ತಕ್ಶೀಲ	ତକ୍ଶୀଲ
ತಜಜ್ಞ	ତଜଜ୍ଞ
ತಜಸರೀ	ତଜସରୀ
ತತ್ವಗ್ಯಾನಾಪ್ರದ	ତତ୍ଵଗ୍ଯାନାପ୍ରଦ
ತನವೀರ	ତନଵୀର
ತನಾವ	ତନାଵ
ತನೇಶ	ତନେଶ
ತನ್ವಿಕಾ	ତନ୍ଵିକା
ತನ್ವೀಶ್ರೀ	ତନ୍ଵୀଶ୍ରୀ
ತಪಸ	ତପସ
ತಪಸ್ವೀ	ତପସ୍ଵୀ
ತಮಸ	ତମସ
ತಮಾಯಾನ್ಥ್ಯ	ତମାଯାନ୍ଥ୍ଯ
ತಮಾಸ್ವೀ	ତମାସ୍ଵୀ
ತಮಿಲಾ	ତମିଲା
ತಮೇಶ	ତମେଶ
ತರಂಗಿನೀ	ତରଂଗିନୀ
ತರಲ	ତରଲ
ತರಸ್ವೀನ	ତରସ୍ଵୀନ
ತರಿತ	ତରିତ
ತರುಶೀ	ତରୁଶୀ
ತಲ್ಲೀ	ତଲ୍ଲୀ
ತಶಾ	ତଶା
ತಾಕ್ಸ್ವೀಹ	ତାକ୍ସ୍ଵୀହ
ತಾನಾಸೀ	ତାନାସୀ
ತಾನ್ಹಿತಾ	ତାନ୍ହିତା
ತಾಮಾಂಶ್ರೀ	ତାମାଂଶ୍ରୀ
ತಾಮಾಸ್ವಿನೀ	ତାମାସ୍ଵିନୀ
ತಾಮಿಲಸೇಲ್ವೀ	ତାମିଲସେଲ୍ଵୀ
ತಾಯೀನ	ତାଯୀନ
ತಾರಾಕ್ಷ	ତାରାକ୍ଷ
ತಾರಾಚಂದ	ତାରାଚଂଦ
ತಾರಾನೀಸೇನ	ତାରାନୀସେନ
ತಾರೀಶೀ	ତାରୀଶୀ
ತಾಲಿನ	ତାଲିନ
ತಾವಾಸ್ಯ	ତାଵାସ୍ଯ
ತಿತಲೀ	ତିତଲୀ
ತಿಲಕ	ତିଲକ
ತಿಸ್ಯಾ	ତିସ୍ଯା
ತೀಅನಾ	ତୀଅନା
ತೀಯಶಾ	ତୀଯଶା
ತೀಯಸ	ତୀଯସ
ತುನಾವಾ	ତୁନାଵା
ತುರಾನ್ಯು	ତୁରାନ୍ଯୁ
ತುಲಜಾ	ତୁଲଜା
ತುಲಸಾ	ତୁଲସା
ತುಲೀ	ତୁଲୀ
ತುಲೀಪ	ତୁଲୀପ
ತುಷಾರ	ତୁଷାର
ತುಷಿತ	ତୁଷିତ
ತುಷ್ಟಿ	ତୁଷ୍ଟି
ತೇಗವಿರ	ତେଗଵିର
ತೇಜಸೀ	ତେଜସୀ
ತೇಜಸ್ವೀ	ତେଜସ୍ଵୀ
ತೇಜಸ್ವೀನ	ତେଜସ୍ଵୀନ
ತೇಜೀ	ତେଜୀ
ತೇಜುಲ	ତେଜୁଲ
ತೇಜೇನದರ	ତେଜେନଦର
ತೇಜೇಶ	ତେଜେଶ
ತೇವಾನ	ତେଵାନ
ತೇಸಶ	ତେସଶ
ತೋಮಾಂಲೀ	ତୋମାଂଲୀ
ತೋಯಾಜ	ତୋଯାଜ
ತೋಶೀ	ତୋଶୀ
ತೋಶೀನ	ତୋଶୀନ
ತೌಲೀಕ	ତୌଲୀକ
ತ್ರಂಬಕ	ତ୍ରଂବକ
ತ್ರಿಂಬಿಕಾ	ତ୍ରିଂବିକା
ತ್ರಿಕಾಯಾ	ତ୍ରିକାଯା
ತ್ರಿಜಲ	ତ୍ରିଜଲ
ತ್ರಿಪುತಾ	ତ୍ରିପୁତା
ತ್ರಿಪುರಸುಂದರೀ	ତ୍ରିପୁରସୁଂଦରୀ
ತ್ರಿಪುರಾರೀ	ତ୍ରିପୁରାରୀ
ತ್ರಿಪ್ತಾ	ତ୍ରିପ୍ତା
ತ್ರಿಲೋಕೇಶ	ତ୍ରିଲୋକେଶ
ತ್ರಿವಿಕ್ರಮ	ତ୍ରିଵିକ୍ରମ
ತ್ರಿವೇಣೀ	ତ୍ରିଵେଣୀ
ತ್ರಿಶಲಾನಾ	ତ୍ରିଶଲାନା
ತ್ರಿಶಾಲಾ	ତ୍ରିଶାଲା
ತ್ರಿಶುಲಿನೀ	ତ୍ରିଶୁଲିନୀ
ತ್ರೀನೇಶ	ତ୍ରୀନେଶ
ತ್ರೀಮ್ಬೀಕಾ	ତ୍ରୀମ୍ବୀକା
ತ್ರೀಲೋಚನನ	ତ୍ରୀଲୋଚନନ
ತ್ರೀವೀದ	ତ୍ରୀଵୀଦ
ತ್ರೀಸವಾ	ତ୍ରୀସଵା
ಥಂಗಾ	ଥଂଗା
ಥಾನೀಶ್ಕಾ	ଥାନୀଶ୍କା
ಥಾನುಂಶಾ	ଥାନୁଂଶା
ಥಾರ್ಶೀನೀ	ଥାର୍ଶୀନୀ
ಥಾರ್ಸೀನ	ଥାର୍ସୀନ
ದಂದಾಪಾನೀ	ଦଂଦାପାନୀ
ದಕ್ಶಾಜಾ	ଦକ୍ଶାଜା
ದಕ್ಷೀ	ଦକ୍ଷୀ
ದಯಾಕರ	ଦଯାକର
ದಯಾನಿತಾ	ଦଯାନିତା
ದಯಾಲನ	ଦଯାଲନ
ದರಹಾಸ	ଦରହାସ
ದರಿದ್ರಾ ಧಾವ್ಸೀನೀ	ଦରିଦ୍ରା ଧାଵ୍ସୀନୀ
ದರೀತ್ರೀ	ଦରୀତ୍ରୀ
ದರ್ಮೀನೀ	ଦର୍ମୀନୀ
ದರ್ಸೀಕಾ	ଦର୍ସୀକା
ದವೇ	ଦଵେ
ದಶಾ	ଦଶା
ದಶಾಗ್ರೀವಾ ಶೀರೋಹರಾ	ଦଶାଗ୍ରୀଵା ଶୀରୋହରା
ದಾನ್ಸೀಕಾ	ଦାନ୍ସୀକା
ದಾಮಾ	ଦାମା
ದಾರುಕಾ	ଦାରୁକା
ದಾಶಾರತೀ	ଦାଶାରତୀ
ದಿಕ್ಶಾನ್ಯ	ଦିକ୍ଶାନ୍ଯ
ದಿಕ್ಶೀಕಾ	ଦିକ୍ଶୀକା
ದಿನ ದಯಾಲ	ଦିନ ଦଯାଲ
ದಿಪಂಶೀ	ଦିପଂଶୀ
ದಿಪೇಂದರ	ଦିପେଂଦର
ದಿಪೇನ	ଦିପେନ
ದೀಪ್ತಿಕಾನಾ	ଦୀପ୍ତିକାନା
ದೀಪ್ತಿಮೋಯ	ଦୀପ୍ତିମୋଯ
ದೇನೀಷ	ଦେନୀଷ
ದೇಬಸ್ಮಿತಾ	ଦେବସ୍ମିତା
ದೇಬೋಪ್ರಿಯಾ	ଦେବୋପ୍ରିଯା
ದೇಬೋಸ್ಮಿತಾ	ଦେବୋସ୍ମିତା
ದೇಬ್ಜಾನೀ	ଦେବ୍ଜାନୀ
ದೇಮ್ಧೇನ್ದ್ರ	ଦେମ୍ଧେନ୍ଦ୍ର
ದೇಯ್ದಿಪ್ಯಾ	ଦେଯ୍ଦିପ୍ଯା
ದೇಲೀನಾ	ଦେଲୀନା
ದೇವ ನರೇನ	ଦେଵ ନରେନ
ದೇವದೀಪ	ଦେଵଦୀପ
ದೇವನಾಥನ	ଦେଵନାଥନ
ದೇವಪದ	ଦେଵପଦ
ದೇವರತ	ଦେଵରତ
ದೇವರಾಜ	ଦେଵରାଜ
ದೇವರಾಜನ	ଦେଵରାଜନ
ದೇವಲ	ଦେଵଲ
ದೇವಾಂಶು	ଦେଵାଂଶୁ
ದೇವಾರಹಾಲ್ಲೀ	ଦେଵାରହାଲ୍ଲୀ
ದೇವಾಶ್ರೀ	ଦେଵାଶ୍ରୀ
ದೇವೀ	ଦେଵୀ
ದೇವ್ಬ್ರತಾ	ଦେଵ୍ବ୍ରତା
ದೇವ್ಮುಕೀಲ	ଦେଵ୍ମୁକୀଲ
ದೇವ್ಯೋಶಾ	ଦେଵ୍ଯୋଶା
ದೇಶಿಕ	ଦେଶିକ
ದೈತ್ಯ ಸಾಈ	ଦୈତ୍ଯ ସାଈ
ದೈನಾ	ଦୈନା
ದೈವಂಶ	ଦୈଵଂଶ
ದ್ಯುತಿ	ଦ୍ଯୁତି
ಧನಶಿಕಾ	ଧନଶିକା
ಧನ್ವಿಕಾ	ଧନ୍ଵିକା
ಧರಿಯಾ	ଧରିଯା
ಧರ್ಮ	ଧର୍ମ
ಧರ್ಮಜಾ	ଧର୍ମଜା
ಧರ್ಮದಿತ್ಯ	ଧର୍ମଦିତ୍ଯ
ಧಾತ್ರೀ	ଧାତ୍ରୀ
ಧಾನ	ଧାନ
ಧಾನೀತ	ଧାନୀତ
ಧಾನೀಶಾ	ଧାନୀଶା
ಧಾಮೀನೀ	ଧାମୀନୀ
ಧಾಮೋಧಾರ	ଧାମୋଧାର
ಧಾವಿತ	ଧାଵିତ
ಧಿತಿ	ଧିତି
ಧೀಯಾನ	ଧୀଯାନ
ಧುಹಿತಾ	ଧୁହିତା
ಧೃತಿ	ଧୃତି
ಧೈರ್ಯ್ಯಾ	ଧୈର୍ଯ୍ଯା
ಧ್ರೀಶೀಕಾ	ଧ୍ରୀଶୀକା
ಧ್ರೀಶ್ತೀಕಾ	ଧ୍ରୀଶ୍ତୀକା
ಧ್ರುವಿಕಾ	ଧ୍ରୁଵିକା
ಧ್ವೀಜಾ	ଧ୍ଵୀଜା
ನಂದಕುಮಾರ	ନଂଦକୁମାର
ನಕುಲ	ନକୁଲ
ನಕ್ಷತ್ರಾ	ନକ୍ଷତ୍ରା
ನಚಿಕೇತಾ	ନଚିକେତା
ನತಾಲೀ	ନତାଲୀ
ನಬರೂಣ	ନବରୂଣ
ನಭೋಜ	ନଭୋଜ
ನಮ್ರಹ	ନମ୍ରହ
ನಲಿನ	ନଲିନ
ನವಮ	ନଵମ
ನವರಾತನಾ	ନଵରାତନା
ನವಾಲನ	ନଵାଲନ
ನವೇಂದು	ନଵେଂଦୁ
ನಾಕುಶ	ନାକୁଶ
ನಾಗಧವಾನೀ	ନାଗଧଵାନୀ
ನಾಗರತನಾ	ନାଗରତନା
ನಾಗಿನೀ	ନାଗିନୀ
ನಾಗೇನ್ದ್ರ	ନାଗେନ୍ଦ୍ର
ನಾದಿಯಾ	ନାଦିଯା
ನಾಧಾ	ନାଧା
ನಾಧೀನೀ	ନାଧୀନୀ
ನಾನ್ತೀನೀ	ନାନ୍ତୀନୀ
ನಾಬಹ	ନାବହ
ನಾಭೀನತ	ନାଭୀନତ
ನಾಮೀಶಾ	ନାମୀଶା
ನಾಯತ	ନାଯତ
ನಾರಾಯಾಣಾ	ନାରାଯାଣା
ನಾರ್ಮಾಂಥಾ	ନାର୍ମାଂଥା
ನಾರ್ಸೀಮುಲುಂ	ନାର୍ସୀମୁଲୁଂ
ನಾಲಾನೀಲ	ନାଲାନୀଲ
ನಾಲಾವೇನ್ಭಾ	ନାଲାଵେନ୍ଭା
ನಾವಾಪ್ರಿಯನ	ନାଵାପ୍ରିଯନ
ನಾವಾಮಾಂಲ್ಲೀ	ନାଵାମାଂଲ୍ଲୀ
ನಾವೀಶಾ	ନାଵୀଶା
ನಾವ್ಯಶ್ರೀ	ନାଵ୍ଯଶ୍ରୀ
ನಾವ್ಯಸರೀ	ନାଵ୍ଯସରୀ
ನಾವ್ಯಾ	ନାଵ୍ଯା
ನಾಹುಲ	ନାହୁଲ
ನಿಕೀನ	ନିକୀନ
ನಿಖಾರ	ନିଖାର
ನಿಖಿಲೇಶ	ନିଖିଲେଶ
ನಿದೇಶ	ନିଦେଶ
ನಿಧ್ಯಾಥೀ	ନିଧ୍ଯାଥୀ
ನಿಭಯ	ନିଭଯ
ನಿರಜಾ	ନିରଜା
ನಿರ್ಜಲಾ	ନିର୍ଜଲା
ನಿಶಾ	ନିଶା
ನಿಶಿಥಿನೀ	ନିଶିଥିନୀ
ನಿಹಾರಿಕಾ	ନିହାରିକା
ನೀಕಮ	ନୀକମ
ನೀಕಾನ್ದರ್ಯ	ନୀକାନ୍ଦର୍ଯ
ನೀಕೀಲ	ନୀକୀଲ
ನೀಕುಂಜ	ନୀକୁଂଜ
ನೀಕುಲ	ନୀକୁଲ
ನೀಚೀತಾ	ନୀଚୀତା
ನೀಜಾ	ନୀଜା
ನೀಡೀ	ନୀଡୀ
ನೀತಾ	ନୀତା
ನೀದೀಶ	ନୀଦୀଶ
ನೀನಾ	ନୀନା
ನೀನ್ನ್ಯ	ନୀନ୍ନ୍ଯ
ನೀಭೀಶ	ନୀଭୀଶ
ನೀರುಧೀ	ନୀରୁଧୀ
ನೀರೇಕ್ಷಾ	ନୀରେକ୍ଷା
ನೀಲ	ନୀଲ
ನೀಲ ಕಾಂತಾ	ନୀଲ କାଂତା
ನೀಲ ಮಾಧವ	ନୀଲ ମାଧଵ
ನೀಲಂಜನಾ	ନୀଲଂଜନା
ನೀಲಕಮಾಲಾ	ନୀଲକମାଲା
ನೀಲದೇವೀ	ନୀଲଦେଵୀ
ನೀಲಯ	ନୀଲଯ
ನೀಲಾಂಜನ	ନୀଲାଂଜନ
ನೀಲಾಮ್ಬೇರ	ନୀଲାମ୍ବେର
ನೀಲೋರ್ಮ್ಯ	ନୀଲୋର୍ମ୍ଯ
ನೀಲ್ಸಾ	ନୀଲ୍ସା
ನೀಶಾಲೀ	ନୀଶାଲୀ
ನೀಷ್ಟಾ	ନୀଷ୍ଟା
ನೀಸಿತೀನೀ	ନୀସିତୀନୀ
ನೀಸ್ಚೀಥಾ	ନୀସ୍ଚୀଥା
ನೀಹಮ	ନୀହମ
ನೀಹಾರಿಕಾ	ନୀହାରିକା
ನೀಹೀಥಾ	ନୀହୀଥା
ನೀಹೀರಾ	ନୀହୀରା
ನೇಮಾ	ନେମା
ನೇಮಾಂಲೀ	ନେମାଂଲୀ
ನೇಹಾರಿಕಾ	ନେହାରିକା
ನೈತಿ	ନୈତି
ನೈರೀತೀ	ନୈରୀତୀ
ನೈವೇದ	ନୈଵେଦ
ನೈಷೀ	ନୈଷୀ
ನೌಬಹಾರ	ନୌବହାର
ಪಂಕಜ಼ಾ	ପଂକଜ଼ା
ಪಂಖೀ	ପଂଖୀ
ಪಂಚಮ	ପଂଚମ
ಪಂಚಾಲೀ	ପଂଚାଲୀ
ಪಂಥ	ପଂଥ
ಪಂಧಾರೀ	ପଂଧାରୀ
ಪಣ-ಗೇಶ	ପଣ-ଗେଶ
ಪತಾಲಾ	ପତାଲା
ಪತ್ರಲಿಕಾ	ପତ୍ରଲିକା
ಪದಮಾವತೀ	ପଦମାଵତୀ
ಪದ್ಮಬಂಧೂ	ପଦ୍ମବଂଧୂ
ಪದ್ಮಹಸ್ತಾ	ପଦ୍ମହସ୍ତା
ಪದ್ಮಾಂನಾಭಾ ಪ್ರಿಯಾ	ପଦ୍ମାଂନାଭା ପ୍ରିଯା
ಪನೀಶ್ಕಾ	ପନୀଶ୍କା
ಪನ್ಕಾಜಮ	ପନ୍କାଜମ
ಪನ್ದಾಲಾವಾಸನ	ପନ୍ଦାଲାଵାସନ
ಪಪಮ್ಮಾಂ	ପପମ୍ମାଂ
ಪರಮಂದಾ	ପରମଂଦା
ಪರಮಪುರುಷ	ପରମପୁରୁଷ
ಪರಮಹಂಸ	ପରମହଂସ
ಪರಮಾ	ପରମା
ಪರಮೇಶ್ವರೀ	ପରମେଶ୍ଵରୀ
ಪರಮ್ವಾರ್ದಾನ	ପରମ୍ଵାର୍ଦାନ
ಪರವೀನ	ପରଵୀନ
ಪರಾಯಂತ್ರ	ପରାଯଂତ୍ର
ಪರಾಶ	ପରାଶ
ಪರಿಕ್ಷಿತ	ପରିକ୍ଷିତ
ಪರಿಣೀತಾ	ପରିଣୀତା
ಪರಿತಾ	ପରିତା
ಪರಿತುಷ್ಟಿ	ପରିତୁଷ୍ଟି
ಪರಿಷ್ಕಾರ	ପରିଷ୍କାର
ಪರಿಹಾ	ପରିହା
ಪರೀಮೀತ	ପରୀମୀତ
ಪರು	ପରୁ
ಪರ್ಣವ	ପର୍ଣଵ
ಪರ್ಣಿಕಾ	ପର୍ଣିକା
ಪರ್ನಾಭಾ	ପର୍ନାଭା
ಪರ್ವತ	ପର୍ଵତ
ಪರ್ವತೀಪ್ರಿತ	ପର୍ଵତୀପ୍ରିତ
ಪರ್ವತೇಶ್ವರ	ପର୍ଵତେଶ୍ଵର
ಪರ್ವನ	ପର୍ଵନ
ಪಲಾನೀಚಾಮ್ಯ	ପଲାନୀଚାମ୍ଯ
ಪಲಾಶೀನೀ	ପଲାଶୀନୀ
ಪವನ	ପଵନ
ಪವೀಥಾ	ପଵୀଥା
ಪಾಂಖಡೀ	ପାଂଖଡୀ
ಪಾಂಚಾಲೀ	ପାଂଚାଲୀ
ಪಾಂಡುರಂಗ	ପାଂଡୁରଂଗ
ಪಾಓಲಾ	ପାଓଲା
ಪಾರಸ	ପାରସ
ಪಾರಾ	ପାରା
ಪಾರ್ತೀಬನ	ପାର୍ତୀବନ
ಪಾರ್ಥಾಪ್ರತಿಮ	ପାର୍ଥାପ୍ରତିମ
ಪಾರ್ಥಿಕ	ପାର୍ଥିକ
ಪಾರ್ವತೀ	ପାର୍ଵତୀ
ಪಾರ್ವಾಥೀ	ପାର୍ଵାଥୀ
ಪಾಲ	ପାଲ
ಪಾಲನೀವೇಲ	ପାଲନୀଵେଲ
ಪಾಲೀನ	ପାଲୀନ
ಪಾವಾನಾ	ପାଵାନା
ಪಾವಾನೀ	ପାଵାନୀ
ಪಾಸೀ	ପାସୀ
ಪಿಂಗಲ	ପିଂଗଲ
ಪಿಂಗಲಾ	ପିଂଗଲା
ಪಿತಾವಾಸನೇ	ପିତାଵାସନେ
ಪಿವಾಲ	ପିଵାଲ
ಪೀಉಶಾ	ପୀଉଶା
ಪೀತೋಬಾಶ	ପୀତୋବାଶ
ಪೀನ್ಕೇಶ	ପୀନ୍କେଶ
ಪೀರನೀಥಾ	ପୀରନୀଥା
ಪುರ್ನೀಮಾಂ	ପୁର୍ନୀମାଂ
ಪೂಜನ	ପୂଜନ
ಪೂಜಾ	ପୂଜା
ಪೂನಿಶ	ପୂନିଶ
ಪೂರಬ	ପୂରବ
ಪೂರ್ವಗಂಗಾ	ପୂର୍ଵଗଂଗା
ಪೂರ್ವಜ	ପୂର୍ଵଜ
ಪೂರ್ವಾ	ପୂର୍ଵା
ಪೇಮಲ	ପେମଲ
ಪೌಶಾಲೀ	ପୌଶାଲୀ
ಪ್ರಗನ್ಯಾ	ପ୍ରଗନ୍ଯା
ಪ್ರಗಿತ	ପ୍ରଗିତ
ಪ್ರಚೀತೀ	ପ୍ରଚୀତୀ
ಪ್ರಜೀಶಾ	ପ୍ରଜୀଶା
ಪ್ರದಿಪಾ	ପ୍ରଦିପା
ಪ್ರದೀಪ್ತಾ	ପ୍ରଦୀପ୍ତା
ಪ್ರನಾವಾಶ್ರೀ	ପ୍ରନାଵାଶ୍ରୀ
ಪ್ರನಿತಾ	ପ୍ରନିତା
ಪ್ರನೀಕಾ	ପ୍ରନୀକା
ಪ್ರಭಂಜನ	ପ୍ରଭଂଜନ
ಪ್ರಭಾಕರ	ପ୍ରଭାକର
ಪ್ರಭಾದಾ	ପ୍ରଭାଦା
ಪ್ರಮಿಕಾ	ପ୍ରମିକା
ಪ್ರಹಾರ್ಶೀನೀ	ପ୍ରହାର୍ଶୀନୀ
ಪ್ರಹಾಸಾ	ପ୍ରହାସା
ಪ್ರಾನಲ	ପ୍ରାନଲ
ಫಣೀಶ	ଫଣୀଶ
ಫ಼ಾಲ್ಗುನ	ଫ଼ାଲ୍ଗୁନ
ಫುಲ್ಲಾರಾ	ଫୁଲ୍ଲାରା
ಬಂದನಾ	ବଂଦନା
ಬಂಧೀನೀ	ବଂଧୀନୀ
ಬಂಸೀಲಾಲ	ବଂସୀଲାଲ
ಬಖ್ತಾವರ	ବଖ୍ତାଵର
ಬಗ್ಯಾರಾಜ	ବଗ୍ଯାରାଜ
ಬನಬಿಹಾರೀ	ବନବିହାରୀ
ಬರ್ಷಾ	ବର୍ଷା
ಬಲರಾಮ	ବଲରାମ
ಬಲವಾನ	ବଲଵାନ
ಬಲಾದೀತ್ಯ	ବଲାଦୀତ୍ଯ
ಬವೀಶ್ಯಸರೀ	ବଵୀଶ୍ଯସରୀ
ಬಹವಾಸ್ಯ	ବହଵାସ୍ଯ
ಬಹುಲಾ	ବହୁଲା
ಬಹುಲೇಯನ	ବହୁଲେଯନ
ಬಾಂಕೇ ಬಿಹಾರೀ	ବାଂକେ ବିହାରୀ
ಬಾಜೀನಾಥ	ବାଜୀନାଥ
ಬಾನೀ	ବାନୀ
ಬಾಪು	ବାପୁ
ಬಾಲಗೋಪಾಲ	ବାଲଗୋପାଲ
ಬಾಲಚಂದ್ರಾ	ବାଲଚଂଦ୍ରା
ಬಾಲನಾಥ	ବାଲନାଥ
ಬಾಲಾಜೀ	ବାଲାଜୀ
ಬಾಲಾರವೀ	ବାଲାରଵୀ
ಬಿಂದುಮಾಲಿನೀ	ବିଂଦୁମାଲିନୀ
ಬಿಂದೂಸರ	ବିଂଦୂସର
ಬಿಜೋಯ	ବିଜୋଯ
ಬಿನೋದ	ବିନୋଦ
ಬಿಪಾಶಾ	ବିପାଶା
ಬಿಮ್ಬಾ	ବିମ୍ବା
ಬಿರಂಚೀ	ବିରଂଚୀ
ಬಿಲ್ವಾ	ବିଲ୍ଵା
ಬೀದಯುಂತ	ବୀଦଯୁଂତ
ಬೀನೋದೀನೀ	ବୀନୋଦୀନୀ
ಬೀನ್ಕಾಲ	ବୀନ୍କାଲ
ಬೀಭು	ବୀଭୁ
ಬೀರಾತ	ବୀରାତ
ಬುದ್ಧ	ବୁଦ୍ଧ
ಬುದ್ಧಿ	ବୁଦ୍ଧି
ಬೇನುಂ	ବେନୁଂ
ಬೇನ್ನೀ	ବେନ୍ନୀ
ಬೇನ್ಶಿಕ	ବେନ୍ଶିକ
ಬೇಲುರಮೀ	ବେଲୁରମୀ
ಬೈರ	ବୈର
ಬೈಸಾಖೀ	ବୈସାଖୀ
ಬೋನಾಸರೀ	ବୋନାସରୀ
ಬ್ರಹ್ಮಾವತೀ	ବ୍ରହ୍ମାଵତୀ
ಬ್ರೀಜಲ	ବ୍ରୀଜଲ
ಬ್ರೀನ್ದಾವಾನೀ	ବ୍ରୀନ୍ଦାଵାନୀ
ಬ್ಲೇಸ್ಸೀ	ବ୍ଲେସ୍ସୀ
ಭಕ್ತಿ	ଭକ୍ତି
ಭಗವತೀ	ଭଗଵତୀ
ಭದ್ರಕ	ଭଦ୍ରକ
ಭದ್ರಕ್ಷ	ଭଦ୍ରକ୍ଷ
ಭದ್ರಾ	ଭଦ୍ରା
ಭದ್ರೀಶಾ	ଭଦ୍ରୀଶା
ಭವಾನಿದಾಸ	ଭଵାନିଦାସ
ಭವಿಷ್ಯಾ	ଭଵିଷ୍ଯା
ಭವೀಶ	ଭଵୀଶ
ಭವ್ಯ	ଭଵ୍ଯ
ಭಾಗವಾಥ	ଭାଗଵାଥ
ಭಾಗಿರತ	ଭାଗିରତ
ಭಾಗ್ಯವತೀ	ଭାଗ୍ଯଵତୀ
ಭಾಗ್ಯಶ್ರೀ	ଭାଗ୍ଯଶ୍ରୀ
ಭಾಗ್ಯಾ	ଭାଗ୍ଯା
ಭಾತ್ರಶ್ರೀ	ଭାତ୍ରଶ୍ରୀ
ಭಾದ್ರಿಕಾ	ଭାଦ୍ରିକା
ಭಾನುಜ	ଭାନୁଜ
ಭಾನುದಾಸ	ଭାନୁଦାସ
ಭಾನುಪ್ರಿಯಾ	ଭାନୁପ୍ରିଯା
ಭಾರನೀಧಾರ	ଭାରନୀଧାର
ಭಾರೂಕ	ଭାରୂକ
ಭಾರ್ತಿಹಾರೀ	ଭାର୍ତିହାରୀ
ಭಾವತೀ	ଭାଵତୀ
ಭಾವಾಥಾರೀನೀ	ଭାଵାଥାରୀନୀ
ಭಾವಾಪ್ರಿಯಾ	ଭାଵାପ୍ରିଯା
ಭಾವಿಕ	ଭାଵିକ
ಭಾವಿತಾ	ଭାଵିତା
ಭಾವೀಶಾ	ଭାଵୀଶା
ಭಾವ್ಯಶ್ರೀ	ଭାଵ୍ଯଶ୍ରୀ
ಭಾಶ್ವೀನೀ	ଭାଶ୍ଵୀନୀ
ಭಾಸ್ಕರಣ	ଭାସ୍କରଣ
ಭಾಸ್ಕೇರ	ଭାସ୍କେର
ಭಿಮಾಂಬಾಲಾ	ଭିମାଂବାଲା
ಭೀಮ	ଭୀମ
ಭೀಷಮ	ଭୀଷମ
ಭೀಷ್ಮ	ଭୀଷ୍ମ
ಭುವಿಕ	ଭୁଵିକ
ಭೂತೇಶ್ವರ	ଭୂତେଶ୍ଵର
ಭೂಪಾಲ	ଭୂପାଲ
ಭೂಪಾಲೀ	ଭୂପାଲୀ
ಭೂಪೇನ	ଭୂପେନ
ಭೂಮತ	ଭୂମତ
ಭೂಮಿಕಾ	ଭୂମିକା
ಭೇರವೀ	ଭେରଵୀ
ಭೇರೇಶ	ଭେରେଶ
ಭೋಲಾನಾಥ	ଭୋଲାନାଥ
ಭ್ರೀಜ	ଭ୍ରୀଜ
ಮಂಜುಶ್ರೀ	ମଂଜୁଶ୍ରୀ
ಮಂತವ್ಯ	ମଂତଵ୍ଯ
ಮಂದಾರ	ମଂଦାର
ಮಂದಿನ	ମଂଦିନ
ಮಂದೀಪಾ	ମଂଦୀପା
ಮಂಶಾ	ମଂଶା
ಮಕರ	ମକର
ಮಣಿಕಾಂತ	ମଣିକାଂତ
ಮಣಿಮಾಲಾ	ମଣିମାଲା
ಮಣಿಶಂಕರ	ମଣିଶଂକର
ಮದುರಾ	ମଦୁରା
ಮಧುಜಾ	ମଧୁଜା
ಮಧುರಾನೀ	ମଧୁରାନୀ
ಮಧುಲಿಕಾ	ମଧୁଲିକା
ಮಧುಶಾ	ମଧୁଶା
ಮನನಶ	ମନନଶ
ಮನಸ್ವೀ	ମନସ୍ଵୀ
ಮನಹರ	ମନହର
ಮನಾಗೋಬೀನದಾ	ମନାଗୋବୀନଦା
ಮನಾಲೀ	ମନାଲୀ
ಮನಿಕುನ್ತಾಲಾ	ମନିକୁନ୍ତାଲା
ಮನಿರಾಮ	ମନିରାମ
ಮನಿಶಿಕಾ	ମନିଶିକା
ಮನೀದೀಪ	ମନୀଦୀପ
ಮನೀಬಲನ	ମନୀବଲନ
ಮನೀಷಾ	ମନୀଷା
ಮನೋಜವಾಯಾ	ମନୋଜଵାଯା
ಮನೋರಥ	ମନୋରଥ
ಮನೋಹರಣ	ମନୋହରଣ
ಮನ್ನನ	ମନ୍ନନ
ಮನ್ವೀರ	ମନ୍ଵୀର
ಮರಲಾ	ମରଲା
ಮಲಯಾ	ମଲଯା
ಮಲಿಕಾ	ମଲିକା
ಮಲೀಂಗಾ	ମଲୀଂଗା
ಮಲ್ಕಾ	ମଲ୍କା
ಮಹಂತ	ମହଂତ
ಮಹಾಕಾಲ	ମହାକାଲ
ಮಹಾಗಂಗಾ	ମହାଗଂଗା
ಮಹಾತ್ಮಾ	ମହାତ୍ମା
ಮಹಾತ್ರೂ	ମହାତ୍ରୂ
ಮಹಾನ್ಯ	ମହାନ୍ଯ
ಮಹಾಬಲಾ	ମହାବଲା
ಮಹಾಬಾಲಾ	ମହାବାଲା
ಮಹಾಬುದ್ಧಿ	ମହାବୁଦ୍ଧି
ಮಹಾಲಕ್ಷ್ಮೀ	ମହାଲକ୍ଷ୍ମୀ
ಮಹಿರಂಶ	ମହିରଂଶ
ಮಹೀಧೇರ	ମହୀଧେର
ಮಹುಬಾಲಾ	ମହୁବାଲା
ಮಾಂಧುಘನೇ	ମାଂଧୁଘନେ
ಮಾಂಧುವೇಮಾನ	ମାଂଧୁଵେମାନ
ಮಾಂನಾಶ್ಯುಂ	ମାଂନାଶ୍ଯୁଂ
ಮಾಂನುರಾಈ	ମାଂନୁରାଈ
ಮಾಂನೋತ	ମାଂନୋତ
ಮಾಂಮೋನ	ମାଂମୋନ
ಮಾಇಲ	ମାଇଲ
ಮಾಗತ	ମାଗତ
ಮಾಗಧೀ	ମାଗଧୀ
ಮಾತನ	ମାତନ
ಮಾಧವನ	ମାଧଵନ
ಮಾಧುಜ	ମାଧୁଜ
ಮಾಧುರೀ	ମାଧୁରୀ
ಮಾಧುರ್ಯ	ମାଧୁର୍ଯ
ಮಾನಸ್ವೀತಾ	ମାନସ୍ଵୀତା
ಮಾನ್ಮಾತನ	ମାନ୍ମାତନ
ಮಾನ್ವಿತ	ମାନ୍ଵିତ
ಮಾಯರಾ	ମାଯରା
ಮಾರೀರಾಜ	ମାରୀରାଜ
ಮಾರುತ	ମାରୁତ
ಮಾರೂತ	ମାରୂତ
ಮಾರ್ಗಶೀ	ମାର୍ଗଶୀ
ಮಾಲವ	ମାଲଵ
ಮಾಲಾರ್ಕೋಡೀ	ମାଲାର୍କୋଡୀ
ಮಾಲ್ಲೇಶಾ	ମାଲ୍ଲେଶା
ಮಾಹಿತ	ମାହିତ
ಮೇಧೀನೀ	ମେଧୀନୀ
ಯಂಶ	ଯଂଶ
ಯಜನ	ଯଜନ
ಯಜುಸ	ଯଜୁସ
ಯದುನಂದನ	ଯଦୁନଂଦନ
ಯಶಸ್ವಿನೀ	ଯଶସ୍ଵିନୀ
ಯಶಾಲ	ଯଶାଲ
ಯಶುಸ	ଯଶୁସ
ಯಶೋದಾಗರ್ಬಾ ಸಮ್ಭೂತಾ	ଯଶୋଦାଗର୍ବା ସମ୍ଭୂତା
ಯಶ್ಯಾಸ್ಸರೀ	ଯଶ୍ଯାସ୍ସରୀ
ಯಶ್ವಾರ್ಧಾನಾ	ଯଶ୍ଵାର୍ଧାନା
ಯಾಗ್ನೀಥಾ	ଯାଗ୍ନୀଥା
ಯಾದ್ನ್ಯೇಶ	ଯାଦ୍ନ୍ଯେଶ
ಯಾಮಾಜೀತ	ଯାମାଜୀତ
ಯಾಲೀನೀ	ଯାଲୀନୀ
ಯಾಲೀಸಾಈ	ଯାଲୀସାଈ
ಯಾಶೀನೀ	ଯାଶୀନୀ
ಯಾಶ್ವನ	ଯାଶ୍ଵନ
ಯುಕ್ತಾತಮಾಂ	ଯୁକ୍ତାତମାଂ
ಯುಗಲ	ଯୁଗଲ
ಯುಗಾಂಕ	ଯୁଗାଂକ
ಯುಗಾನ್ಧರ	ଯୁଗାନ୍ଧର
ಯುಗ್ಮ	ଯୁଗ୍ମ
ಯುಥಿಕಾ	ଯୁଥିକା
ಯುಧಾವ	ଯୁଧାଵ
ಯುಧ್ಧ	ଯୁଧ୍ଧ
ಯುವಾಕ್ಷೀ	ଯୁଵାକ୍ଷୀ
ಯುವಾನೀ	ଯୁଵାନୀ
ಯುವೀ	ଯୁଵୀ
ಯುವೀನ	ଯୁଵୀନ
ಯುಸು	ଯୁସୁ
ಯೇಶಾಸ್ವೀ	ଯେଶାସ୍ଵୀ
ಯೇಶ್ವೀ	ଯେଶ୍ଵୀ
ಯೇಸ್ವಂಠ	ଯେସ୍ଵଂଠ
ಯೋಗದಾ	ଯୋଗଦା
ಯೋಗಲಕ್ಷ್ಮೀ	ଯୋଗଲକ୍ଷ୍ମୀ
ಯೋಗಾ	ଯୋଗା
ಯೋಗೀ ಶ್ರೀ	ଯୋଗୀ ଶ୍ରୀ
ಯೋಗೀಸಾಇ	ଯୋଗୀସାଇ
ಯೋಗ್ದೀಪ	ଯୋଗ୍ଦୀପ
ಯೋಗ್ರಾಮ	ଯୋଗ୍ରାମ
ಯೋನಿತಾ	ଯୋନିତା
ಯೋಹನ	ଯୋହନ
ರಂಗೀತ	ରଂଗୀତ
ರಂಗೇಶ	ରଂଗେଶ
ರಂತೀಕಾ	ରଂତୀକା
ರಕ್ತ	ରକ୍ତ
ರಕ್ಷಾತೀ	ରକ୍ଷାତୀ
ರಕ್ಷಾನಾ	ରକ୍ଷାନା
ರಕ್ಷ್ಯ	ରକ୍ଷ୍ଯ
ರಘುನನ್ದನ	ରଘୁନନ୍ଦନ
ರಘುಪತಿ	ରଘୁପତି
ರಘುಪ್ರಿಯಾ	ରଘୁପ୍ରିଯା
ರಚನಾ	ରଚନା
ರಣಜೀ	ରଣଜୀ
ರಣವಿಜಯ	ରଣଵିଜଯ
ರತಿಕಾ	ରତିକା
ರತ್ನಕುಂಡಲ	ରତ୍ନକୁଂଡଲ
ರತ್ನಾಲೀ	ରତ୍ନାଲୀ
ರತ್ನೇಶ	ରତ୍ନେଶ
ರಥನಾ	ରଥନା
ರನಾಮೀತಾ	ରନାମୀତା
ರನ್ಯ	ରନ୍ଯ
ರಮಾ  ದೇವೀ	ରମା  ଦେଵୀ
ರಮಾಕಾಂತ	ରମାକାଂତ
ರಮಿಲಾ	ରମିଲା
ರಮೋಲಾ	ରମୋଲା
ರವಿಕೀರ್ತೀ	ରଵିକୀର୍ତୀ
ರವಿಚಂದ್ರ	ରଵିଚଂଦ୍ର
ರವಿಜ	ରଵିଜ
ರವಿತಾ	ରଵିତା
ರವಿನಾ	ରଵିନା
ರವಿಶಂಕರ	ରଵିଶଂକର
ರವೀಂದ್ರ	ରଵୀଂଦ୍ର
ರಶೀಕಾ	ରଶୀକା
ರಶ್ಮೀ	ରଶ୍ମୀ
ರಶ್ಮೀಸ್ರಯಾ	ରଶ୍ମୀସ୍ରଯା
ರಸರಾಜ	ରସରାଜ
ರಸಿಕಾ	ରସିକା
ರಾಗಾ	ରାଗା
ರಾಗಾವೀ	ରାଗାଵୀ
ರಾಗಾವೀನೋದೀನೀ	ରାଗାଵୀନୋଦୀନୀ
ರಾಜಕುಮಾರೀ	ରାଜକୁମାରୀ
ರಾಜನ	ରାଜନ
ರಾಜಬೀರ	ରାଜବୀର
ರಾಜವೀ	ରାଜଵୀ
ರಾಜಸೇಕರಣ	ରାଜସେକରଣ
ರಾಜಾಹಮ್ಸನ	ରାଜାହମ୍ସନ
ರಾಜೀ	ରାଜୀ
ರಾಜ್ಕಲಾ	ରାଜ୍କଲା
ರಾಜ್ಬಲಾ	ରାଜ୍ବଲା
ರಾತ್ನಾನೀಧೀ	ରାତ୍ନାନୀଧୀ
ರಾಧೇಯಾ	ରାଧେଯା
ರಾನಾ	ରାନା
ರಾಮಚರಣ	ରାମଚରଣ
ರಾಮರಾಜ	ରାମରାଜ
ರಾಮಸುಂದರ	ରାମସୁଂଦର
ರಾಮಾದೀಪ	ରାମାଦୀପ
ರಾಯಂಶ	ରାଯଂଶ
ರಾಷೀಪ	ରାଷୀପ
ರಾಸ್ಯಾ	ରାସ୍ଯା
ರಿಶಿಮಾ	ରିଶିମା
ರಿಹಾನ	ରିହାନ
ರೀಅನಾ	ରୀଅନା
ರೀತಮಾಂ	ରୀତମାଂ
ರೀತ್ಶೀಕಾ	ରୀତ୍ଶୀକା
ರೀಥೀಶಾ	ରୀଥୀଶା
ರೀಥ್ವೀ	ରୀଥ୍ଵୀ
ರೀದ್ಧೀಮಾಂ	ରୀଦ୍ଧୀମାଂ
ರೀನ್ಸೀನ	ରୀନ୍ସୀନ
ರೀಮೀ	ରୀମୀ
ರೀಶಾನೀ	ରୀଶାନୀ
ರೀಶೋನಾ	ରୀଶୋନା
ರೀಸ್ಲುಂನಾ	ରୀସ୍ଲୁଂନା
ರೂಂಗ / ರಂಗ	ରୂଂଗ / ରଂଗ
ರೇಡ್ಡೀ	ରେଡ୍ଡୀ
ರೇಥುಶಾನಾ	ରେଥୁଶାନା
ರೇನುಕ	ରେନୁକ
ರೇಭಾ	ରେଭା
ರೇಮಾಂನೀಕಾ	ରେମାଂନୀକା
ರೇಮ್ಯಾ	ରେମ୍ଯା
ರೇವಂತ	ରେଵଂତ
ರೇಶಿಕಾ	ରେଶିକା
ರೇಹಾ	ରେହା
ರೇಹ್ನುಘಾ	ରେହ୍ନୁଘା
ಲಕೀ	ଲକୀ
ಲಕ್ಷಾಕೀ	ଲକ୍ଷାକୀ
ಲಕ್ಷಿತಾ	ଲକ୍ଷିତା
ಲಕ್ಷ್ಮಣಅಪರಣದಾತಾ	ଲକ୍ଷ୍ମଣଅପରଣଦାତା
ಲಕ್ಷ್ಮೀ	ଲକ୍ଷ୍ମୀ
ಲಕ್ಷ್ಮೀ   ನಾರಾಯಣ	ଲକ୍ଷ୍ମୀ   ନାରାଯଣ
ಲಕ್ಷ್ಮೀನ	ଲକ୍ଷ୍ମୀନ
ಲಖಿತ	ଲଖିତ
ಲಜ್ಜಕ	ଲଜ୍ଜକ
ಲಜ್ಜಾ	ଲଜ୍ଜା
ಲತಾಕಾರಾ	ଲତାକାରା
ಲಯನಾ	ଲଯନା
ಲಲಿತಾದಿತ್ಯ	ଲଲିତାଦିତ୍ଯ
ಲವಂಗೀ	ଲଵଂଗୀ
ಲವನಾ	ଲଵନା
ಲವಲೀನ	ଲଵଲୀନ
ಲವಾಮ	ଲଵାମ
ಲಾಥಾನಗೀ	ଲାଥାନଗୀ
ಲಾಬನ್ಯ	ଲାବନ୍ଯ
ಲಾಬುಕೀ	ଲାବୁକୀ
ಲಾಭಾ	ଲାଭା
ಲಾರ್ಮಿಕಾ	ଲାର୍ମିକା
ಲಾಲಸಾ	ଲାଲସା
ಲಾಲಾತೇಂದು	ଲାଲାତେଂଦୁ
ಲಾವನ್ತೀಕಾ	ଲାଵନ୍ତୀକା
ಲಾವಾಲಿಕಾ	ଲାଵାଲିକା
ಲಾಸ್ಯಾವೀ	ଲାସ୍ଯାଵୀ
ಲಿಖಿತ	ଲିଖିତ
ಲಿಮಿಯಾ	ଲିମିଯା
ಲೀಗ	ଲୀଗ
ಲೀತೀಶಾ	ଲୀତୀଶା
ಲೀನಾಥಾ	ଲୀନାଥା
ಲೀನೀತ	ଲୀନୀତ
ಲೀನ್ಗದೇವಾರುಂ	ଲୀନ୍ଗଦେଵାରୁଂ
ಲೀನ್ಗರಾಜಾ	ଲୀନ୍ଗରାଜା
ಲೀನ್ಗೀಃ	ଲୀନ୍ଗୀଃ
ಲೀಪಿಕಾ	ଲୀପିକା
ಲೀಲಾಮಈ	ଲୀଲାମଈ
ಲೀಲಾವತೀ	ଲୀଲାଵତୀ
ಲೀಶಾ	ଲୀଶା
ಲುಕೇಶ	ଲୁକେଶ
ಲುಪೇಶ	ଲୁପେଶ
ಲೇಈಶಾ	ଲେଈଶା
ಲೇಕ್ಯಾ	ଲେକ୍ଯା
ಲೇಕ್ಷಾನಾ	ଲେକ୍ଷାନା
ಲೇಖಕ	ଲେଖକ
ಲೇಖೀಶಾ	ଲେଖୀଶା
ಲೋಕಪ್ರಕಾಶ	ଲୋକପ୍ରକାଶ
ಲೋಕಾಕೃತಿ	ଲୋକାକୃତି
ಲೋಕಾಜನಾನೀ	ଲୋକାଜନାନୀ
ಲೋಕಾಧ್ಯಕ್ಷ	ଲୋକାଧ୍ଯକ୍ଷ
ಲೋಕ್ಭುಶನ	ଲୋକ୍ଭୁଶନ
ಲೋಕ್ಷೀ	ଲୋକ୍ଷୀ
ಲೋಗಚಾನ್ದ್ರಣ	ଲୋଗଚାନ୍ଦ୍ରଣ
ಲೋಗನ	ଲୋଗନ
ಲೋಗನಾಥನ	ଲୋଗନାଥନ
ಲೋಗೀನೀ	ଲୋଗୀନୀ
ಲೋಗೇಶ	ଲୋଗେଶ
ಲೋನಾ	ଲୋନା
ಲೋಮಶ	ଲୋମଶ
ಲೋಮಾಂಕೇಶ	ଲୋମାଂକେଶ
ಲೋಲೀಥ್ಯಾ	ଲୋଲୀଥ୍ଯା
ಲೋವೇಯಂಶ	ଲୋଵେଯଂଶ
ಲೋಶೀನೀ	ଲୋଶୀନୀ
ಲೋಹೀತಾ	ଲୋହୀତା
ಲೋಹೀತ್ಸರಣ	ଲୋହୀତ୍ସରଣ
ವಂಶಿಕಾ	ଵଂଶିକା
ವಕ್ರತುನ್ಡಾ	ଵକ୍ରତୁନ୍ଡା
ವಕ್ಷ	ଵକ୍ଷ
ವಚನ	ଵଚନ
ವತ್ಸಲಾ	ଵତ୍ସଲା
ವರಲಕ್ಷ್ಮೀ	ଵରଲକ୍ଷ୍ମୀ
ವರ್ದಾನೀ	ଵର୍ଦାନୀ
ವರ್ಧಾನೀ	ଵର୍ଧାନୀ
ವರ್ನೀಥಾ	ଵର୍ନୀଥା
ವರ್ಷಾನ	ଵର୍ଷାନ
ವಲ್ಲಭೀ	ଵଲ୍ଲଭୀ
ವಶೀತಾ	ଵଶୀତା
ವಸತೀನ	ଵସତୀନ
ವಸಾ	ଵସା
ವಸೀಸತಾ	ଵସୀସତା
ವಸುಧಾ	ଵସୁଧା
ವಸುಮಿತ್ರ	ଵସୁମିତ୍ର
ವಸುರೂಪ	ଵସୁରୂପ
ವಸುಶ	ଵସୁଶ
ವಸ್ಥಾವೀ	ଵସ୍ଥାଵୀ
ವಹೀಂ	ଵହୀଂ
ವಾಕ್ಶಾನಾ	ଵାକ୍ଶାନା
ವಾಗ್ಮೀನ	ଵାଗ୍ମୀନ
ವಾಜ್ರಕ್ಷ	ଵାଜ୍ରକ୍ଷ
ವಾಜ್ರನಾಖಾ	ଵାଜ୍ରନାଖା
ವಾತ್ಸಲ್ರಾಜ	ଵାତ୍ସଲ୍ରାଜ
ವಾದಿವೇಲನ	ଵାଦିଵେଲନ
ವಾದಿವೇಲುಂ	ଵାଦିଵେଲୁଂ
ವಾದೀರಾಜ	ଵାଦୀରାଜ
ವಾನಿಶ್ರೀ	ଵାନିଶ୍ରୀ
ವಾನುಜಾ	ଵାନୁଜା
ವಾಮನ	ଵାମନ
ವಾಮಾಂಕ್ಷೀ	ଵାମାଂକ୍ଷୀ
ವಾಮಿಲ	ଵାମିଲ
ವಾಮ್ಶೀಥಾ	ଵାମ୍ଶୀଥା
ವಾಯಾ	ଵାଯା
ವಾಯು	ଵାଯୁ
ವಾಸನ	ଵାସନ
ವಾಸು	ଵାସୁ
ವಾಸುಮಾಂಥಾ	ଵାସୁମାଂଥା
ವಿಅರ	ଵିଅର
ವಿಕ್ಟೋರಿಯಾ	ଵିକ୍ଟୋରିଯା
ವಿಕ್ರಾಂತಿ	ଵିକ୍ରାଂତି
ವಿಜಯಾಲಕ್ಷ್ಮೀ	ଵିଜଯାଲକ୍ଷ୍ମୀ
ವಿಜೀತಾ	ଵିଜୀତା
ವಿಜುಲ	ଵିଜୁଲ
ವಿದಿಶಾ	ଵିଦିଶା
ವಿದ್ವಾಥ	ଵିଦ୍ଵାଥ
ವಿನತಿ	ଵିନତି
ವಿನಸ	ଵିନସ
ವಿನಾ	ଵିନା
ವಿನಾಥೀ	ଵିନାଥୀ
ವಿನಾಯಿಕಾ	ଵିନାଯିକା
ವಿನ್ದ್ಯಾ	ଵିନ୍ଦ୍ଯା
ವಿಭಾಸ	ଵିଭାସ
ವಿಭೀ	ଵିଭୀ
ವಿಭೂಷ	ଵିଭୂଷ
ವಿಮಲಾ	ଵିମଲା
ವಿರಬಾಬು	ଵିରବାବୁ
ವಿಲಾಸಿನೀ	ଵିଲାସିନୀ
ವಿಹಾನೀ	ଵିହାନୀ
ವಿಹಾರಿಕಾ	ଵିହାରିକା
ವೀಅಲಾಶೀನೀ	ଵୀଅଲାଶୀନୀ
ವೇಂಕಟ ಮಾನೀ	ଵେଂକଟ ମାନୀ
ವೇತ್ರೀ	ଵେତ୍ରୀ
ವೇದನ್ಜಾನಾ	ଵେଦନ୍ଜାନା
ವೇದಾಂಗ	ଵେଦାଂଗ
ವೇದಾತ್ಮನೇ	ଵେଦାତ୍ମନେ
ವೇದಾಸ್ವರೂಪೀ	ଵେଦାସ୍ଵରୂପୀ
ವೇದೀಥಾ	ଵେଦୀଥା
ವೇದ್ವಿಯನ	ଵେଦ୍ଵିଯନ
ವೇಧಾವಲ್ಲೀ	ଵେଧାଵଲ୍ଲୀ
ವೇನಮಾಂಥೀ	ଵେନମାଂଥୀ
ವೇನಾ	ଵେନା
ವೇನೀ	ଵେନୀ
ವೇನ್ಕಟಾಗೀರೀ	ଵେନ୍କଟାଗୀରୀ
ವೇನ್ಕಟೇಶಾ	ଵେନ୍କଟେଶା
ವೇನ್ಕನಾ	ଵେନ୍କନା
ವೇಲ್ಕ್ಯ	ଵେଲ୍କ୍ଯ
ವೇವೇಶಾ	ଵେଵେଶା
ವೈಗಾ	ଵୈଗା
ವೈಜಯಂತೀ	ଵୈଜଯଂତୀ
ವೈಜಯೀ	ଵୈଜଯୀ
ವೈದಿಕ	ଵୈଦିକ
ವೈದೀಕಾ	ଵୈଦୀକା
ವೈಧೇ	ଵୈଧେ
ವೈಧ್ಯಾತ	ଵୈଧ୍ଯାତ
ಶೈಲೇಶ	ଶୈଲେଶ
ಸಂಗಮ	ସଂଗମ
ಸಂಗೀತಾ	ସଂଗୀତା
ಸಂಚಾನಾ	ସଂଚାନା
ಸಂಜಾಣಥೀ	ସଂଜାଣଥୀ
ಸಂಜೀವ	ସଂଜୀଵ
ಸಂಜೀವೀ	ସଂଜୀଵୀ
ಸಂಜುಕ್ಥಾ	ସଂଜୁକ୍ଥା
ಸಂಥೀನೀ	ସଂଥୀନୀ
ಸಂದೀಪ್ತಾ	ସଂଦୀପ୍ତା
ಸಂಧರಾ	ସଂଧରା
ಸಂಪದಾ	ସଂପଦା
ಸಂಮತ	ସଂମତ
ಸಕ್ಥೀದಾರ	ସକ୍ଥୀଦାର
ಸಖಾ	ସଖା
ಸಗ್ನೀಕ	ସଗ୍ନୀକ
ಸಚ್ಚಿತ	ସଚ୍ଚିତ
ಸಚ್ಚಿದಾನಂದ ವಿಗ್ರಹ	ସଚ୍ଚିଦାନଂଦ ଵିଗ୍ରହ
ಸಜೂ	ସଜୂ
ಸದಗತಾ	ସଦଗତା
ಸನಾತನ	ସନାତନ
ಸನಾಥ	ସନାଥ
ಸಫ಼ಲಾ	ସଫ଼ଲା
ಸಫ್ಫರ	ସଫ୍ଫର
ಸಬರಿಶ	ସବରିଶ
ಸಬಿತಾ	ସବିତା
ಸಮಕ್ಷ	ସମକ୍ଷ
ಸಮಜ	ସମଜ
ಸಮನ್ಯು	ସମନ୍ଯୁ
ಸಮಬರಣ	ସମବରଣ
ಸಮಭಾವನ	ସମଭାଵନ
ಸಮಾಂನ್ವಿತಾ	ସମାଂନ୍ଵିତା
ಸಮಾಂಶ್ರಯ	ସମାଂଶ୍ରଯ
ಸಮಿಕ	ସମିକ
ಸಮೀರ	ସମୀର
ಸಮೀರಾ	ସମୀରା
ಸಮುದಾಯ	ସମୁଦାଯ
ಸಮುದ್ರಾ	ସମୁଦ୍ରା
ಸಮೇಂದು	ସମେଂଦୁ
ಸಮ್ಪ್ರಸಾದ	ସମ୍ପ୍ରସାଦ
ಸಮ್ಪ್ರಿತೀ	ସମ୍ପ୍ରିତୀ
ಸಮ್ಬತ	ସମ୍ବତ
ಸಮ್ಮಾದ	ସମ୍ମାଦ
ಸಮ್ಯಕ	ସମ୍ଯକ
ಸಮ್ಶೀನೀ	ସମ୍ଶୀନୀ
ಸಮ್ಸ್ಕಾರಾ	ସମ୍ସ୍କାରା
ಸಮ್ಹೀಠಾ	ସମ୍ହୀଠା
ಸರಜಾ	ସରଜା
ಸರಿಶಾ	ସରିଶା
ಸರ್ಗಿನೀ	ସର୍ଗିନୀ
ಸಹಶ್ರದ	ସହଶ୍ରଦ
ಸಾಈ ಅರ್ಜುನ	ସାଈ ଅର୍ଜୁନ
ಸಾಈ ಶ್ರೀ	ସାଈ ଶ୍ରୀ
ಸಾಈ ಸತ್ಪುರುಷಾ	ସାଈ ସତ୍ପୁରୁଷା
ಸಾಈ ಸುರಿಯಾ	ସାଈ ସୁରିଯା
ಸಾತ್ವಿಕ	ସାତ୍ଵିକ
ಸಾತ್ವಿಕಾ	ସାତ୍ଵିକା
ಸಾದರೀ	ସାଦରୀ
ಸಾದ್ವಿಥಾ	ସାଦ୍ଵିଥା
ಸಾಧ್ಯ	ସାଧ୍ଯ
ಸಾನಾವೀ	ସାନାଵୀ
ಸಾಬೀತ್ರೀ	ସାବୀତ୍ରୀ
ಸಾಮಂತ	ସାମଂତ
ಸಾಮೋದ	ସାମୋଦ
ಸಾಮ್ರೀನ	ସାମ୍ରୀନ
ಸಾಯರಾಮ	ସାଯରାମ
ಸಾರಂಗೀ	ସାରଂଗୀ
ಸಾರಸೀ	ସାରସୀ
ಸಾರಾನ್ಯ	ସାରାନ୍ଯ
ಸಾರಾಹ	ସାରାହ
ಸಾವಿತ್ರ	ସାଵିତ୍ର
ಸೈಕತ	ସୈକତ
ಸೈಜಾಸೀ	ସୈଜାସୀ
ಸೈನಿ	ସୈନି
ಸೈನೀತ್ಯ	ସୈନୀତ୍ଯ
ಸೈನ್ಧಾವ	ସୈନ୍ଧାଵ
ಹಂಸಾ	ହଂସା
ಹಂಸಿನ	ହଂସିନ
ಹಂಸ್ಧ್ವಾನೀ	ହଂସ୍ଧ୍ଵାନୀ
ಹಜೇಶ	ହଜେଶ
ಹನೀತಾ	ହନୀତା
ಹನೀಮಾ	ହନୀମା
ಹನೀಶ್ಕಾ	ହନୀଶ୍କା
ಹಮಸಾನಂದೀನೀ	ହମସାନଂଦୀନୀ
ಹಯಾತೀ	ହଯାତୀ
ಹರನೀಶ	ହରନୀଶ
ಹರಿಅಕ್ಸಾ	ହରିଅକ୍ସା
ಹರಿಕಿಶನ	ହରିକିଶନ
ಹರಿತ	ହରିତ
ಹರಿದಾ	ହରିଦା
ಹರಿದಾಸ	ହରିଦାସ
ಹರಿನ್ದ್ರನಾಥ	ହରିନ୍ଦ୍ରନାଥ
ಹರಿಪ್ರಸಾದ	ହରିପ୍ରସାଦ
ಹರಿವಂಶ	ହରିଵଂଶ
ಹರೀಜ	ହରୀଜ
ಹರೀಥ್ರಾ	ହରୀଥ୍ରା
ಹರೀಧಾಮ	ହରୀଧାମ
ಹರೀಮಾಂರ್ಕಾತಾಮಾಂರ್ಕತಾ	ହରୀମାଂର୍କାତାମାଂର୍କତା
ಹರೀಶ್ರೀ	ହରୀଶ୍ରୀ
ಹರೀಸಾಈ	ହରୀସାଈ
ಹರೇಕೃಷ್ಣ	ହରେକୃଷ୍ଣ
ಹರ್ಕೇಶ	ହର୍କେଶ
ಹರ್ಥೀಕಾ	ହର୍ଥୀକା
ಹರ್ಯಾಕ್ಷಾ	ହର୍ଯାକ୍ଷା
ಹರ್ಲೇಯ	ହର୍ଲେଯ
ಹರ್ಶಾಶ್ರೀ	ହର୍ଶାଶ୍ରୀ
ಹರ್ಷವರ್ದನ	ହର୍ଷଵର୍ଦନ
ಹರ್ಷಿತ	ହର୍ଷିତ
ಹವೀಹ	ହଵୀହ
ಹಶ್ವರ್ಧನ	ହଶ୍ଵର୍ଧନ
ಹಸಂತ	ହସଂତ
ಹಾಕೇಶ	ହାକେଶ
ಹಾರ್ಶೀನೀ	ହାର୍ଶୀନୀ
ಹಾಸಂಥೀ	ହାସଂଥୀ
ಹಿಡಿಂಬಾ	ହିଡିଂବା
ಹಿತಾಂಶು	ହିତାଂଶୁ
ಹಿತಾಂಸೀ	ହିତାଂସୀ
ಹಿತೀ	ହିତୀ
ಹಿತೀಕ್ಷಾ	ହିତୀକ୍ଷା
ಹಿತೇನ್ದ್ರ	ହିତେନ୍ଦ୍ର
ಹಿತೈಷೀ	ହିତୈଷୀ
ಹಿಥೀಕ್ಸಾ	ହିଥୀକ୍ସା
ಹಿಮವಂತ	ହିମଵଂତ
ಹಿಮಾಂಕ	ହିମାଂକ
ಹಿಮಾಂನಿಶ	ହିମାଂନିଶ
ಹಿಮಾಂನ್ಗೀನೀ	ହିମାଂନ୍ଗୀନୀ
ಹಿಮಾಂಸೇಖರ	ହିମାଂସେଖର
ಹಿಮಾದ್ರೀ	ହିମାଦ୍ରୀ
ಹಿಮಾನ್ಸು	ହିମାନ୍ସୁ
ಹಿಯಾ	ହିଯା
ಹಿಲೀ	ହିଲୀ
ಹೀಥಾ	ହୀଥା
ಹೀಮೀರ	ହୀମୀର
ಹುಮೀಶಾ	ହୁମୀଶା
ಹುವೇನ್ದ್ರ	ହୁଵେନ୍ଦ୍ର
ಹೇತ	ହେତ
ಹೇತವ	ହେତଵ
ಹೇತಾಂಶೀ	ହେତାଂଶୀ
ಹೇತ್ವಿಕ	ହେତ୍ଵିକ
ಹೇಥಾನ್ಶ್ರೀ	ହେଥାନ୍ଶ୍ରୀ
ಹೇನಾ	ହେନା
ಹೇನೀತ	ହେନୀତ
ಹೇನ್ಸೀ	ହେନ୍ସୀ
ಹೇಮ ಲಥಾ	ହେମ ଲଥା
ಹೇಮಚಂದರ	ହେମଚଂଦର
ಹೇಮಾಕೇಶ	ହେମାକେଶ
ಹೇಮೀತಾ	ହେମୀତା
ಹೇಮೀತ್ರಾ	ହେମୀତ୍ରା
ಹೇಮೀನ	ହେମୀନ
ಹೇಮೇಂದ್ರ	ହେମେଂଦ୍ର
ಹೇರಕ	ହେରକ
ಹೇರೀ	ହେରୀ
ಹೇಲಸಾ	ହେଲସା
ಹೇಲಾ	ହେଲା
ಹೇಲ್ಲ್ಯ	ହେଲ୍ଲ୍ଯ
ಹೋಜನ	ହୋଜନ
ಹೋಯಲಾ	ହୋଯଲା
ಹ್ರೀತೀಕಾ	ହ୍ରୀତୀକା
ಹ್ರೀದೇಶ	ହ୍ରୀଦେଶ
ಹ್ರೀದ್ಯೇಸಾ	ହ୍ରୀଦ୍ଯେସା
ಹ್ರೀಶನ	ହ୍ରୀଶନ
#
#
# Territory names from CLDR
ಅಸೆನ್ಶನ್ ದ್ವೀಪ	ଅସେନ୍ଶନ୍ ଦ୍ଵୀପ
ಅಂಡೋರಾ	ଅଂଡୋରା
ಸಂಯುಕ್ತ ಅರಬ್ ಎಮಿರೇಟಸ್	ସଂଯୁକ୍ତ ଅରବ୍ ଏମିରେଟସ୍
ಅಫಘಾನಿಸ್ಥಾನ್	ଅଫଘାନିସ୍ଥାନ୍
ಆಂಟಿಗುವಾ ಮತ್ತು ಬರ್ಬುಡಾ	ଆଂଟିଗୁଵା ମତ୍ତୁ ବର୍ବୁଡା
ಆಂಗುಯಿಲ್ಲಾ	ଆଂଗୁଯିଲ୍ଲା
ಅಲ್ಬೇನಿಯಾ	ଅଲ୍ବେନିଯା
ಅರ್ಮೇನಿಯಾ	ଅର୍ମେନିଯା
ಅಂಗೋಲಾ	ଅଂଗୋଲା
ಅಂಟಾರ್ಟಿಕಾ	ଅଂଟାର୍ଟିକା
ಅರ್ಜೆಂಟಿನಾ	ଅର୍ଜେଂଟିନା
ಅಮೇರಿಕನ್ ಸಮೋವಾ	ଅମେରିକନ୍ ସମୋଵା
ಆಸ್ಟ್ರಿಯಾ	ଆସ୍ଟ୍ରିଯା
ಆಸ್ಟ್ರೇಲಿಯ	ଆସ୍ଟ୍ରେଲିଯ
ಅರುಬಾ	ଅରୁବା
ಆಲ್ಯಾಂಡ್ ದ್ವೀಪಗಳು	ଆଲ୍ଯାଂଡ୍ ଦ୍ଵୀପଗଳୁ
ಅಜರ್ಬೈಜಾನ್	ଅଜର୍ବୈଜାନ୍
ಬೋಸ್ನಿಯಾ ಮತ್ತು ಹರ್ಜೆಗೋವಿನಾ	ବୋସ୍ନିଯା ମତ୍ତୁ ହର୍ଜେଗୋଵିନା
ಬಾರ್ಬಡೋಸ್	ବାର୍ବଡୋସ୍
ಬಾಂಗ್ಲಾದೇಶ್	ବାଂଗ୍ଲାଦେଶ୍
ಬೆಲ್ಜಿಯಮ್	ବେଲ୍ଜିଯମ୍
ಬುರ್ಕಿನಾ ಫಾಸೋ	ବୁର୍କିନା ଫାସୋ
ಬಲ್ಗೇರಿಯಾ	ବଲ୍ଗେରିଯା
ಬಹರೈನ್	ବହରୈନ୍
ಬುರುಂಡಿ	ବୁରୁଂଡି
ಬೆನಿನ್	ବେନିନ୍
ಸೇಂಟ್ ಬಾರ್ಥೆಲೆಮಿ	ସେଂଟ୍ ବାର୍ଥେଲେମି
ಬರ್ಮುಡಾ	ବର୍ମୁଡା
ಬ್ರೂನಿ	ବ୍ରୂନି
ಬೊಲಿವಿಯಾ	ବୋଲିଵିଯା
ಕೆರೀಬಿಯನ್ ನೆದರ್‌ಲ್ಯಾಂಡ್ಸ್	କେରୀବିଯନ୍ ନେଦର୍‌ଲ୍ଯାଂଡ୍ସ୍
ಬ್ರೆಜಿಲ್	ବ୍ରେଜିଲ୍
ಬಹಾಮಾಸ್	ବହାମାସ୍
ಭೂತಾನ್	ଭୂତାନ୍
ಬೋವೆಟ್ ದ್ವೀಪ	ବୋଵେଟ୍ ଦ୍ଵୀପ
ಬೋಟ್ಸ್‌ವಾನಾ	ବୋଟ୍ସ୍‌ଵାନା
ಬೆಲಾರಸ್	ବେଲାରସ୍
ಬೆಲಿಜ್	ବେଲିଜ୍
ಕೆನಡಾ	କେନଡା
ಕೊಕೊಸ್ (ಕೀಲಿಂಗ್) ದ್ವೀಪಗಳು	କୋକୋସ୍ (କୀଲିଂଗ୍) ଦ୍ଵୀପଗଳୁ
ಕಾಂಗೋ - ಕಿನ್ಶಾಸಾ	କାଂଗୋ - କିନ୍ଶାସା
ಕಾಂಗೋ (DRC)	କାଂଗୋ (DRC)
ಮಧ್ಯ ಆಫ್ರಿಕಾ ಗಣರಾಜ್ಯ	ମଧ୍ଯ ଆଫ୍ରିକା ଗଣରାଜ୍ଯ
ಕಾಂಗೋ - ಬ್ರಾಜಾವಿಲ್ಲೇ	କାଂଗୋ - ବ୍ରାଜାଵିଲ୍ଲେ
ಕಾಂಗೋ (ಗಣರಾಜ್ಯ)	କାଂଗୋ (ଗଣରାଜ୍ଯ)
ಸ್ವಿಟ್ಜರ್ಲ್ಯಾಂಡ್	ସ୍ଵିଟ୍ଜର୍ଲ୍ଯାଂଡ୍
ಕೋತ್‌ ದಿವಾರ್‍	କୋତ୍‌ ଦିଵାର୍‍
ಐವರಿ ಕೋಸ್ಟ್	ଐଵରି କୋସ୍ଟ୍
ಕುಕ್ ದ್ವೀಪಗಳು	କୁକ୍ ଦ୍ଵୀପଗଳୁ
ಚಿಲಿ	ଚିଲି
ಕ್ಯಾಮರೋನ್	କ୍ଯାମରୋନ୍
ಚೀನಾ	ଚୀନା
ಕೊಲಂಬಿಯಾ	କୋଲଂବିଯା
ಕ್ಲಿಪ್ಪರ್‌ಟಾನ್ ದ್ವೀಪಗಳು	କ୍ଲିପ୍ପର୍‌ଟାନ୍ ଦ୍ଵୀପଗଳୁ
ಕೊಸ್ಟಾ ರಿಕಾ	କୋସ୍ଟା ରିକା
ಕ್ಯೂಬಾ	କ୍ଯୂବା
ಕೇಪ್ ವರ್ಡೆ	କେପ୍ ଵର୍ଡେ
ಕುರಾಕಾವ್	କୁରାକାଵ୍
ಕ್ರಿಸ್ಮಸ್ ದ್ವೀಪ	କ୍ରିସ୍ମସ୍ ଦ୍ଵୀପ
ಸೈಪ್ರಸ್	ସୈପ୍ରସ୍
ಚೆಕ್ ರಿಪಬ್ಲಿಕ್	ଚେକ୍ ରିପବ୍ଲିକ୍
ಜರ್ಮನಿ	ଜର୍ମନି
ಡೈಗೋ ಗಾರ್ಸಿಯ	ଡୈଗୋ ଗାର୍ସିଯ
ಜಿಬೋಟಿ	ଜିବୋଟି
ಡೆನ್ಮಾರ್ಕ್	ଡେନ୍ମାର୍କ୍
ಡೊಮಿನಿಕಾ	ଡୋମିନିକା
ಡೊಮೆನಿಕನ್ ರಿಪಬ್ಲಿಕ್	ଡୋମେନିକନ୍ ରିପବ୍ଲିକ୍
ಅಲ್ಗೇರಿಯಾ	ଅଲ୍ଗେରିଯା
ಸೆಯುಟಾ ಹಾಗೂ ಮೆಲಿಲ್ಲಾ	ସେଯୁଟା ହାଗୂ ମେଲିଲ୍ଲା
ಈಕ್ವೆಡಾರ್	ଈକ୍ଵେଡାର୍
ಎಸ್ಟೋನಿಯಾ	ଏସ୍ଟୋନିଯା
ಈಜಿಪ್ಟ್	ଈଜିପ୍ଟ୍
ಪಶ್ಚಿಮ ಸಹಾರಾ	ପଶ୍ଚିମ ସହାରା
ಏರಿಟ್ರಿಯಾ	ଏରିଟ୍ରିଯା
ಸ್ಪೇನ್	ସ୍ପେନ୍
ಇಥಿಯೋಪಿಯಾ	ଇଥିଯୋପିଯା
ಯುರೋಪಿಯನ್ ಯೂನಿಯನ್	ଯୁରୋପିଯନ୍ ଯୂନିଯନ୍
ಫಿನ್‌ಲ್ಯಾಂಡ್	ଫିନ୍‌ଲ୍ଯାଂଡ୍
ಫಿಜಿ	ଫିଜି
ಫಾಲ್ಕ್‌ಲ್ಯಾಂಡ್ ದ್ವೀಪಗಳು	ଫାଲ୍କ୍‌ଲ୍ଯାଂଡ୍ ଦ୍ଵୀପଗଳୁ
ಫಾಲ್ಕ್‌ಲ್ಯಾಂಡ್ ದ್ವೀಪಗಳು (ಇಸ್ಲಾಸ್ ಮಾಲ್ವಿನಸ್)	ଫାଲ୍କ୍‌ଲ୍ଯାଂଡ୍ ଦ୍ଵୀପଗଳୁ (ଇସ୍ଲାସ୍ ମାଲ୍ଵିନସ୍)
ಮೈಕ್ರೋನೇಶಿಯಾ	ମୈକ୍ରୋନେଶିଯା
ಫರೋ ದ್ವೀಪಗಳು	ଫରୋ ଦ୍ଵୀପଗଳୁ
ಫ್ರಾನ್ಸ್	ଫ୍ରାନ୍ସ୍
ಗೆಬೊನ್	ଗେବୋନ୍
ಬ್ರಿಟನ್/ಇಂಗ್ಲೆಂಡ್	ବ୍ରିଟନ୍/ଇଂଗ୍ଲେଂଡ୍
ಗ್ರೆನೆಡಾ	ଗ୍ରେନେଡା
ಜಾರ್ಜಿಯಾ	ଜାର୍ଜିଯା
ಫ್ರೆಂಚ್ ಗಯಾನಾ	ଫ୍ରେଂଚ୍ ଗଯାନା
ಗುರ್ನ್‌ಸೆ	ଗୁର୍ନ୍‌ସେ
ಘಾನಾ	ଘାନା
ಗಿಬ್ರಾಲ್ಟರ್	ଗିବ୍ରାଲ୍ଟର୍
ಗ್ರೀನ್‌ಲ್ಯಾಂಡ್	ଗ୍ରୀନ୍‌ଲ୍ଯାଂଡ୍
ಗ್ಯಾಂಬಿಯಾ	ଗ୍ଯାଂବିଯା
ಗಿನಿ	ଗିନି
ಗುಡೆಲೋಪ್	ଗୁଡେଲୋପ୍
ಈಕ್ವೆಟೋರಿಯಲ್ ಗಿನಿ	ଈକ୍ଵେଟୋରିଯଲ୍ ଗିନି
ಗ್ರೀಸ್	ଗ୍ରୀସ୍
ದಕ್ಷಿಣ ಜಾರ್ಜಿಯಾ ಮತ್ತು ದಕ್ಷಿಣ ಸ್ಯಾಂಡ್‍ವಿಚ್ ದ್ವೀಪಗಳು	ଦକ୍ଷିଣ ଜାର୍ଜିଯା ମତ୍ତୁ ଦକ୍ଷିଣ ସ୍ଯାଂଡ୍‍ଵିଚ୍ ଦ୍ଵୀପଗଳୁ
ಗ್ವಾಟೆಮಾಲಾ	ଗ୍ଵାଟେମାଲା
ಗುಯಾಮ್	ଗୁଯାମ୍
ಗಿನಿ-ಬಿಸ್ಸಾವ್	ଗିନି-ବିସ୍ସାଵ୍
ಗಯಾನಾ	ଗଯାନା
ಹಾಂಗ್ ಕಾಂಗ್ SAR ಚೈನಾ	ହାଂଗ୍ କାଂଗ୍ SAR ଚୈନା
ಹಾಂಗ್ ಕಾಂಗ್	ହାଂଗ୍ କାଂଗ୍
ಹರ್ಡ್ ದ್ವೀಪ ಮತ್ತು ಮ್ಯಾಕ್‍ಡೊನಾಲ್ಡ್ ದ್ವೀಪಗಳು	ହର୍ଡ୍ ଦ୍ଵୀପ ମତ୍ତୁ ମ୍ଯାକ୍‍ଡୋନାଲ୍ଡ୍ ଦ୍ଵୀପଗଳୁ
ಹೊಂಡುರಾಸ್	ହୋଂଡୁରାସ୍
ಕ್ರೊಯೇಶಿಯಾ	କ୍ରୋଯେଶିଯା
ಹೈಟಿ	ହୈଟି
ಹಂಗಾರಿ	ହଂଗାରି
ಕ್ಯಾನರಿ ದ್ವೀಪಗಳು	କ୍ଯାନରି ଦ୍ଵୀପଗଳୁ
ಇಂಡೋನೇಶಿಯಾ	ଇଂଡୋନେଶିଯା
ಐರ್ಲೆಂಡ್	ଐର୍ଲେଂଡ୍
ಇಸ್ರೇಲ್	ଇସ୍ରେଲ୍
ಐಲ್ ಆಫ್ ಮ್ಯಾನ್	ଐଲ୍ ଆଫ୍ ମ୍ଯାନ୍
ಭಾರತ	ଭାରତ
ಬ್ರಿಟೀಶ್ ಇಂಡಿಯನ್ ಮಹಾಸಾಗರ ಪ್ರದೇಶ	ବ୍ରିଟୀଶ୍ ଇଂଡିଯନ୍ ମହାସାଗର ପ୍ରଦେଶ
ಇರಾಕ್	ଇରାକ୍
ಇರಾನ್	ଇରାନ୍
ಐಸ್‌ಲ್ಯಾಂಡ್	ଐସ୍‌ଲ୍ଯାଂଡ୍
ಇಟಲಿ	ଇଟଲି
ಜೆರ್ಸಿ	ଜେର୍ସି
ಜಮೈಕಾ	ଜମୈକା
ಜೋರ್ಡಾನ್	ଜୋର୍ଡାନ୍
ಜಪಾನ್	ଜପାନ୍
ಕೀನ್ಯಾ	କୀନ୍ଯା
ಕಿರ್ಗಿಸ್ಥಾನ್	କିର୍ଗିସ୍ଥାନ୍
ಕಾಂಬೋಡಿಯಾ	କାଂବୋଡିଯା
ಕಿರಿಬಾತಿ	କିରିବାତି
ಕೊಮೊರೊಸ್	କୋମୋରୋସ୍
ಸೇಂಟ್ ಕಿಟ್ಸ್ ಮತ್ತು ನೆವಿಸ್	ସେଂଟ୍ କିଟ୍ସ୍ ମତ୍ତୁ ନେଵିସ୍
ಉತ್ತರ ಕೋರಿಯಾ	ଉତ୍ତର କୋରିଯା
ದಕ್ಷಿಣ ಕೋರಿಯಾ	ଦକ୍ଷିଣ କୋରିଯା
ಕುವೈತ್	କୁଵୈତ୍
ಕೇಮನ್ ದ್ವೀಪಗಳು	କେମନ୍ ଦ୍ଵୀପଗଳୁ
ಕಝಾಕಿಸ್ಥಾನ್	କଝାକିସ୍ଥାନ୍
ಲಾವೋಸ್	ଲାଵୋସ୍
ಲೆಬನಾನ್	ଲେବନାନ୍
ಸೇಂಟ್ ಲೂಸಿಯಾ	ସେଂଟ୍ ଲୂସିଯା
ಲಿಚೆನ್‌ಸ್ಟೈನ್	ଲିଚେନ୍‌ସ୍ଟୈନ୍
ಶ್ರೀಲಂಕಾ	ଶ୍ରୀଲଂକା
ಲಿಬೇರಿಯಾ	ଲିବେରିଯା
ಲೆಸೊಥೋ	ଲେସୋଥୋ
ಲಿಥುವೇನಿಯಾ	ଲିଥୁଵେନିଯା
ಲಕ್ಸಂಬರ್ಗ್	ଲକ୍ସଂବର୍ଗ୍
ಲಾಟ್ವಿಯಾ	ଲାଟ୍ଵିଯା
ಲಿಬಿಯಾ	ଲିବିଯା
ಮೊರಾಕ್ಕೊ	ମୋରାକ୍କୋ
ಮೊನಾಕೊ	ମୋନାକୋ
ಮೊಲ್ಡೋವಾ	ମୋଲ୍ଡୋଵା
ಮೊಂಟೆನೆಗ್ರೋ	ମୋଂଟେନେଗ୍ରୋ
ಸೇಂಟ್ ಮಾರ್ಟಿನ್	ସେଂଟ୍ ମାର୍ଟିନ୍
ಮಡಗಾಸ್ಕರ್	ମଡଗାସ୍କର୍
ಮಾರ್ಷಲ್ ದ್ವೀಪಗಳು	ମାର୍ଷଲ୍ ଦ୍ଵୀପଗଳୁ
ಮ್ಯಾಸಿಡೋನಿಯಾ	ମ୍ଯାସିଡୋନିଯା
ಮ್ಯಾಸಿಡೋನಿಯ (FYROM)	ମ୍ଯାସିଡୋନିଯ (FYROM)
ಮಾಲಿ	ମାଲି
ಮಯನ್ಮಾರ್ (ಬರ್ಮಾ)	ମଯନ୍ମାର୍ (ବର୍ମା)
ಮೊಂಗೋಲಿಯಾ	ମୋଂଗୋଲିଯା
ಮಖಾವ್ (SAR) ಚೈನಾ	ମଖାଵ୍ (SAR) ଚୈନା
ಮಖಾವ್	ମଖାଵ୍
ಉತ್ತರ ಮರಿಯಾನಾ ದ್ವೀಪಗಳು	ଉତ୍ତର ମରିଯାନା ଦ୍ଵୀପଗଳୁ
ಮಾರ್ಟಿನಿಕ್	ମାର୍ଟିନିକ୍
ಮಾರಿಟೇನಿಯಾ	ମାରିଟେନିଯା
ಮಾಂಟ್‌ಸೆರೇಟ್	ମାଂଟ୍‌ସେରେଟ୍
ಮಾಲ್ಟಾ	ମାଲ୍ଟା
ಮಾರಿಶಿಯಸ್	ମାରିଶିଯସ୍
ಮಾಲ್ಡಿವ್ಸ್	ମାଲ୍ଡିଵ୍ସ୍
ಮಲಾವಿ	ମଲାଵି
ಮೆಕ್ಸಿಕೊ	ମେକ୍ସିକୋ
ಮಲೇಶಿಯಾ	ମଲେଶିଯା
ಮೊಜಾಂಬಿಕ್	ମୋଜାଂବିକ୍
ನಮೀಬಿಯಾ	ନମୀବିଯା
ನ್ಯೂ ಕ್ಯಾಲಿಡೋನಿಯಾ	ନ୍ଯୂ କ୍ଯାଲିଡୋନିଯା
ನೈಜರ್	ନୈଜର୍
ನಾರ್ಫೋಕ್ ದ್ವೀಪ	ନାର୍ଫୋକ୍ ଦ୍ଵୀପ
ನೈಜೀರಿಯಾ	ନୈଜୀରିଯା
ನಿಕಾರಾಗುವಾ	ନିକାରାଗୁଵା
ನೆದರ್‌ಲ್ಯಾಂಡ್ಸ್	ନେଦର୍‌ଲ୍ଯାଂଡ୍ସ୍
ನಾರ್ವೇ	ନାର୍ଵେ
ನೇಪಾಳ	ନେପାଳ
ನೌರು	ନୌରୁ
ನಿಯು	ନିଯୁ
ನ್ಯೂಜಿಲೆಂಡ್	ନ୍ଯୂଜିଲେଂଡ୍
ಓಮನ್	ଓମନ୍
ಪನಾಮಾ	ପନାମା
ಪೆರು	ପେରୁ
ಫ್ರೆಂಚ್ ಪಾಲಿನೇಷ್ಯಾ	ଫ୍ରେଂଚ୍ ପାଲିନେଷ୍ଯା
ಪಪುವಾ ನ್ಯೂಗಿನಿಯಾ	ପପୁଵା ନ୍ଯୂଗିନିଯା
ಫಿಲಿಫೈನ್ಸ್	ଫିଲିଫୈନ୍ସ୍
ಪಾಕಿಸ್ತಾನ	ପାକିସ୍ତାନ
ಪೋಲ್ಯಾಂಡ್	ପୋଲ୍ଯାଂଡ୍
ಸೇಂಟ್ ಪಿಯರೆ ಮತ್ತು ಮಿಕೆಲನ್	ସେଂଟ୍ ପିଯରେ ମତ୍ତୁ ମିକେଲନ୍
ಪಿಟ್‌ಕೈರ್ನ್ ದ್ವೀಪಗಳು	ପିଟ୍‌କୈର୍ନ୍ ଦ୍ଵୀପଗଳୁ
ಪ್ಯೂರ್ಟೋ ರಿಕೊ	ପ୍ଯୂର୍ଟୋ ରିକୋ
ಪ್ಯಾಲೇಸ್ಟೇನಿಯನ್ ಪ್ರದೇಶ	ପ୍ଯାଲେସ୍ଟେନିଯନ୍ ପ୍ରଦେଶ
ಪ್ಯಾಲೆಸ್ಟೇನ್	ପ୍ଯାଲେସ୍ଟେନ୍
ಪೋರ್ಚುಗಲ್	ପୋର୍ଚୁଗଲ୍
ಪಲಾವು	ପଲାଵୁ
ಪರಾಗ್ವೇ	ପରାଗ୍ଵେ
ಖತಾರ್	ଖତାର୍
ಔಟ್ ಲೈಯಿಂಗ್ ಓಷಿಯಾನಿಯಾ	ଔଟ୍ ଲୈଯିଂଗ୍ ଓଷିଯାନିଯା
ರೀಯೂನಿಯನ್	ରୀଯୂନିଯନ୍
ರೊಮೇನಿಯಾ	ରୋମେନିଯା
ಸೆರ್ಬಿಯಾ	ସେର୍ବିଯା
ರಷ್ಯಾ	ରଷ୍ଯା
ರುವಾಂಡಾ	ରୁଵାଂଡା
ಸೌದಿ ಅರೇಬಿಯಾ	ସୌଦି ଅରେବିଯା
ಸೊಲೊಮನ್ ದ್ವೀಪಗಳು	ସୋଲୋମନ୍ ଦ୍ଵୀପଗଳୁ
ಸೀಶೆಲ್ಲೆಸ್	ସୀଶେଲ୍ଲେସ୍
ಸೂಡಾನ್	ସୂଡାନ୍
ಸ್ವೀಡನ್	ସ୍ଵୀଡନ୍
ಸಿಂಗಾಪುರ್	ସିଂଗାପୁର୍
ಸೇಂಟ್ ಹೆಲೆನಾ	ସେଂଟ୍ ହେଲେନା
ಸ್ಲೋವೇನಿಯಾ	ସ୍ଲୋଵେନିଯା
ಸ್ವಾಲ್ಬಾರ್ಡ್ ಮತ್ತು ಜಾನ್ ಮೆಯನ್	ସ୍ଵାଲ୍ବାର୍ଡ୍ ମତ୍ତୁ ଜାନ୍ ମେଯନ୍
ಸ್ಲೋವೇಕಿಯಾ	ସ୍ଲୋଵେକିଯା
ಸಿಯೆರ್ರಾ ಲಿಯೋನ್	ସିଯେର୍ରା ଲିଯୋନ୍
ಸ್ಯಾನ್ ಮೆರಿನೋ	ସ୍ଯାନ୍ ମେରିନୋ
ಸೆನೆಗಲ್	ସେନେଗଲ୍
ಸೊಮಾಲಿಯಾ	ସୋମାଲିଯା
ಸುರಿನಾಮ	ସୁରିନାମ
ದಕ್ಷಿಣ ಸೂಡಾನ್	ଦକ୍ଷିଣ ସୂଡାନ୍
ಸಾವೋ ಟೋಮ್ ಮತ್ತು ಪ್ರಿನ್ಸಿಪಿ	ସାଵୋ ଟୋମ୍ ମତ୍ତୁ ପ୍ରିନ୍ସିପି
ಎಲ್ ಸಾಲ್ವೇಡಾರ್	ଏଲ୍ ସାଲ୍ଵେଡାର୍
ಸಿಂಟ್ ಮಾರ್ಟೆನ್	ସିଂଟ୍ ମାର୍ଟେନ୍
ಸಿರಿಯಾ	ସିରିଯା
ಸ್ವಾಜಿಲ್ಯಾಂಡ್	ସ୍ଵାଜିଲ୍ଯାଂଡ୍
ಟ್ರಿಸ್ತನ್ ಡಾ ಕುನ್ಹಾ	ଟ୍ରିସ୍ତନ୍ ଡା କୁନ୍ହା
ಟರ್ಕ್ಸ್ ಮತ್ತು ಕೈಕೋಸ್ ದ್ವೀಪಗಳು	ଟର୍କ୍ସ୍ ମତ୍ତୁ କୈକୋସ୍ ଦ୍ଵୀପଗଳୁ
ಚಾದ್	ଚାଦ୍
ಫ್ರೆಂಚ್ ದಕ್ಷಿಣ ಪ್ರದೇಶಗಳು	ଫ୍ରେଂଚ୍ ଦକ୍ଷିଣ ପ୍ରଦେଶଗଳୁ
ಟೋಗೋ	ଟୋଗୋ
ಥೈಲ್ಯಾಂಡ್	ଥୈଲ୍ଯାଂଡ୍
ತಜಾಕಿಸ್ಥಾನ್	ତଜାକିସ୍ଥାନ୍
ಟೊಕೆಲಾವ್	ଟୋକେଲାଵ୍
ಪೂರ್ವ ತಿಮೋರ್	ପୂର୍ଵ ତିମୋର୍
ಈಸ್ಟ್ ಟಿಮೋರ್	ଈସ୍ଟ୍ ଟିମୋର୍
ತುರ್ಕ್ಮೇನಿಸ್ಥಾನ್	ତୁର୍କ୍ମେନିସ୍ଥାନ୍
ಟುನಿಶಿಯಾ	ଟୁନିଶିଯା
ಟೊಂಗ	ଟୋଂଗ
ಟರ್ಕಿ	ଟର୍କି
ಟ್ರಿನಿಡಾಡ್ ಮತ್ತು ಟೊಬಾಗೊ	ଟ୍ରିନିଡାଡ୍ ମତ୍ତୁ ଟୋବାଗୋ
ಟುವಾಲು	ଟୁଵାଲୁ
ಥೈವಾನ್	ଥୈଵାନ୍
ತಾಂಜೇನಿಯಾ	ତାଂଜେନିଯା
ಉಕ್ರೈನ್	ଉକ୍ରୈନ୍
ಉಗಾಂಡಾ	ଉଗାଂଡା
ಅಮೇರಿಕಾ ಸಂಯುಕ್ತ ಸಂಸ್ಥಾನ	ଅମେରିକା ସଂଯୁକ୍ତ ସଂସ୍ଥାନ
ಉರುಗ್ವೇ	ଉରୁଗ୍ଵେ
ಉಜ್ಬೇಕಿಸ್ಥಾನ್	ଉଜ୍ବେକିସ୍ଥାନ୍
ವ್ಯಾಟಿಕನ್	ଵ୍ଯାଟିକନ୍
ವೆನೆಜುವೆಲಾ	ଵେନେଜୁଵେଲା
ಬ್ರಿಟಿಷ್ ವರ್ಜಿನ್ ದ್ವೀಪಗಳು	ବ୍ରିଟିଷ୍ ଵର୍ଜିନ୍ ଦ୍ଵୀପଗଳୁ
ವಿಯೇಟ್ನಾಮ್	ଵିଯେଟ୍ନାମ୍
ವನೌಟು	ଵନୌଟୁ
ವಾಲಿಸ್ ಮತ್ತು ಫುಟುನಾ	ଵାଲିସ୍ ମତ୍ତୁ ଫୁଟୁନା
ಸಮೋವಾ	ସମୋଵା
ಕೊಸೊವೊ	କୋସୋଵୋ
ಯೆಮನ್	ଯେମନ୍
ಮಯೊಟ್ಟೆ	ମଯୋଟ୍ଟେ
ದಕ್ಷಿಣ ಆಫ್ರಿಕಾ	ଦକ୍ଷିଣ ଆଫ୍ରିକା
ಝಾಂಬಿಯಾ	ଝାଂବିଯା
ಜಿಂಬಾಬ್ವೆ	ଜିଂବାବ୍ଵେ
ಅಜ್ಞಾತ ಪ್ರದೇಶ	ଅଜ୍ଞାତ ପ୍ରଦେଶ
