# Baby names
ਅਂਗਦ	aṅgada
ਅਂਗਦ ਦੇਵ	aṅgada dēva
ਅਂਗਾਰਿਕਾ	aṅgārikā
ਅਂਤਰਜੋਤ	antarajōta
ਅਂਤਰਪ੍ਰਿਤ	antaraprita
ਅਂਤਰਾ	antarā
ਅਕਲਤਟ	akalataṭa
ਅਕਲਰੂਪ	akalarūpa
ਅਕਲਸ਼ਰਣ	akalaśaraṇa
ਅਕਲਸੀਮਾਰ	akalasīmāra
ਅਕਾਲਜੋਗ	akālajōga
ਅਕਾਲਦੀਪ	akāladīpa
ਅਕਾਲਪ੍ਰੀਤ	akālaprīta
ਅਕਾਲਬੀਰ	akālabīra
ਅਗਮਜੀਤ	agamajīta
ਅਗਮਜੋਤ	agamajōta
ਅਗਮ੍ਪਾਲ	agampāla
ਅਗਮ੍ਪ੍ਰੀਤ	agamprīta
ਅਜ੍ਮੀਨ੍ਦੇਰ	ajmīndēra
ਅਝਾਦਬੀਰ	ajhādabīra
ਅਝੀਝ	ajhījha
ਅਤੀਨਦੇਰ੍ਜਿਤ	atīnadērjita
ਅਤੀਨ੍ਦੇਰ	atīndēra
ਅਤ੍ਤਾਮਜਿਤ	attāmajita
ਅਨਂਤਦੇਵ	anantadēva
ਅਨਂਤਰ	anantara
ਅਨਂਤਵੀਰ	anantavīra
ਅਨਂਤ੍ਜੀਤ	anantjīta
ਅਨਾਹਤ	anāhata
ਅਨਿਂਦਿਤਾ	aninditā
ਅਨਿਸ਼ਾ	aniśā
ਅਨੀਲਜੋਤ	anīlajōta
ਅਨੀਸ਼੍ਕੋਉਂਰ	anīśkō'unra
ਅਨੁਂਜਪਾਲ	anun̄japāla
ਅਨੁਂਪਜੋਤ	anumpajōta
ਅਨੁਰਾਧਾ	anurādhā
ਅਨੁਸ਼੍ਕਾ	anuśkā
ਅਨੂਪਜੋਤ	anūpajōta
ਅਨੂਪਬੀਰ	anūpabīra
ਅਨੂਪਲੋਕ	anūpalōka
ਅਪੂਰ੍ਵਾ	apūrvā
ਅਪ੍ਰੀਨਦੇਰ	aprīnadēra
ਅਬਨੀ	abanī
ਅਬਿਚਾਲ	abicāla
ਅਬਿਨਾਸ਼	abināśa
ਅਭਿਜੀਤ	abhijīta
ਅਭਿਰੂਪ	abhirūpa
ਅਮਨਜੀਤ	amanajīta
ਅਮਰਜੋਤ	amarajōta
ਅਮਰਤ	amarata
ਅਮਰਿਂਦਰ	amarindara
ਅਮਰਿਤ	amarita
ਅਮਲਜੋਤ	amalajōta
ਅਮਾਨਜੀਵਨ	amānajīvana
ਅਮਾਨੀਨ੍ਦੇਰ	amānīndēra
ਅਮਾਨ੍ਰੂਪ	amānrūpa
ਅਮਾਰ੍ਪਾਲ	amārpāla
ਅਮਾਰ੍ਬੀਰ	amārbīra
ਅਮਿਕ	amika
ਅਮਿਤ	amita
ਅਮਿਤੋਜ	amitōja
ਅਮੀਤਪਾਲ	amītapāla
ਅਮੀਤ੍ਬੀਰ	amītbīra
ਅਮੋਲ੍ਰਸ	amōlrasa
ਅਮ੍ਨੀਨ੍ਦੇਰ	amnīndēra
ਅਮ੍ਰੀਤਬਾਨ	amrītabāna
ਅਮ੍ਰੀਤ੍ਪ੍ਰਿਤ	amrītprita
ਅਮ੍ਰੀਤ੍ਵਾਨੀ	amrītvānī
ਅਰਮਾਨੀ	aramānī
ਅਰਵਜੋਤ	aravajōta
ਅਰੀਨਾਜੇਤ	arīnājēta
ਅਰੀਨ੍ਦੇਰ੍ਜੀਤ	arīndērjīta
ਅਰੁਨਜੀਤ	arunajīta
ਅਰੁਨਜੋਤ	arunajōta
ਅਰ੍ਚਨਾ	arcanā
ਅਰ੍ਦਮਨ	ardamana
ਅਰ੍ਨਾਲੀਨ੍ਦੇਰ	arnālīndēra
ਅਰ੍ਸ਼੍ਦੀਪ	arśdīpa
ਅਲੋਕ੍ਪਾਲ	alōkpāla
ਅਲ੍ਪਨਾ	alpanā
ਅਵਨੀਨਦੇਰ	avanīnadēra
ਅਵਿਰ	avira
ਅਵ੍ਲੀਨ	avlīna
ਅਸਂਖ	asaṅkha
ਅਸ਼ਮਿਤ	aśamita
ਅਸ਼ਰ੍ਨਾਮ	aśarnāma
ਅਸ਼ਰ੍ਪ੍ਰੀਤ	aśarprīta
ਅਸ਼ਰ੍ਪ੍ਰੇਮ	aśarprēma
ਅਸ਼ਰ੍ਵੀਰ	aśarvīra
ਅਸ਼ਿਮਾ	aśimā
ਅਸੀਮ	asīma
ਅਸੀਸ	asīsa
ਅਸ੍ਨੇਹ	asnēha
ਆਖਰੀ	ākharī
ਆਤ੍ਮਜਾ	ātmajā
ਆਨਂਦਮਯੀ	ānandamayī
ਆਨਂਦਰੂਪ	ānandarūpa
ਆਯਕਾਰ	āyakāra
ਆਯਾਤਪ੍ਰਿਤ	āyātaprita
ਆਯੁਸ਼੍ਮਤਿ	āyuśmati
ਆਰਮਾਨ	āramāna
ਆਰਾਧ	ārādha
ਆਰਾਧਨਾ	ārādhanā
ਆਰ੍ਯਨ	āryana
ਇਂਦਰਬੀਰ	indarabīra
ਇਂਦਿਵਰ	indivara
ਇਕਪ੍ਰਿਤ	ikaprita
ਇਕਬਾਲ	ikabāla
ਇਕਰੂਪ	ikarūpa
ਇਕ੍ਪੂਜ	ikpūja
ਇਕ੍ਮਾਨ	ikmāna
ਇਚ੍ਕਜਿਤ	ickajita
ਇਨ੍ਦਾਰਤੇਜ	indāratēja
ਇਨ੍ਦਾਰਮਿਤ	indāramita
ਇਨ੍ਦਾਰ੍ਦੀਪ	indārdīpa
ਇਨ੍ਦਾਰ੍ਪ੍ਰਿਤ	indārprita
ਇਨ੍ਦਾਰ੍ਪ੍ਰੇਮ	indārprēma
ਇਨ੍ਦੇਰ	indēra
ਇਨ੍ਦੇਰਪਲ	indērapala
ਇਨ੍ਦੇਰਮਾਨ	indēramāna
ਇਨ੍ਦੇਰਹਾਰ੍ਜਿਤ	indērahārjita
ਇਮਰਾਤ	imarāta
ਈਖ੍ਤਿਅਰ	īkhti'ara
ਈਨ੍ਦਰ੍ਜੀਏਤ	īndarjī'ēta
ਈਨ੍ਦੇਰਤੇਕ	īndēratēka
ਈਨ੍ਦੇਰਵੀਰ	īndēravīra
ਈਬਾਦਤ	ībādata
ਈਸ਼ਪਾਲ	īśapāla
ਈਸ਼ਲੀਨ	īśalīna
ਈਸ਼ਾਰਤੇਕ	īśāratēka
ਈਸ਼ਾਰਪਾਲ	īśārapāla
ਈਸ਼੍ਤ੍ਵਰ੍ਜਿਤ	īśtvarjita
ਈਸ਼੍ਪ੍ਰਿਤ	īśprita
ਈਸ਼੍ਵਾਰ੍ਜਿਤ	īśvārjita
ਈਸ਼੍ਵੀਨਦੇਰ	īśvīnadēra
ਉਖ੍ਤਿਅਰ	ukhti'ara
ਉਚਪਾਲ	ucapāla
ਉਚਪ੍ਰਿਤ	ucaprita
ਉਚੀਤਦੀਪ	ucītadīpa
ਉਚੀਤਪ੍ਰਿਤ	ucītaprita
ਉਚੀਤਬੀਰ	ucītabīra
ਉਚੀਤਰੂਪ	ucītarūpa
ਉਚੀਤਲੋਕ	ucītalōka
ਉਚੀਤਵਂਤ	ucītavanta
ਉਜਗਰ੍ਜੋਤ	ujagarjōta
ਉਜਗਰ੍ਦੀਪ	ujagardīpa
ਉਜਗਰ੍ਬੀਰ	ujagarbīra
ਉਜਾਗਰ	ujāgara
ਉਜਾਲਾ	ujālā
ਉਜ੍ਜਲਜੋਤ	ujjalajōta
ਉਤ੍ਤਮ	uttama
ਉਤ੍ਤਮਪਾਲ	uttamapāla
ਉਤ੍ਤਮਲੀਵ	uttamalīva
ਉਤ੍ਤਾਮਕਾਰਾਮ	uttāmakārāma
ਉਤ੍ਤਾਮਜੋਧ	uttāmajōdha
ਉਤ੍ਤਾਮਤਿਰਥ	uttāmatiratha
ਉਤ੍ਤਾਮਤੇਕ	uttāmatēka
ਉਤ੍ਤਾਮਦੀਪ	uttāmadīpa
ਉਤ੍ਤਾਮਪਦ	uttāmapada
ਉਤ੍ਤਾਮ੍ਰਸ	uttāmrasa
ਉਤ੍ਤਾਮ੍ਰੂਪ	uttāmrūpa
ਉਤ੍ਰਕ੍ਸ਼	utrakśa
ਉਦੀਤਦੀਪ	udītadīpa
ਉਦੀਤਪ੍ਰਿਤ	udītaprita
ਉਦੀਤਬੀਰ	udītabīra
ਉਦੈਬੀਰ	udaibīra
ਉਦੈਭਗਤ	udaibhagata
ਉਦ੍ਦਾਮਜੀਤ	uddāmajīta
ਉਪਕਰਮ	upakarama
ਉਪਕਿਰਤ	upakirata
ਉਪਜਿਤ	upajita
ਉਪਨਿਤ	upanita
ਉਪੀਨਦੇਰ੍ਪ੍ਰਿਤ	upīnadērprita
ਉਪੇਨ੍ਦੇਰ	upēndēra
ਉਮੀਦ	umīda
ਊਤ੍ਤਮ੍ਗਿਆਨ	ūttamgi'āna
ਏਕਂਕਰ	ēkaṅkara
ਏਕਬੀਰ	ēkabīra
ਏਕਮ	ēkama
ਏਕਮਪੂਜ	ēkamapūja
ਏਕਮਬੀਰ	ēkamabīra
ਏਕਮ੍ਜੋਤ	ēkamjōta
ਏਕਮ੍ਰੂਪ	ēkamrūpa
ਏਕਾਨਪ੍ਰੀਤ	ēkānaprīta
ਏਕ੍ਕਾਮ	ēkkāma
ਏਤੀਬਾਰ	ētībāra
ਏਤ੍ਤਲੀਨ	ēttalīna
ਏਰਸ਼ੀਨ	ēraśīna
ਏਵੇਨਿਤ	ēvēnita
ਏਸ਼ਨਾ	ēśanā
ਏਸ਼੍ਵਰ	ēśvara
ਓਨਕਾਰ੍ਜਿਤ	ōnakārjita
ਓਨਕਾਰ੍ਜੀਤ	ōnakārjīta
ਓਨਕਾਰ੍ਪ੍ਰਿਤ	ōnakārprita
ਓਮਪ੍ਰਿਤ	ōmaprita
ਕਂਵਲ	kanvala
ਕਂਵਲਜੀਤ	kanvalajīta
ਕਨਵਾਰ੍ਜਾਗਤ	kanavārjāgata
ਕਨਵਾਰ੍ਜਿਤ	kanavārjita
ਕਨਵਾਰ੍ਪ੍ਰੇਮ	kanavārprēma
ਕਨਵਾਲ੍ਜੋਤ	kanavāljōta
ਕਨਵਾਲ੍ਨੈਨ	kanavālnaina
ਕਨਵਾਲ੍ਪਾਲ	kanavālpāla
ਕਨਵਾਲ੍ਪ੍ਰੇਮ	kanavālprēma
ਕਨਵਾਲ੍ਬੀਰ	kanavālbīra
ਕਨਵਾਲ੍ਰੂਪ	kanavālrūpa
ਕਨ੍ਚਨ੍ਦੀਪ	kancandīpa
ਕਨ੍ਚਾਨ੍ਪਾਲ	kancānpāla
ਕਨ੍ਵਾਰਪਾਲ	kanvārapāla
ਕਮਾਲ੍ਲਾ	kamāllā
ਕਰਨਦੀਪ	karanadīpa
ਕਰਨਪਾਲ	karanapāla
ਕਰਨਪ੍ਰਿਤ	karanaprita
ਕਰਨਰੂਪ	karanarūpa
ਕਰਮਪਲ	karamapala
ਕਰਮਪੁਲ	karamapula
ਕਰਮ੍ਜੋਤ	karamjōta
ਕਰੁਨ੍ਯਾ	karun'yā
ਕਲਬੀਰ	kalabīra
ਕਲਾਜੋਤ	kalājōta
ਕਲਾਪ੍ਰੇਮ	kalāprēma
ਕਵਨਿਤ	kavanita
ਕਵਨੀਰ	kavanīra
ਕਵਾਲ੍ਨਾਨ	kavālnāna
ਕਵਿਰਾਜ	kavirāja
ਕਸਮ	kasama
ਕਾਨਵਾਲੀਨ੍ਦੇਰ	kānavālīndēra
ਕਾਮਾਂਲਜੋਤ	kāmānlajōta
ਕਾਮਾਂਲਮਿਤ	kāmānlamita
ਕਾਮਾਂਲਮੋਹਨ	kāmānlamōhana
ਕਾਮਾਂਲ੍ਪਤਿ	kāmānlpati
ਕਾਰਮਨ	kāramana
ਕਾਵਾਲਪ੍ਰਿਤ	kāvālaprita
ਕਿਰਣਜੀਤ	kiraṇajīta
ਕਿਰਨਰੂਪ	kiranarūpa
ਕਿਰਨਸੁਖ	kiranasukha
ਕਿਸ਼ੇਨ	kiśēna
ਕੁਂਵਰਜੀਤ	kunvarajīta
ਕੁਲ	kula
ਕੁਲਜੋਤ	kulajōta
ਕੁਲਮਿਤ	kulamita
ਕੁਲਰਾਤਨ	kularātana
ਕੁਲਰੂਪ	kularūpa
ਕੁਲਵਂਠ	kulavaṇṭha
ਕੁਸ਼ਪ੍ਰਿਤ	kuśaprita
ਕੇਵਾਲਦੀਪ	kēvāladīpa
ਕੇਵਾਲਬੀਰ	kēvālabīra
ਕੋਉਰ	kō'ura
ਕੋਮਾਂਲਜੀਤ	kōmānlajīta
ਕੋਮਾਂਲਪ੍ਰੇਮ	kōmānlaprēma
ਕੋਮਾਲਦੀਪ	kōmāladīpa
ਕੋਮਾਲਮਿਤ	kōmālamita
ਕੌਰ	kaura
ਕ੍ਰਿਸ਼੍ਦੀਪ	kriśdīpa
ਕ੍ਸ਼ਾਗਨ	kśāgana
ਕ੍ਸ਼ਾਗਰ	kśāgara
ਕ੍ਸ਼ਿਤਿਜ	kśitija
ਕ੍ਸ਼੍ਹੀਮ	kśhīma
ਖਰਗ	kharaga
ਖਾਲਾਕ੍ਵੀਰ	khālākvīra
ਖੁਂਸ਼ਜੋਤ	khunśajōta
ਖੁਸ	khusa
ਖੁਸ਼	khuśa
ਖੁਸ਼ਜੀਤ	khuśajīta
ਖੇਮਵਂਤ	khēmavanta
ਗਗਨ	gagana
ਗਗਨਜੀਵ	gaganajīva
ਗਗਨਜੋਤ	gaganajōta
ਗਗਨਪ੍ਰਿਤ	gaganaprita
ਗਗਨਮਿਤ	gaganamita
ਗਤਲੀਨ	gatalīna
ਗਤਸ਼ਰਣ	gataśaraṇa
ਗਤਸੀਮਾਰ	gatasīmāra
ਗਰੀਨ੍ਦੇਰ	garīndēra
ਗਰ੍ਗੋਤ	gargōta
ਗਾਤਨੀਵਾਸ	gātanīvāsa
ਗਿਅਨ	gi'ana
ਗੀਂਜੀਵਨ	gīn̄jīvana
ਗੀਂਰਾਤਨ	gīnrātana
ਗੀਂਲੀਨ	gīnlīna
ਗੀਅਂਗੀਤ	gī'aṅgīta
ਗੀਅਂਚੇਤਨ	gī'an̄cētana
ਗੀਅਂਜੋਤ	gī'an̄jōta
ਗੀਅਂਪ੍ਰਿਤ	gī'amprita
ਗੀਅਂਰੂਪ	gī'anrūpa
ਗੀਅਨੀਨਦੇਰ	gī'anīnadēra
ਗੀਅਨ੍ਬੀਰ	gī'anbīra
ਗੀਆਨਪ੍ਰਿਤ	gī'ānaprita
ਗੀਆਨਲੀਨ	gī'ānalīna
ਗੀਤ	gīta
ਗੀਤਲੀਨ	gītalīna
ਗੀਤੀਨਦੇਰ	gītīnadēra
ਗੁਣਿਤ	guṇita
ਗੁਨ ਦਾਤ	guna dāta
ਗੁਨਕਿਰਤ	gunakirata
ਗੁਨਜਸ	gunajasa
ਗੁਨਜਿਤ	gunajita
ਗੁਨਜੀਵਨ	gunajīvana
ਗੁਨਜੁਨ	gunajuna
ਗੁਨਜੋਤ	gunajōta
ਗੁਨਪ੍ਰਿਤ	gunaprita
ਗੁਨਮਿਤ	gunamita
ਗੁਨਰਾਜ	gunarāja
ਗੁਨਸ਼ਾਂਤ	gunaśānta
ਗੁਨਾਤਮ	gunātama
ਗੁਨਿਤਪੁਲ	gunitapula
ਗੁਨਿਤਪ੍ਰਿਤ	gunitaprita
ਗੁਨ੍ਰਿਤ	gunrita
ਗੁਰਕਮਲ਼	gurakamaḻa
ਗੁਰਗਿਯਨ	guragiyana
ਗੁਰਜਾਸ	gurajāsa
ਗੁਰਜੀਵਨ	gurajīvana
ਗੁਰਜੋਗ	gurajōga
ਗੁਰਜੋਤ	gurajōta
ਗੁਰਝੀਲ	gurajhīla
ਗੁਰਤਰਣ	gurataraṇa
ਗੁਰਤਿਰਥ	guratiratha
ਗੁਰਦਰ੍ਸ਼ਨ	guradarśana
ਗੁਰਦਿਤ	guradita
ਗੁਰਦੀਤ੍ਤਾ	guradīttā
ਗੁਰਦ੍ਵੀਪ	guradvīpa
ਗੁਰਨਾਦ	guranāda
ਗੁਰਨਾਮਾਸ੍ਕਾਰ	guranāmāskāra
ਗੁਰਨੀਧ	guranīdha
ਗੁਰਨੀਰ੍ਮਾਲ	guranīrmāla
ਗੁਰਨੀਸ਼ਾਨ	guranīśāna
ਗੁਰਨ੍ਯਮ	guran'yama
ਗੁਰਪਰ੍ਵਿਨ	guraparvina
ਗੁਰਪੀਨਦੇਰ	gurapīnadēra
ਗੁਰਪ੍ਰੀਤਮ	guraprītama
ਗੁਰਬਕ੍ਸ਼	gurabakśa
ਗੁਰਬਲੀਹਾਰ	gurabalīhāra
ਗੁਰਬੀਨ੍ਦੇਰ	gurabīndēra
ਗੁਰਬੀਰ	gurabīra
ਗੁਰਭਜਨ	gurabhajana
ਗੁਰਭਾਗਤ	gurabhāgata
ਗੁਰਮਾਰ	guramāra
ਗੁਰਮਾਹੇਰ	guramāhēra
ਗੁਰਮੁਖ	guramukha
ਗੁਰਮੇਹਾਰ	guramēhāra
ਗੁਰਮੈਲ	guramaila
ਗੁਰਮ੍ਰਿਤ	guramrita
ਗੁਰਲੋਚਨ	guralōcana
ਗੁਰਵਿਂਦਰ	guravindara
ਗੁਰਵੀਨ੍ਦੇਰ	guravīndēra
ਗੁਰਵੀਰ	guravīra
ਗੁਰਸਨ੍ਦੀਪ	gurasandīpa
ਗੁਰਸ਼ਾਨ	guraśāna
ਗੁਰਸੁਖ	gurasukha
ਗੁਰਸੇਵ	gurasēva
ਗੁਰਹਾਰ੍ਪਾਲ	gurahārpāla
ਗੁਰਿਂਦਰ	gurindara
ਗੁਰੀਨਦੇਰ੍ਪਾਲ	gurīnadērpāla
ਗੁਰੁਕਾਰ	gurukāra
ਗੁਰੁਗੁਲ੍ਝਾਰ	guruguljhāra
ਗੁਰੁਚਰਣ	gurucaraṇa
ਗੁਰੁਦਰ੍ਸ਼ਨ	gurudarśana
ਗੁਰੁਦਾਸ	gurudāsa
ਗੁਰੁਦੀਪ	gurudīpa
ਗੁਰੁਪ੍ਰੇਮ	guruprēma
ਗੁਰੁਬੀਰ	gurubīra
ਗੁਰੁਮਾਂਨ੍ਦੀਰ	gurumānndīra
ਗੁਰੁਸੀਮ੍ਰਣ	gurusīmraṇa
ਗੁਰ੍ਕੀਰਣ	gurkīraṇa
ਗੁਰ੍ਕੀਰਪਾਲ	gurkīrapāla
ਗੁਰ੍ਚਾਰਾਨ੍ਜੋਤ	gurcārānjōta
ਗੁਰ੍ਜਨਪਾਲ	gurjanapāla
ਗੁਰ੍ਜੁ	gurju
ਗੁਰ੍ਤੇਜ	gurtēja
ਗੁਰ੍ਨੀਵਾਝ	gurnīvājha
ਗੁਰ੍ਨੂਰ	gurnūra
ਗੁਰ੍ਪ੍ਰਿਤੀ	gurpritī
ਗੁਰ੍ਮੀਤ	gurmīta
ਗੁਰ੍ਮੀਨਦੇਰ	gurmīnadēra
ਗੁਰ੍ਮੁਖਨੀਹਲ	gurmukhanīhala
ਗੁਰ੍ਸ਼ਣ	gurśaṇa
ਗੁਰ੍ਸ਼ਾਂਤ	gurśānta
ਗੁਰ੍ਸ਼ੀਲ	gurśīla
ਗੁਰ੍ਸਾਹੇਬ	gursāhēba
ਗੁਲਦੀਪ	guladīpa
ਗੁਲਵਂਤ	gulavanta
ਗੁਲਸ਼ਾਨ੍ਰੂਪ	gulaśānrūpa
ਗੁਲ੍ਵਾਨ੍ਤਪ੍ਰਿਤ	gulvāntaprita
ਗੁਲ੍ਸ਼ਾਨਪ੍ਰਿਤ	gulśānaprita
ਗੁਲ੍ਸ਼ਾਨਮਿਤ	gulśānamita
ਗੋਪਲਪ੍ਰਿਤ	gōpalaprita
ਗੋਬਿਂਦ	gōbinda
ਗੋਬੀਨਦੇਰ	gōbīnadēra
ਗੋਬੀਨਦੇਰ੍ਜਿਤ	gōbīnadērjita
ਗੋਬੀਨ੍ਦਰਾਈ	gōbīndarā'ī
ਗੌਰਵ੍ਪ੍ਰਿਤ	gauravprita
ਘਮਾਂਨਦ੍ਜਿਤ	ghamānnadjita
ਘਮਾਂਨਦ੍ਪਾਲ	ghamānnadpāla
ਚਂਚਲਜਿਤ	can̄calajita
ਚਂਚਲ੍ਪ੍ਰੀਤ	can̄calprīta
ਚਂਦਨ	candana
ਚਂਦਨਦੀਪ	candanadīpa
ਚਮਕੌਰ	camakaura
ਚਮਨਜਿਤ	camanajita
ਚਮਨਪ੍ਰਿਤ	camanaprita
ਚਮਨਰੂਪ	camanarūpa
ਚਰਨਕਾਨ੍ਵਾਲ	caranakānvāla
ਚਰਨਜੋਤ /ਚਰਨਜ੍ਯੋਤ	caranajōta /caranajyōta
ਚਰਨਪ੍ਰੇਮ	caranaprēma
ਚਾਂਦ	cānda
ਚਿਤਰਾਮਣ	citarāmaṇa
ਚਿਤਸਰੂਪ	citasarūpa
ਚੀਤਪ੍ਰਿਤ	cītaprita
ਚੇਤਨ੍ਦੀਪ	cētandīpa
ਜਗਜੀਤ	jagajīta
ਜਗਜੀਵ	jagajīva
ਜਗਜੀਵਨ	jagajīvana
ਜਗਤਜੀਤ	jagatajīta
ਜਗਤਪ੍ਰੇਮ	jagataprēma
ਜਗਤਰਣ	jagataraṇa
ਜਗਤਰੂਪ	jagatarūpa
ਜਗਨ	jagana
ਜਗਪਾਲ	jagapāla
ਜਗਪ੍ਰਿਤ	jagaprita
ਜਗਪ੍ਰੇਮ	jagaprēma
ਜਗਮਿਤ	jagamita
ਜਗਮੇਹਾਰ	jagamēhāra
ਜਗਮੋਹਨ	jagamōhana
ਜਗਰਾਜ	jagarāja
ਜਗਰੂਪ	jagarūpa
ਜਗਵੀਨ੍ਦੇਰ	jagavīndēra
ਜਗਵੀਰ	jagavīra
ਜਗੀਨਦੇਰ	jagīnadēra
ਜਗੀਨ੍ਦੇਰਪਾਲ	jagīndērapāla
ਜਗ੍ਵੀਰ	jagvīra
ਜਘ੍ਰ	jaghra
ਜਤੀਨਦੇਰ੍ਜਿਤ	jatīnadērjita
ਜਤੀਨਦੇਰ੍ਬੀਰ	jatīnadērbīra
ਜਤੀਨਦੇਰ੍ਮਿਤ	jatīnadērmita
ਜਨਜਿਤ	janajita
ਜਨਜੋਤ	janajōta
ਜਨਪ੍ਰਿਤ	janaprita
ਜਨਰਾਜ	janarāja
ਜਨਿਸ਼	janiśa
ਜਪਜਿਤ	japajita
ਜਪਧਾਰਾਮ	japadhārāma
ਜਪਧਿਰ	japadhira
ਜਪਨਾਮ	japanāma
ਜਪਸ਼ੇਰ	japaśēra
ਜਪੁਜੀ	japujī
ਜਬਰਜਂਗ	jabarajaṅga
ਜਮੀਲ	jamīla
ਜਯਂਸ਼	jayanśa
ਜਯਪਾਲ	jayapāla
ਜਰ੍ਨੈਲ	jarnaila
ਜਲਿਨ੍ਦ੍ਰ	jalindra
ਜਲ੍ਬੀਰ	jalbīra
ਜਸਂਜੋਤ	jasan̄jōta
ਜਸਂਪਾਲ	jasampāla
ਜਸਂਮਿਤ	jasammita
ਜਸਕੀਰਣ	jasakīraṇa
ਜਸਗੁਰ੍ਕੀਰ੍ਤਤ	jasagurkīrtata
ਜਸਜੀਨ੍ਦੇਰ	jasajīndēra
ਜਸਜੀਵਨ	jasajīvana
ਜਸਜੋਤ	jasajōta
ਜਸਤਰਣ	jasataraṇa
ਜਸਨਾਮ	jasanāma
ਜਸਪਾਲ (ਪੁਲ )	jasapāla (pula )
ਜਸਬੀਰ	jasabīra
ਜਸਭੂਪ	jasabhūpa
ਜਸਮਿਂਦਰ	jasamindara
ਜਸਮੋਹਨ	jasamōhana
ਜਸਰੂਪ	jasarūpa
ਜਸ੍ਕਰਣ	jaskaraṇa
ਜਸ੍ਕੀਰਿਤ	jaskīrita
ਜਸ੍ਕੀਰ੍ਪਲ	jaskīrpala
ਜਸ੍ਗੁਨ	jasguna
ਜਸ੍ਮਿਤ	jasmita
ਜਸ੍ਮੀਨਪ੍ਰਿਤ	jasmīnaprita
ਜਸ੍ਰਜਪ੍ਰਿਤ	jasrajaprita
ਜਸ੍ਸੀ	jas'sī
ਜਾਗ	jāga
ਜਾਗਰੀਤ	jāgarīta
ਜਾਤਵਂਤ	jātavanta
ਜਾਤਿਨਦੇਰ੍ਦੀਪ	jātinadērdīpa
ਜਾਨਾਕਪ੍ਰਿਤ	jānākaprita
ਜਾਪਮਾਨ	jāpamāna
ਜਾਸਨਿਤ	jāsanita
ਜਾਸ਼ਾਨਪ੍ਰਿਤ	jāśānaprita
ਜਾਸ੍ਮੀਲ	jāsmīla
ਜੀਵਨਦੀਪ ; ਜੀਵਨਦੀਪ ; ਜੀਵਨਦੀਪ	jīvanadīpa ; jīvanadīpa ; jīvanadīpa
ਜੀਵਨਪਲ	jīvanapala
ਜੀਵਨਪ੍ਰਿਤ	jīvanaprita
ਜੀਵਾਨਬੀਰ	jīvānabīra
ਜੁਗਦ	jugada
ਜੁਪੀਨਦੇਰਦੀਪ	jupīnadēradīpa
ਜੁਪੀਨਦੇਰ੍ਬੀਰ	jupīnadērbīra
ਜੁਸਜਿਤ	jusajita
ਜੁਸਪੁਲ	jusapula
ਜੁਸਮੈਲ	jusamaila
ਜੇਬਾ	jēbā
ਜੇਸਪਾਲ	jēsapāla
ਜੈਕਾਰ	jaikāra
ਜੈਪ੍ਰਜ	jaipraja
ਜੈਪ੍ਰਤਨ	jaipratana
ਜੈਬੀਰ	jaibīra
ਜੈਸਂਗਤ	jaisaṅgata
ਜੈਸੁਖਬੀਰ	jaisukhabīra
ਜੋਗਧੀਆਨ	jōgadhī'āna
ਜੋਗਪ੍ਰਕਾਸ਼	jōgaprakāśa
ਜੋਗੀਨਦੇਰ੍ਬੀਰ	jōgīnadērbīra
ਜੋਗੀਨਦੇਰ੍ਮਿਤ	jōgīnadērmita
ਜੋਗੇਨਦੇਰ	jōgēnadēra
ਜੋਤਪ੍ਰਕਾਸ਼	jōtaprakāśa
ਜੋਬਨਰੂਪ	jōbanarūpa
ਜੋਹਾਰ	jōhāra
ਜ੍ਞਾਨਜਿਤ	jñānajita
ਜ੍ਞਾਨਜੋਤ	jñānajōta
ਜ੍ਞਾਨਪ੍ਰਿਤ	jñānaprita
ਜ੍ਞਾਨਰੂਪ	jñānarūpa
ਜ੍ਞਾਨਵੀਰ	jñānavīra
ਜ੍ਞਾਨੇਨ੍ਦੇਰ	jñānēndēra
ਜ੍ਹਮਕ	j'hamaka
ਜ੍ਹਾਗਰ	j'hāgara
ਝਈਤੂਨ	jha'ītūna
ਝਹਾਗਨ	jhahāgana
ਝਾਮੀਨਾਹ	jhāmīnāha
ਝੀਤੁਨ	jhītuna
ਝੀਲ	jhīla
ਝੁਲਾਖਾ	jhulākhā
ਝੁਲ੍ਫਾ	jhulphā
ਝੇਬਵਂਤ	jhēbavanta
ਝੋਰਾਵਾਰ	jhōrāvāra
ਟੇਇਜਿਨ੍ਦੇਰ	ṭē'ijindēra
ਤਕਦੀਰ	takadīra
ਤਖਤ	takhata
ਤਤਜੋਗ	tatajōga
ਤਤਬੀਰ	tatabīra
ਤਤਵਿਚਾਰ	tatavicāra
ਤਤ੍ਰਾਤਨ	tatrātana
ਤਦਬੀਰ	tadabīra
ਤਨਦੀਪ	tanadīpa
ਤਨਵੀਰ	tanavīra
ਤਮਨ੍ਪ੍ਰਿਤ	tamanprita
ਤਰਣਵੀਰ	taraṇavīra
ਤਰਲੋਚਨ	taralōcana
ਤਰਸੇਮ	tarasēma
ਤਰੁਨਜਿਤ	tarunajita
ਤਲਵਿਨ	talavina
ਤਾਜਦਾਰ	tājadāra
ਤਾਜੀਨਦੇਰ੍ਦੀਪ	tājīnadērdīpa
ਤਾਜੀਨਦੇਰ੍ਪ੍ਰੇਮ	tājīnadērprēma
ਤਾਨੁਪ੍ਰਿਤ	tānuprita
ਤਾਪਨਪਾਲ	tāpanapāla
ਤੀਰਨ /ਤਿਹ੍ਰਣ /ਤੇਯ੍ਰੁਣ	tīrana /tihraṇa /tēyruṇa
ਤੀਰਾਥ੍ਰਾਮ	tīrāthrāma
ਤੁਵਿਜਾਤ	tuvijāta
ਤੇਕਜੀਤ	tēkajīta
ਤੇਕਦੀਪ	tēkadīpa
ਤੇਕਪ੍ਰਿਤ	tēkaprita
ਤੇਕ੍ਪਾਲ	tēkpāla
ਤੇਘਬਹਾਦੁਰ	tēghabahādura
ਤੇਜਧਾਰਾਮ	tējadhārāma
ਤੇਜਨਾਮ	tējanāma
ਤੇਜਪ੍ਰਤਾਪ	tējapratāpa
ਤੇਜ਼	tēza
ਤੇਜਾਸਵੀਰ	tējāsavīra
ਤੇਜੀਨਦੇਰ੍ਜੀਤ	tējīnadērjīta
ਤੇਜੀਨਦੇਰ੍ਪਾਲ	tējīnadērpāla
ਤੋਤਾਸਿਂਹ	tōtāsinha
ਤ੍ਰਿਪਲ	tripala
ਤ੍ਰਿਲੋਚਨ	trilōcana
ਤ੍ਰੀਭਾਵਾਨ	trībhāvāna
ਤ੍ਰੀਸ਼ਾਨਜੋਤ	trīśānajōta
ਤ੍ਰੀਸ਼ਾਨਦੀਪ	trīśānadīpa
ਤ੍ਰੀਸ਼ਾਨਬੀਰ	trīśānabīra
ਥਾਕੁਰਨਾਮ	thākuranāma
ਥਾਲਭੂਪ	thālabhūpa
ਥਾਲਰਾਜ	thālarāja
ਥੀਰਮਾਨ	thīramāna
ਥੀਰ੍ਧੀਆਨ	thīrdhī'āna
ਦਮਨਜਿਤ	damanajita
ਦਮਨਜੋਤ	damanajōta
ਦਯਾਜੋਤ	dayājōta
ਦਯਾਦੀਪ	dayādīpa
ਦਰਮੀਨ੍ਦੇਰ	daramīndēra
ਦਰ੍ਪ੍ਰਿਤ	darprita
ਦਲਜੋਧ	dalajōdha
ਦਲਬੀਨਦੇਰ	dalabīnadēra
ਦਲਬੀਨ੍ਦੇਰ੍ਜਿਤ	dalabīndērjita
ਦਲਰਾਜ	dalarāja
ਦਲੇਰ	dalēra
ਦਵੀਨ੍ਦੇਰ	davīndēra
ਦਿਦਾਰ	didāra
ਦਿਨਤੇਕ	dinatēka
ਦਿਪਲੀਨ	dipalīna
ਦਿਲਜੋਤ	dilajōta
ਦਿਲਨਿਤ	dilanita
ਦਿਲਪ੍ਰਿਤ	dilaprita
ਦਿਲਮਿਤ	dilamita
ਦਿਲਰਿਤ	dilarita
ਦਿਲਸ਼ਾਨ	dilaśāna
ਦਿਲਸ਼ੇਰ	dilaśēra
ਦਿਵ੍ਯਜ੍ਯੋਤ	divyajyōta
ਦੀਲਜੀਤ	dīlajīta
ਦੀਲਬਾਘ	dīlabāgha
ਦੀਲ੍ਜਿਤ	dīljita
ਦੀਵ੍ਯਜੋਤ	dīvyajōta
ਦੇਵਜੀਤ	dēvajīta
ਦੇਵਪ੍ਰਿਤ	dēvaprita
ਦੇਵਾਤ੍ਮਾ	dēvātmā
ਦੇਵੀਨ੍ਦੇਰ	dēvīndēra
ਧਰਮਜ੍ਯੋਤ	dharamajyōta
ਧਰਮਪਾਲ	dharamapāla
ਧਰਮਪ੍ਰੀਤ	dharamaprīta
ਧਰਮਲੀਨ	dharamalīna
ਧੀਅਨ੍ਜੋਗ	dhī'anjōga
ਨਕ੍ਸ਼ਤ੍ਰਾ	nakśatrā
ਨਮ੍ਰੀਤਾਬੀਰ	namrītābīra
ਨਯਨਦੀਪ	nayanadīpa
ਨਰਿਨ੍ਦਰ	narindara
ਨਰੇਨ੍ਦ੍ਰ	narēndra
ਨਵਜੀਤ	navajīta
ਨਵਜੀਵਨ	navajīvana
ਨਵਦੀਪ	navadīpa
ਨਵਬੀਰ	navabīra
ਨਵਮਿਤ	navamita
ਨਵ੍ਜੀਨ੍ਦੇਰ	navjīndēra
ਨਾਗਂਦਰ	nāgandara
ਨਾਨਕੀ	nānakī
ਨਾਨਵੀਰ	nānavīra
ਨਾਨ੍ਦਾਨਜਿਤ	nāndānajita
ਨਾਨ੍ਦਾਨਪ੍ਰਿਤ	nāndānaprita
ਨਾਮਜੀਵ	nāmajīva
ਨਾਮਜੋਗ	nāmajōga
ਨਾਮਜੋਤ	nāmajōta
ਨਾਮਜੋਧ	nāmajōdha
ਨਾਮਧਾਰ	nāmadhāra
ਨਾਮਧਿਯਨ	nāmadhiyana
ਨਾਮਧਿਰ	nāmadhira
ਨਾਮਨੀਰ੍ਮਾਲ	nāmanīrmāla
ਨਾਮਨੀਵਾਸ	nāmanīvāsa
ਨਾਮਪ੍ਰਿਤ	nāmaprita
ਨਾਮਪ੍ਰੇਮ	nāmaprēma
ਨਾਮਭਾਗਤ	nāmabhāgata
ਨਾਮਵਿਚਾਰ	nāmavicāra
ਨਾਮਸ਼ਰਣ	nāmaśaraṇa
ਨਾਮਾਂਡੋਲ਼	nāmāṇḍōḻa
ਨਾਮਾਹਾਰ	nāmāhāra
ਨਾਮੁਤ੍ਤਮ	nāmuttama
ਨਾਮ੍ਰਾਤਨ	nāmrātana
ਨਾਮ੍ਰਿਤਾ	nāmritā
ਨਾਮ੍ਰੀਤਾਜੋਤ	nāmrītājōta
ਨਾਮ੍ਰੀਤਾਦੀਪ	nāmrītādīpa
ਨਾਮ੍ਰੀਤਾਪ੍ਰਿਤ	nāmrītāprita
ਨਾਰ	nāra
ਨਾਰਂਜਨ	nāran̄jana
ਨਾਰੀਤਪਲ	nārītapala
ਨਾਰੀਨਦੇਰਦੀਪ	nārīnadēradīpa
ਨਾਰੈਨ	nāraina
ਨਾਵਿਨਜਿਤ	nāvinajita
ਨਾਵ੍ਕੀਰਣ	nāvkīraṇa
ਨਾਵ੍ਕੀਰਨਜੋਤ	nāvkīranajōta
ਨਾਵ੍ਪ੍ਰਿਤ	nāvprita
ਨਿਮਾਈ	nimā'ī
ਨਿਰਂਜਨ	niran̄jana
ਨਿਰਂਜਨਾ	niran̄janā
ਨਿਰ੍ਮਲਜੀਤ	nirmalajīta
ਨਿਲਾਮਜੋਤ	nilāmajōta
ਨਿਲਾਮਪੁਲ	nilāmapula
ਨਿਲਾਮਪ੍ਰਿਤ	nilāmaprita
ਨਿਲਾਮਬੇਰ	nilāmabēra
ਨਿਸ਼ਾ	niśā
ਨਿਹ੍ਚਾਲਤੇਕ	nihcālatēka
ਨਿਹ੍ਚਾਲਮਿਤ	nihcālamita
ਨੀਤਨਾਮ	nītanāma
ਨੀਨਦੇਰ੍ਬੀਰ	nīnadērbīra
ਨੀਮਮਾਂਪ੍ਰਿਤ	nīmamāmprita
ਨੀਮਮਾਂਰ੍ਦੀਪ	nīmamānrdīpa
ਨੀਮ੍ਮਾਂਰਤਾ	nīm'mānratā
ਨੀਮ੍ਰਤ	nīmrata
ਨੀਰਮਾਂਲਦੀਪ	nīramānladīpa
ਨੀਰਮਾਂਲਬੀਰ	nīramānlabīra
ਨੀਰਮੋਲ	nīramōla
ਨੀਰਵੈਰ	nīravaira
ਨੀਰ੍ਭਾਉ	nīrbhā'u
ਨੀਰ੍ਮਾਂਲਕਾਰਾਮ	nīrmānlakārāma
ਨੀਰ੍ਮਾਂਲਜੀਵ	nīrmānlajīva
ਨੀਰ੍ਮਾਂਲਜੋਤ	nīrmānlajōta
ਨੀਰ੍ਮਾਂਲਤੇਕ	nīrmānlatēka
ਨੀਰ੍ਮਾਂਲਧਾਰਾਮ	nīrmānladhārāma
ਨੀਰ੍ਮਾਂਲਪ੍ਰਿਤ	nīrmānlaprita
ਨੀਸ਼ਾਨ੍ਦੀਪ	nīśāndīpa
ਨੀਹ੍ਚਾਲ੍ਪ੍ਰੇਮ	nīhcālprēma
ਨੂਰਦੇਵ	nūradēva
ਨੂਰਨਿਤ	nūranita
ਨੂਰਪ੍ਰਿਤ	nūraprita
ਨੇਕਨਾਮ	nēkanāma
ਨੇਕੀਨਦੇਰ	nēkīnadēra
ਨੇਕ੍ਦੀਪ	nēkdīpa
ਨੇਕ੍ਪਾਲ	nēkpāla
ਨੇਹ੍ਚਾਲਪ੍ਰਿਤ	nēhcālaprita
ਨੈਨਤਾਰ	nainatāra
ਨੈਨਦੀਪ	nainadīpa
ਨੈਨੀਨਦੇਰ	nainīnadēra
ਨੋਉਲਖ	nō'ulakha
ਨੌਹਨੀਹਲ	nauhanīhala
ਨ੍ਰੀਪਜੋਤ	nrīpajōta
ਪਤਵਂਤ	patavanta
ਪਤਵੀਰ	patavīra
ਪਦਾਮਜਿਤ	padāmajita
ਪਦਾਮਪ੍ਰੇਮ	padāmaprēma
ਪਦ੍ਮਸ਼੍ਰੀ	padmaśrī
ਪਰਤਾਪ ; ਪਰਤਾਪ	paratāpa ; paratāpa
ਪਰਤਾਪੀ	paratāpī
ਪਰਦੀਪ	paradīpa
ਪਰਬੀਨ	parabīna
ਪਰਮਕਮਲ਼	paramakamaḻa
ਪਰਮਕਿਰਤ	paramakirata
ਪਰਮਗੁਨ	paramaguna
ਪਰਮਜਾਪ	paramajāpa
ਪਰਮਜੀਤ ; ਪਰਮਜੀਤ	paramajīta ; paramajīta
ਪਰਮਜੁਗਤ	paramajugata
ਪਰਮਜੋਗ	paramajōga
ਪਰਮਜੋਧ	paramajōdha
ਪਰਮਠਾਕਰ	paramaṭhākara
ਪਰਮਤੇਕ	paramatēka
ਪਰਮਦੀਪ	paramadīpa
ਪਰਮਧਾਰਾਮ	paramadhārāma
ਪਰਮਧਿਰ	paramadhira
ਪਰਮਪਾਲ	paramapāla
ਪਰਮਪ੍ਰੇਮ	paramaprēma
ਪਰਮਬੋਧ	paramabōdha
ਪਰਮਯੋਗ	paramayōga
ਪਰਮਰਂਗ	paramaraṅga
ਪਰਮਲੀਨ	paramalīna
ਪਰਮਸ਼ਾਂਤ	paramaśānta
ਪਰਮਸਿਤਾਲ	paramasitāla
ਪਰਮਸੁਖ	paramasukha
ਪਰਮਸੇਵਕ	paramasēvaka
ਪਰਮਾਧਾਰ	paramādhāra
ਪਰਮਾਰ੍ਥ	paramārtha
ਪਰਮਿਂਦਰ	paramindara
ਪਰਮੀਤ	paramīta
ਪਰਮ੍ਦਯਾ	paramdayā
ਪਰਸਂਜੀਤ	parasan̄jīta
ਪਰਸ਼ੋਤਮ	paraśōtama
ਪਰਾਮਨੀਵਾਸ	parāmanīvāsa
ਪਰੀਦਰ੍ਸ਼ਨ	parīdarśana
ਪਰ੍ਗਤ	pargata
ਪਰ੍ਵੀਨ੍ਦੇਰ	parvīndēra
ਪਲਬੀਨਦੇਰ	palabīnadēra
ਪਲਵੀਨ੍ਦੇਰ੍ਪਾਲ	palavīndērpāla
ਪਵਾਨਜੋਤ	pavānajōta
ਪਵਾਨਦੀਪ	pavānadīpa
ਪਵਾਨਪ੍ਰਿਤ	pavānaprita
ਪਵਾਨਵੀਰ	pavānavīra
ਪਵੀਤ	pavīta
ਪਾਰਂਗਤ	pāraṅgata
ਪੁਨੀਤ	punīta
ਪੁਨੀਤਪਾਲ	punītapāla
ਪੁਰਾਨਪ੍ਰੇਮ	purānaprēma
ਪੁਰਾਨ੍ਜੀਤ	purānjīta
ਪੁਸ਼ਪ੍ਰਿਤ	puśaprita
ਪੁਸ਼੍ਪਿਤਾ	puśpitā
ਪੂਰਨਜੀਤ	pūranajīta
ਪ੍ਰਗਿਤ	pragita
ਪ੍ਰਜਨਾ	prajanā
ਪ੍ਰਣਿਤ	praṇita
ਪ੍ਰਨੀਤਾ	pranītā
ਪ੍ਰਫੂਲਦੀਪ	praphūladīpa
ਪ੍ਰਭਕੀਰਤ	prabhakīrata
ਪ੍ਰਭਕੀਰ੍ਪਾਲ	prabhakīrpāla
ਪ੍ਰਭਗੀਤ	prabhagīta
ਪ੍ਰਭਚਰਣ	prabhacaraṇa
ਪ੍ਰਭਚੇਤਨ	prabhacētana
ਪ੍ਰਭਜਿਤ	prabhajita
ਪ੍ਰਭਜੀਤ	prabhajīta
ਪ੍ਰਭਜੀਵਨ	prabhajīvana
ਪ੍ਰਭਜੋਗ	prabhajōga
ਪ੍ਰਭਜੋਤੇ	prabhajōtē
ਪ੍ਰਭਜੋਧ	prabhajōdha
ਪ੍ਰਭਤਿਰਥ	prabhatiratha
ਪ੍ਰਭਦਾਸ	prabhadāsa
ਪ੍ਰਭਧਿਯਨ	prabhadhiyana
ਪ੍ਰਭਧਿਰਾਜ	prabhadhirāja
ਪ੍ਰਭਨਾਮ	prabhanāma
ਪ੍ਰਭਨੂਰ	prabhanūra
ਪ੍ਰਭਪਰ੍ਵਾਨ	prabhaparvāna
ਪ੍ਰਭਬੋਧ	prabhabōdha
ਪ੍ਰਭਮਿਤ	prabhamita
ਪ੍ਰਭਮੇਹਾਰ	prabhamēhāra
ਪ੍ਰਭਲੀਨ	prabhalīna
ਪ੍ਰਭਵਿਚਾਰ	prabhavicāra
ਪ੍ਰਭਸਂਗਤ	prabhasaṅgata
ਪ੍ਰਭਸਿਤਾਲ	prabhasitāla
ਪ੍ਰਭਾਤਕੀਰਣ	prabhātakīraṇa
ਪ੍ਰਭ੍ਰਮਣ	prabhramaṇa
ਪ੍ਰਭ੍ਰਾਤਨ	prabhrātana
ਪ੍ਰਭ੍ਰੂਪ	prabhrūpa
ਪ੍ਰਸ਼ਾਰਨਬੀਰ	praśāranabīra
ਪ੍ਰਿਤਮੋਹਨ	pritamōhana
ਪ੍ਰਿਤੀਨ੍ਦੇਰ	pritīndēra
ਪ੍ਰਿਤ੍ਵੀਰ	pritvīra
ਪ੍ਰੀਤਪਾਲ	prītapāla
ਪ੍ਰੀਤਮ੍ਹਾਰੀ	prītamhārī
ਪ੍ਰੀਤਾਮਜਿਤ	prītāmajita
ਪ੍ਰੀਥਾਮ੍ਦੀਪ	prīthāmdīpa
ਪ੍ਰੀਥੀਪਾਲ	prīthīpāla
ਪ੍ਰੀਥ੍ਵੀਪਾਲ	prīthvīpāla
ਪ੍ਰੇਮਜਿਤ	prēmajita
ਪ੍ਰੇਮਤੇਕ	prēmatēka
ਪ੍ਰੇਮਪਾਲ	prēmapāla
ਪ੍ਰੇਮਬਂਸ	prēmabansa
ਪ੍ਰੇਮਭਾਗਤ	prēmabhāgata
ਪ੍ਰੇਮਰਂਗ	prēmaraṅga
ਪ੍ਰੇਮਰਮਣ	prēmaramaṇa
ਪ੍ਰੇਮਰਸ	prēmarasa
ਪ੍ਰੇਮਲੀਨ	prēmalīna
ਪ੍ਰੇਮਵਾਂਤ	prēmavānta
ਪ੍ਰੇਮਸੀਰੀ	prēmasīrī
ਪ੍ਰੇਮਸੁਖ	prēmasukha
ਪ੍ਰੇਮ੍ਵੀਰ	prēmvīra
ਫਕੀਰ	phakīra
ਫਤੇਹਕਾਰਾਮ	phatēhakārāma
ਫਤੇਹਪ੍ਰਿਤ	phatēhaprita
ਫਤੇਹਬੀਰ	phatēhabīra
ਫਤੇਹ੍ਵਂਤ	phatēhvanta
ਫਾਜਲ	phājala
ਫੁਲਵਂਤ	phulavanta
ਫੋਜੀਨਦੇਰ	phōjīnadēra
ਬਂਸਮਿਤ	bansamita
ਬਕ੍ਸ਼ੀ	bakśī
ਬਚਾਨਬੀਰ	bacānabīra
ਬਚੀਨ੍ਤ	bacīnta
ਬਨੀਤ	banīta
ਬਨੀਨਦੇਰ	banīnadēra
ਬਰਿਨ੍ਦ੍ਰ	barindra
ਬਰੀਨ੍ਦੇਰ	barīndēra
ਬਲਤੇਜ	balatēja
ਬਲਦੀਪ	baladīpa
ਬਲਦੇਵ	baladēva
ਬਲਮੋਹਨ	balamōhana
ਬਲਰਾਜ	balarāja
ਬਲਵਿਂਦਰ	balavindara
ਬਲੀਨਦੇਰ	balīnadēra
ਬਲੀਹਾਰ	balīhāra
ਬਲ੍ਵਿਨ੍ਦ੍ਰ	balvindra
ਬਲ੍ਵੀਨ੍ਦੇਰ	balvīndēra
ਬਹਾਦਰ	bahādara
ਬਾਲਮਿਤ	bālamita
ਬਿਸ਼ਨਪਾਲ	biśanapāla
ਬਿਸ੍ਮੀਤ	bismīta
ਬੀਨਦੇਰ	bīnadēra
ਬੀਨਾ	bīnā
ਬੀਬੀਨਾਨਾਕੀ	bībīnānākī
ਬੀਮਾਂਲਜੋਤ	bīmānlajōta
ਬੀਰੀਨਦਾਰ	bīrīnadāra
ਬੀਸਮਾਧ	bīsamādha
ਬੀਸ਼੍ਮਿਤ	bīśmita
ਬੁਜੀ	bujī
ਬੁਧ੍ਪ੍ਰਿਤ	budhprita
ਬੁਧ੍ਰੂਪ	budhrūpa
ਬੇਂਤ	bēnta
ਬੇਨ੍ਨੀ	bēnnī
ਬੇਬੇ	bēbē
ਬੈਰਾਗੀ	bairāgī
ਬ੍ਰਹਮਜੋਤ	brahamajōta
ਬ੍ਰਹਾਮਲੀਨ	brahāmalīna
ਬ੍ਰਹਾਮ੍ਜੀਤ	brahāmjīta
ਬ੍ਰਹ੍ਮਲੀਨ	brahmalīna
ਬ੍ਰਹ੍ਮਵੀਰ	brahmavīra
ਬ੍ਰਿਜੇਂਦਰ	brijēndara
ਬ੍ਰੀਜੋਧ	brījōdha
ਭਗਤ	bhagata
ਭਗਵਾਨ	bhagavāna
ਭਜਨਿਕ	bhajanika
ਭਰਪੂਰ	bharapūra
ਭਾਘਵੀਨ੍ਦੇਰ	bhāghavīndēra
ਭਾਜ੍ਨਾਮ	bhājnāma
ਭਾਜ੍ਨਿਤ	bhājnita
ਭਾਵਜਿਤ	bhāvajita
ਭਾਵਜੀਨ੍ਦੇਰ	bhāvajīndēra
ਭਾਵਨਦੀਪ	bhāvanadīpa
ਭਾਵਨੀਤ	bhāvanīta
ਭਾਵਪਾਲ	bhāvapāla
ਭਾਵਪ੍ਰੇਮ	bhāvaprēma
ਭਾਵਲੀਨ	bhāvalīna
ਭੀਨਦੇਰ੍ਪਾਲ	bhīnadērpāla
ਭੁਪੀਨ੍ਦੇਰ	bhupīndēra
ਮਂਗਲਾ	maṅgalā
ਮਂਤੇਕ	mantēka
ਮਜਾਲ	majāla
ਮਣਿਪਾਲ	maṇipāla
ਮਧੁਪ੍ਰਿਤ	madhuprita
ਮਧੁਰਬੀਨ	madhurabīna
ਮਧੁਵਂਤ	madhuvanta
ਮਨਵਂਤ	manavanta
ਮਰਦੁਲਾ	maradulā
ਮਸ੍ਤਪ੍ਰੇਮ	mastaprēma
ਮਸ੍ਤਾਨ	mastāna
ਮਸ੍ਤੁਕ	mastuka
ਮਸ੍ਤ੍ਵੀਰ	mastvīra
ਮਹਨਬੀਰ	mahanabīra
ਮਹਾਜਿਤ	mahājita
ਮਹਾਨਗਿਯਨ	mahānagiyana
ਮਹਾਨਗੀਤ	mahānagīta
ਮਹਾਨਗੁਨ	mahānaguna
ਮਹਾਨਜਿਤ	mahānajita
ਮਹਾਨਜੀਵਨ	mahānajīvana
ਮਹਾਨਜੋਤ	mahānajōta
ਮਹਾਨਤੇਕ	mahānatēka
ਮਹਾਨਤ੍ਰੀਪਾਤ	mahānatrīpāta
ਮਹਾਨਦੀਪ	mahānadīpa
ਮਹਾਨਪਾਲ	mahānapāla
ਮਹਾਨਪ੍ਰੇਮ	mahānaprēma
ਮਹਾਨਭਗਤ	mahānabhagata
ਮਹਿਨਦੇਰ੍ਪ੍ਰਿਤ	mahinadērprita
ਮਹੀਨਗਾ	mahīnagā
ਮਹੀਨਦੇਰ੍ਪਾਲ	mahīnadērpāla
ਮਹੇਕਪ੍ਰਿਤ	mahēkaprita
ਮਹੇਨਦੇਰ	mahēnadēra
ਮਹੇਰਬਾਨੀ	mahērabānī
ਮਹੇਸ਼ੀਨਦੇਰ	mahēśīnadēra
ਮਾਂਨਕਰਣ	mānnakaraṇa
ਮਾਂਨਗਲ੍ਪ੍ਰਿਤ	mānnagalprita
ਮਾਂਨਵਾਨ੍ਤ੍ਬੀਰ	mānnavāntbīra
ਮਾਂਨਸੀਰਤ	mānnasīrata
ਮਾਂਨਾਵੀਨਦੇਰ	mānnāvīnadēra
ਮਾਂਨਾਸਪ੍ਰੇਮ	mānnāsaprēma
ਮਾਂਨੀਨਦੇਰ੍ਬੀਰ	mānnīnadērbīra
ਮਾਂਨੋਹਾਰਜੋਤ	mānnōhārajōta
ਮਾਂਨੋਹਾਰਦੀਪ	mānnōhāradīpa
ਮਾਂਨੋਹਾਰ੍ਜੀਤ	mānnōhārjīta
ਮਾਂਨੋਹਾਰ੍ਪਲ	mānnōhārpala
ਮਾਂਨ੍ਗਲ੍ਜੀਤ	mānn'galjīta
ਮਾਂਨ੍ਗਲ੍ਪ੍ਰੇਮ	mānn'galprēma
ਮਾਂਨ੍ਸ਼ਿਤਾਲ	mānnśitāla
ਮਾਦਨਬੀਰ	mādanabīra
ਮਾਦਾਨਕੀਰ੍ਪਾਲ	mādānakīrpāla
ਮਾਦਾਨਪਾਲ	mādānapāla
ਮਾਨਤੇਜ	mānatēja
ਮਾਨਦੇਵ	mānadēva
ਮਾਨਪੁਲ	mānapula
ਮਾਨਬੀਰ	mānabīra
ਮਾਨਰਿਤ	mānarita
ਮਾਨਾਸਦੀਪ	mānāsadīpa
ਮਾਨ੍ਕੀਰਣ	mānkīraṇa
ਮਾਨ੍ਗਲ੍ਜੋਤ	mān'galjōta
ਮਾਨ੍ਪ੍ਰੀਯਾ	mānprīyā
ਮਾਯ੍ਰਾਯ	māyrāya
ਮਿਤ੍ਰਾ	mitrā
ਮਿਤ੍ਰਾਜ	mitrāja
ਮੀਰਾ	mīrā
ਮੁਕੁਂਦਾ	mukundā
ਮੁਕੁਨਦ੍ਪ੍ਰਿਤ	mukunadprita
ਮੁਖ੍ਤਯਾਰ	mukhtayāra
ਮੁਦ੍ਰਾ	mudrā
ਮੁਨਦੀਪ	munadīpa
ਮੁਨਲੇਨੇ	munalēnē
ਮੇਸ਼	mēśa
ਮੇਹਰ	mēhara
ਮੇਹਾਰਤੇਕ	mēhāratēka
ਮੇਹਾਰਪਲ	mēhārapala
ਮੇਹਾਰਪ੍ਰਿਤ	mēhāraprita
ਮੇਹਾਰਭੂਪ	mēhārabhūpa
ਮੇਹਾਰਮਿਤ	mēhāramita
ਮੇਹੇਰ	mēhēra
ਮੇਹੇਰਬਾਨੀ	mēhērabānī
ਮੋਨੀਨ੍ਦੇਰ	mōnīndēra
ਮੋਹਨਤੇਕ	mōhanatēka
ਮੋਹਨਮਿਤ	mōhanamita
ਮੋਹਨਲੀਨ	mōhanalīna
ਮੋਹਨਵਂਤ	mōhanavanta
ਮੋਹਨਵੀਰ	mōhanavīra
ਮੋਹਿਨ੍ਦੇਰਪਾਲ	mōhindērapāla
ਮੋਹੇਨਪਲ	mōhēnapala
ਮੋਹੇਨਪ੍ਰਿਤ	mōhēnaprita
ਯਕਿਨ	yakina
ਯਸ਼ਜੋਤ	yaśajōta
ਯਸ਼ਨੂਰ	yaśanūra
ਯਸ਼ਪਾਲ	yaśapāla
ਯਸ਼ਵਂਤ	yaśavanta
ਯਸ਼੍ਦੀਪ	yaśdīpa
ਯਾਤੀਨਪਾਲ	yātīnapāla
ਯਾਦਲੀਨ	yādalīna
ਯਾਦਵੀਰ	yādavīra
ਯਾਦ੍ਬੀਰ	yādbīra
ਯਾਸ੍ਮੀਨੇ	yāsmīnē
ਯੁਵਰਾਨੀ	yuvarānī
ਯੋਗੇਸ਼ਪਾਲ	yōgēśapāla
ਰਂਗ ਰਮਨ	raṅga ramana
ਰਂਗਜੋਤ	raṅgajōta
ਰਂਗਪ੍ਰਿਤ	raṅgaprita
ਰਂਗਾਤਮ	raṅgātama
ਰਂਗੀਵਨ	raṅgīvana
ਰਂਜੀਤ	ran̄jīta
ਰਘੁਜਿਤ	raghujita
ਰਘੁਬਂਸ	raghubansa
ਰਚਨਜਿਤ	racanajita
ਰਚਨਜੋਤ	racanajōta
ਰਚ੍ਪੀਨਦੇਰ੍ਜਿਤ	racpīnadērjita
ਰਜੀਨਦਾਰ	rajīnadāra
ਰਣਦੀਪ	raṇadīpa
ਰਣਬੀਰ	raṇabīra
ਰਤਨ੍ਕਾਰਾਮ	ratankārāma
ਰਤ੍ਤਾਨਜੋਤ	rattānajōta
ਰਤ੍ਤਾਨਦੀਪ	rattānadīpa
ਰਨਗ੍ਰਤ੍ਤੀ	ranagrattī
ਰਨਪ੍ਰਿਤ	ranaprita
ਰਪੀਨਦੇਰ	rapīnadēra
ਰਮਚੇਤਨ	ramacētana
ਰਮਣੀਕ	ramaṇīka
ਰਮਨਜਿਤ	ramanajita
ਰਮਨਦੀਪ	ramanadīpa
ਰਮਨਿਤ	ramanita
ਰਮਨੀਵਾਸ	ramanīvāsa
ਰਮਲੀਨ	ramalīna
ਰਮਾਂਨਜੋਤ	ramānnajōta
ਰਮਾਂਨਰੂਪ	ramānnarūpa
ਰਮਾਂਨਸੁਖ	ramānnasukha
ਰਮਿਤ	ramita
ਰਮਿਨਾਜੀਤ	raminājīta
ਰਮੀਨਦੇਰ੍ਜਿਤ	ramīnadērjita
ਰਮੀਨਦੇਰ੍ਪਾਲ	ramīnadērpāla
ਰਮੀਨਦੇਰ੍ਪ੍ਰਿਤ	ramīnadērprita
ਰਮੀਨਦੇਰ੍ਬੀਰ	ramīnadērbīra
ਰਮੇਸ਼ਪਲ	ramēśapala
ਰਮੇਸ਼ਮਿਤ	ramēśamita
ਰਵਜੋਤ	ravajōta
ਰਵਨੀਤ	ravanīta
ਰਵਿਨ੍ਦਰ	ravindara
ਰਵਿਰਾਜ	ravirāja
ਰਵੀਦੀਪ	ravīdīpa
ਰਵੀਨਦੇਰ੍ਦੀਪ	ravīnadērdīpa
ਰਵੀਨਦੇਰ੍ਮਿਤ	ravīnadērmita
ਰਸਂਜਿਤ	rasan̄jita
ਰਸਂਜੋਤ	rasan̄jōta
ਰਸਂਮਿਤ	rasammita
ਰਸਗੁਨ	rasaguna
ਰਸਜੋਤ	rasajōta
ਰਸਧਾਰਮ	rasadhārama
ਰਸਨਂਦ	rasananda
ਰਸਪ੍ਰਿਤ	rasaprita
ਰਸਬੀਰ	rasabīra
ਰਸਭਾਗਤ	rasabhāgata
ਰਸਮ	rasama
ਰਸਮ੍ਰਿਤ	rasamrita
ਰਸਲੀਨ	rasalīna
ਰਸਵਂਤ	rasavanta
ਰਸ਼ਾਨ੍ਪ੍ਰਿਤ	raśānprita
ਰਸੁਤ੍ਤਮ	rasuttama
ਰਹੁਲਜੀਤ	rahulajīta
ਰਹੁਲਦੀਪ	rahuladīpa
ਰਾਖਨਾਂ	rākhanāṁ
ਰਾਖਬੀਰ	rākhabīra
ਰਾਜਕਿਰਣ	rājakiraṇa
ਰਾਜਦੀਪ	rājadīpa
ਰਾਜਨਾਰੀਨ੍ਦ	rājanārīnda
ਰਾਜਪਰਾਮ	rājaparāma
ਰਾਜਪਾਲ	rājapāla
ਰਾਜਪ੍ਰਤਾਪ	rājapratāpa
ਰਾਜਮਂਦਰ	rājamandara
ਰਾਜਮਿਤ	rājamita
ਰਾਜਸ਼ਰਣ	rājaśaraṇa
ਰਾਜਸੁਖ	rājasukha
ਰਾਜਾਨਜਿਤ	rājānajita
ਰਾਜਾਨਮਿਤ	rājānamita
ਰਾਜਾਨ੍ਦੀਪ	rājāndīpa
ਰਾਤਾਨਗੀਤ	rātānagīta
ਰਾਤਾਨਚੇਤਨ	rātānacētana
ਰਾਤਾਨਜੀਵਨ	rātānajīvana
ਰਾਤਾਨਪ੍ਰਿਤ	rātānaprita
ਰਾਤਾਨਮਿਤ	rātānamita
ਰਾਤਾਨਵਂਤ	rātānavanta
ਰਾਤਾਨਾਤਮ	rātānātama
ਰਾਮਦਾਸ	rāmadāsa
ਰਾਮਪਾਲ	rāmapāla
ਰਾਮਰਂਗ	rāmaraṅga
ਰਾਮਰਤ੍ਤਨ	rāmarattana
ਰਾਮਸੁਖ	rāmasukha
ਰਾਸਰਮਣ	rāsaramaṇa
ਰਾਸ਼੍ਪਲ	rāśpala
ਰਾਸ਼੍ਮੀਨਦੇਰ	rāśmīnadēra
ਰਿਧਿਮਾ	ridhimā
ਰੀਜਕ	rījaka
ਰੀਤੀਨਦੇਰ	rītīnadēra
ਰੀਪਨ੍ਜੋਤ	rīpanjōta
ਰੀਪੁਦਮ	rīpudama
ਰੂਂਗ / ਰਂਗ	rūṅga / raṅga
ਰੂਪਦੀਪ	rūpadīpa
ਰੂਪਦੇਵ	rūpadēva
ਰੂਪਵਂਤ	rūpavanta
ਰੇਗੇਨਦਰ	rēgēnadara
ਰੋਸ਼ਨਦੀਪ	rōśanadīpa
ਰੌਸ਼ਾਨਪ੍ਰੇਮ	rauśānaprēma
ਰੌਸ਼ਾਨਬੀਰ	rauśānabīra
ਲਕ੍ਸ਼੍ਮੀ	lakśmī
ਲਖਪ੍ਰਿਤ	lakhaprita
ਲਖਮਿਤ	lakhamita
ਲਖਰੂਪ	lakharūpa
ਲਖਵੀਰ	lakhavīra
ਲਵੇਨਿਤ	lavēnita
ਲਾਜਵਂਤ	lājavanta
ਲਾਵਪ੍ਰਿਤ	lāvaprita
ਲਾਵਿਨਦੀਪ	lāvinadīpa
ਲੀਵਗੀਆਨ	līvagī'āna
ਲੀਵਚਿਤ	līvacita
ਲੀਵਚੇਤ	līvacēta
ਲੀਵਜੋਤ	līvajōta
ਲੀਵਨਾਮ	līvanāma
ਲੀਵਸ਼ਰਣ	līvaśaraṇa
ਲੀਵਾਵਤਰ	līvāvatara
ਲੋਕਪਾਲ	lōkapāla
ਲੋਕਪ੍ਰਿਤ	lōkaprita
ਲੋਕਰੂਪ	lōkarūpa
ਲੋਕ੍ਪ੍ਰੇਮ	lōkprēma
ਲੋਵਪ੍ਰੇਮ	lōvaprēma
ਲੋਵੇਦੀਪ	lōvēdīpa
ਵਰੀਨਦੇਰ੍ਪਾਲ	varīnadērpāla
ਵਰੁਨਜਿਤ	varunajita
ਵਰੁਨਦੀਪ	varunadīpa
ਵਸਂਤਪ੍ਰਿਤ	vasantaprita
ਵਸੁਂਧਰਾ	vasundharā
ਵਾਦਭਾਗ	vādabhāga
ਵਾਮਾਂਨਜੀਤ	vāmānnajīta
ਵਾਰੀਨਦੇਰ	vārīnadēra
ਵਾਸੀਮਬੀਰ	vāsīmabīra
ਵਾਹੀਦਪ੍ਰਿਤ	vāhīdaprita
ਵਾਹੇਗੁਰੁ	vāhēguru
ਵਿਕ੍ਰਮਜੀਤ	vikramajīta
ਵਿਕ੍ਰਮਜੋਤ	vikramajōta
ਵਿਚਾਰ੍ਚੇਤਨ	vicārcētana
ਵਿਚਾਰ੍ਦੀਪ	vicārdīpa
ਵਿਚਾਰ੍ਲੀਨ	vicārlīna
ਵਿਜਯਪ੍ਰਤਾਪ	vijayapratāpa
ਵਿਜਯਪ੍ਰਿਤ	vijayaprita
ਵਿਜੇਂਦਰ	vijēndara
ਵਿਨਾਯਦੀਪ	vināyadīpa
ਵਿਨਾਯਪੁਲ	vināyapula
ਵਿਨਾਯ੍ਬਿਰ	vināybira
ਵਿਮਾਂਲਜਿਤ	vimānlajita
ਵਿਮਾਂਲਜੋਤ	vimānlajōta
ਵਿਮਾਂਲਪ੍ਰੇਮ	vimānlaprēma
ਵਿਰੀਨਦਾਰ ; ਵਿਰੀਨਦੇਰ	virīnadāra ; virīnadēra
ਵਿਰੀਨਦੇਰ	virīnadēra
ਵਿਸਮਦ	visamada
ਵਿਸ਼ਾਲਦੀਪ	viśāladīpa
ਵਿਸ਼ਾਲਪ੍ਰਿਤ	viśālaprita
ਵਿਸ਼੍ਵਰ੍ਪ੍ਰਿਤ	viśvarprita
ਵਿਸ਼੍ਵਾਤਮ	viśvātama
ਵਿਸਾਹ	visāha
ਵੀਜਯਮਿਤ	vījayamita
ਵੀਰ	vīra
ਵੀਰ /ਵੀਰ	vīra /vīra
ਵੀਰਪਾਲ	vīrapāla
ਵੀਵੇਕ੍ਬੀਰ	vīvēkbīra
ਵੀਸ੍ਰਮਣ	vīsramaṇa
ਵੇਰਾਜ	vērāja
ਵੈਭਵ	vaibhava
ਸਂਗਜਾਪ	saṅgajāpa
ਸਂਗਤਪ੍ਰਿਤ	saṅgataprita
ਸਂਗਤਰੂਪ	saṅgatarūpa
ਸਂਗਤ੍ਰਸ	saṅgatrasa
ਸਂਗੀਤਾ	saṅgītā
ਸਂਗ੍ਰਾਮ	saṅgrāma
ਸਂਜੀਤ	san̄jīta
ਸਂਜੋਗ	san̄jōga
ਸਂਤਕੀਰੀਨ	santakīrīna
ਸਂਤਪ੍ਰਕਾਸ਼	santaprakāśa
ਸਂਤਪ੍ਰੇਮ	santaprēma
ਸਂਤਬੀਰ	santabīra
ਸਂਤੋਖਜੀਤ	santōkhajīta
ਸਂਤੋਖਜੋਤ	santōkhajōta
ਸਂਤੋਖਪ੍ਰਿਤ	santōkhaprita
ਸਂਤੋਖਬੀਰ	santōkhabīra
ਸਂਦੀਪ	sandīpa
ਸਗਲਜੋਤ	sagalajōta
ਸਚਕਿਰਤ	sacakirata
ਸਚਜੋਗ	sacajōga
ਸਚਪਾਲ	sacapāla
ਸਚਪ੍ਰਧਾਨ	sacapradhāna
ਸਚਭਾਗਤ	sacabhāgata
ਸਚਮਾਨ	sacamāna
ਸਚਰੂਪ	sacarūpa
ਸਚਵੀਰ	sacavīra
ਸਚਸੁਖ	sacasukha
ਸਚਸੇਵਕ	sacasēvaka
ਸਚਾਮ੍ਰਿਤ	sacāmrita
ਸਚ੍ਦੀਪ	sacdīpa
ਸਜੀਨਦੇਰ	sajīnadēra
ਸਤਕਿਰਤ	satakirata
ਸਤਕੀਰਤ	satakīrata
ਸਤਕੀਰ੍ਤਨ	satakīrtana
ਸਤਗੁਨ	sataguna
ਸਤਗੁਰ	satagura
ਸਤਜੋਤ	satajōta
ਸਤਨਾਮ	satanāma
ਸਤਪਾਲ	satapāla
ਸਤਪ੍ਰਕਾਸ਼	sataprakāśa
ਸਤਪ੍ਰਿਤ	sataprita
ਸਤਪ੍ਰੇਮ	sataprēma
ਸਤਬਚਨ	satabacana
ਸਤਮਿਤ	satamita
ਸਤਰਜਿਤ	satarajita
ਸਤਰਾਜ	satarāja
ਸਤਲੀਨ	satalīna
ਸਤਵਂਤ	satavanta
ਸਤਸਂਗਤ	satasaṅgata
ਸਤਸਂਤੋਖ	satasantōkha
ਸਤਸਰਂਗ	satasaraṅga
ਸਤਸੁਖ	satasukha
ਸਤੀਨਦੇਰ੍ਜਿਤ	satīnadērjita
ਸਤ੍ਯਜਿਤ	satyajita
ਸਤ੍ਯਪ੍ਰੇਮ	satyaprēma
ਸਥਿਨ੍ਦਰ	sathindara
ਸਦਜੀਵਨ	sadajīvana
ਸਦਸੁਖ	sadasukha
ਸਨਮੁਖ	sanamukha
ਸਨਾਨਤਨ	sanānatana
ਸਪਨਦੀਪ	sapanadīpa
ਸਪਾਹੀ	sapāhī
ਸਬੂਰੀ	sabūrī
ਸਭਾਜੀਤ	sabhājīta
ਸਮਰਜੀਤ	samarajīta
ਸਮਰਣ	samaraṇa
ਸਮਰਵੀਰ	samaravīra
ਸਮਰ੍ਥ	samartha
ਸਮਾਂਰਬੀਰ	samānrabīra
ਸਮਾਂਰ੍ਜੋਤ	samānrjōta
ਸਮਾਈ	samā'ī
ਸਮੀਨਦੀਪ	samīnadīpa
ਸਮੀਰ	samīra
ਸਰਦਾਰ	saradāra
ਸਰਨਦਾਯਲ	saranadāyala
ਸਰਨਦੀਪ	saranadīpa
ਸਰਨਾਗਤ	saranāgata
ਸਰਬਜੀਤ / ਸਰਬਜੀਤ	sarabajīta / sarabajīta
ਸਰਬਨੀਵਾਸ	sarabanīvāsa
ਸਰਬਪ੍ਰਿਤ	sarabaprita
ਸਰਬਸੁਖ	sarabasukha
ਸਰਬੁਤ੍ਤਮ	sarabuttama
ਸਰਬ੍ਗਿਆਨ	sarabgi'āna
ਸਰਬ੍ਜਿਤ	sarabjita
ਸਰਬ੍ਦਾਯਲ	sarabdāyala
ਸਰਬ੍ਦੀਪ	sarabdīpa
ਸਰਬ੍ਦੇਵ	sarabdēva
ਸਰਬ੍ਧਾਰਾਮ	sarabdhārāma
ਸਰਲਜਿਤ	saralajita
ਸਰਲਬੀਰ	saralabīra
ਸਰਾਬ੍ਰਜ	sarābraja
ਸਰੂਪ	sarūpa
ਸਰੂਰ	sarūra
ਸਰ੍ਜਿਤ	sarjita
ਸਰ੍ਮੀਨਦੇਰ	sarmīnadēra
ਸਵਾਨਪ੍ਰਿਤ	savānaprita
ਸਵਾਰਜਦੀਪ	savārajadīpa
ਸਵਾਰਜਬੀਰ	savārajabīra
ਸਵਾਰਨਜੋਤ	savāranajōta
ਸਵਾਰਨਪ੍ਰਿਤ	savāranaprita
ਸਵੀਤੀਨਦੇਰ	savītīnadēra
ਸਵੀਤੋਜ	savītōja
ਸਵੀਨਦੇਰ	savīnadēra
ਸਹੀਲਮਿਤ	sahīlamita
ਸ਼ਯ੍ਮ੍ਸੁਨ੍ਦਾਰ	śaymsundāra
ਸ਼ਰਨਪਾਲ	śaranapāla
ਸ਼ਰਨਬੀਰ	śaranabīra
ਸ਼ਰਨ੍ਜੀਤ੍ਕੌਰ	śaranjītkaura
ਸ਼ਾਂਤਚਿਤ	śāntacita
ਸ਼ਾਂਤਦੀਪ	śāntadīpa
ਸ਼ਾਂਤਪ੍ਰਕਾਸ਼	śāntaprakāśa
ਸ਼ਾਂਤਪ੍ਰਿਤ	śāntaprita
ਸ਼ਾਂਤਬੀਰ	śāntabīra
ਸ਼ਾਂਤਲੀਨ	śāntalīna
ਸ਼ਾਨਤ੍ਨੀਵਾਸ	śānatnīvāsa
ਸ਼ਾਬਦਚੇਤ	śābadacēta
ਸ਼ਾਬਦਤੇਕ	śābadatēka
ਸ਼ਾਬਦ੍ਰਾਸ	śābadrāsa
ਸ਼ਾਬਾਦ੍ਦੀਪ	śābāddīpa
ਸ਼ਾਲੀਨ	śālīna
ਸ਼ਾਸ਼ੀਪ੍ਰਿਤ	śāśīprita
ਸ਼ਿਵਚਰਣ	śivacaraṇa
ਸ਼ਿਵ੍ਚਾਰਨ੍ਜੀਤ	śivcāranjīta
ਸ਼ੁਕਾਰਿਯਨ	śukāriyana
ਸ਼ੁਭਦੀਪ	śubhadīpa
ਸ਼ੂਰਵੀਰ	śūravīra
ਸ਼ੇਰ	śēra
ਸ਼ੇਰਪੁਲ	śērapula
ਸ਼ੇਰਬਹਾਦੁਰ	śērabahādura
ਸ਼ੇਹ੍ਬਾਝ	śēhbājha
ਸਾਕਰਥ	sākaratha
ਸਾਖ	sākha
ਸਾਗਰ	sāgara
ਸਾਜ	sāja
ਸਾਤਪੁਲ	sātapula
ਸਾਧਨਾਹ	sādhanāha
ਸਾਧਿਕਾ	sādhikā
ਸਾਬਰ	sābara
ਸਾਰ	sāra
ਸਿਂਦਾ	sindā
ਸਿਓਪਰਿਤ	si'ōparita
ਸਿਤਾਲਜੀਤ	sitālajīta
ਸਿਤਾਲਜੋਤ	sitālajōta
ਸਿਮਰਨ	simarana
ਸੀਖਲ	sīkhala
ਸੀਮਾਂਰ੍ਜਿਤ	sīmānrjita
ਸੀਮਾਂਰ੍ਨਾਮ	sīmānrnāma
ਸੀਮਾਂਰ੍ਪ੍ਰਿਤ	sīmānrprita
ਸੀਮਾਂਰ੍ਲੀਨ	sīmānrlīna
ਸੀਮ੍ਰਤ	sīmrata
ਸੀਮ੍ਰਨਪਾਲ	sīmranapāla
ਸੀਮ੍ਰਨਪ੍ਰਿਤ	sīmranaprita
ਸੀਮ੍ਰਨ੍ਕੌਰ	sīmrankaura
ਸੀਮ੍ਰਨ੍ਜੀਤ	sīmranjīta
ਸੀਮ੍ਰੀਤਾ	sīmrītā
ਸੀਰਤ	sīrata
ਸੀਰੀਪ੍ਰੀਤਮ	sīrīprītama
ਸੀਰੀਵੇਦ੍ਯਾ	sīrīvēdyā
ਸੀਰੀਸੀਮ੍ਰਣ	sīrīsīmraṇa
ਸੀਰੀਸੇਵਾ	sīrīsēvā
ਸੁਖਚੈਨ	sukhacaina
ਸੁਖਜੀਵਨ	sukhajīvana
ਸੁਖਜੋਤ	sukhajōta
ਸੁਖਜੋਧ	sukhajōdha
ਸੁਖਦਾਯਲ	sukhadāyala
ਸੁਖਦੀਪ	sukhadīpa
ਸੁਖਦੇਵ	sukhadēva
ਸੁਖਬੀਰ	sukhabīra
ਸੁਖਮਾਂ	sukhamāṁ
ਸੁਖਰੂਪ	sukharūpa
ਸੁਖਸਿਤਾਲ	sukhasitāla
ਸੁਖਸੀਮ੍ਰਣ	sukhasīmraṇa
ਸੁਖਾਨਂਦ	sukhānanda
ਸੁਖਿਤ	sukhita
ਸੁਖੀਨ	sukhīna
ਸੁਖੀਨ੍ਦੇਰ	sukhīndēra
ਸੁਖ੍ਚਾਰਨ੍ਜੀਤ	sukhcāranjīta
ਸੁਖ੍ਜਿਤ	sukhjita
ਸੁਚਦੀਪ	sucadīpa
ਸੁਚਦੇਵ	sucadēva
ਸੁਚਮ	sucama
ਸੁਜਨਰੂਪ	sujanarūpa
ਸੁਜਨ੍ਬੀਰ	sujanbīra
ਸੁਜ੍ਜਨ	sujjana
ਸੁਧਬੁਧ	sudhabudha
ਸੁਧਸੁਰਤ	sudhasurata
ਸੁਭਪ੍ਰਿਤ	subhaprita
ਸੁਹੇਜਦੀਪ	suhējadīpa
ਸੇਵਾਕਪ੍ਰਿਤ	sēvākaprita
ਸੇਵਾਕਪ੍ਰੇਮ	sēvākaprēma
ਸੇਵਾਕਰਣ	sēvākaraṇa
ਸੇਵਾਪ੍ਰੀਤ	sēvāprīta
ਸੇਹਜ	sēhaja
ਸੇਹੇਜਬੀਰ	sēhējabīra
ਸੈਲੇਸ਼ਦੀਪ	sailēśadīpa
ਸੈਹਜ	saihaja
ਸੈਹਾਜਨੀਵਾਸ	saihājanīvāsa
ਸੈਹਾਜਲੀਨ	saihājalīna
ਸੈਹਾਜਾਧਾਰ	saihājādhāra
ਸੋਚੀ	sōcī
ਸੋਨਹਨ	sōnahana
ਸੋਭਾਵਂਤ	sōbhāvanta
ਸੋਹੀਨਦੇਰ	sōhīnadēra
ਸੋਹੁਨ	sōhuna
ਸ੍ਵਰ੍ਨ	svarna
ਹਕਾਮਪ੍ਰਿਤ	hakāmaprita
ਹਨ੍ਸ੍ਪਾਲ	hanspāla
ਹਰਕਾਨ੍ਵਾਲ	harakānvāla
ਹਰਕੀਰਣ	harakīraṇa
ਹਰਗੀਤ	haragīta
ਹਰਗੁਰ੍ਮਿਤ (ਮਿਤ )	haragurmita (mita )
ਹਰਗੋਬੀਨ੍ਦ	haragōbīnda
ਹਰਚਰਣ	haracaraṇa
ਹਰਜਪ	harajapa
ਹਰਜੀ	harajī
ਹਰਜੀਤ	harajīta
ਹਰਜੀਨ੍ਦੇਰ	harajīndēra
ਹਰਜੀਵ	harajīva
ਹਰਜੁਗਤ	harajugata
ਹਰਜੋਗ	harajōga
ਹਰਜੋਧ	harajōdha
ਹਰਜ੍ਯੋਤ	harajyōta
ਹਰਤਿਰਥ	haratiratha
ਹਰਤੇਜ੍ਪਾਲ	haratējpāla
ਹਰਦਯਾਲ	haradayāla
ਹਰਦਾਸ	haradāsa
ਹਰਦਿਪਾ	haradipā
ਹਰਦੀਪ	haradīpa
ਹਰਧਨ	haradhana
ਹਰਨਾਮ	haranāma
ਹਰਨਾਰਾਯਣ	haranārāyaṇa
ਹਰਨਿਤ	haranita
ਹਰਨੀਰ੍ਮਲ	haranīrmala
ਹਰਨੀਹਲ	haranīhala
ਹਰਪਰ੍ਸਨ੍ਨ	haraparsanna
ਹਰਪਾਲ	harapāla
ਹਰਪ੍ਰੇਮ੍ਜੀਤ	haraprēmjīta
ਹਰਬਿਂਦਰ	harabindara
ਹਰਬਿਰ	harabira
ਹਰਭਗਤ	harabhagata
ਹਰਮਨਾਦ	haramanāda
ਹਰਮਾਂਨ੍ਦੇਰ	haramānndēra
ਹਰਮੀਤ	haramīta
ਹਰਮੀਲਨ	haramīlana
ਹਰਮੂਰਤ	haramūrata
ਹਰਰਾਈ	hararā'ī
ਹਰਰੂਪ	hararūpa
ਹਰਵਂਤ	haravanta
ਹਰਵਿਨ	haravina
ਹਰਸ਼ਰਣ	haraśaraṇa
ਹਰਸਿਤਾਲ	harasitāla
ਹਰਸੀਮ੍ਰਣ	harasīmraṇa
ਹਰਸੀਮ੍ਰਨ੍ਜੋਤ	harasīmranjōta
ਹਰਸੀਮ੍ਰਿਤ	harasīmrita
ਹਰਸੁਖ	harasukha
ਹਰਾਨੂਪ	harānūpa
ਹਰਾਮ੍ਰੀਤ	harāmrīta
ਹਰਿਕੀਰ੍ਤਨ	harikīrtana
ਹਰਿਦਰ੍ਸ਼ਨ	haridarśana
ਹਰਿਨਾਰਾਯਣ	harinārāyaṇa
ਹਰਿਪ੍ਰੀਤ	hariprīta
ਹਰੀਅਮ੍ਰਿਤ	harī'amrita
ਹਰੀਸਰੂਪ	harīsarūpa
ਹਰੀਸੀਮਾਂਰਣ	harīsīmānraṇa
ਹਰ੍ਕਾਰਾਨ੍ਜੀਤ	harkārānjīta
ਹਰ੍ਕੀਰਨ੍ਜੀਤ	harkīranjīta
ਹਰ੍ਕੀਰਪਾਲ	harkīrapāla
ਹਰ੍ਜਸ	harjasa
ਹਰ੍ਤੇਇਜ	hartē'ija
ਹਰ੍ਨੀਝ	harnījha
ਹਰ੍ਬਂਸ	harbansa
ਹਰ੍ਮਾਂਨਜਿਤ	harmānnajita
ਹਰ੍ਮਾਂਨਪਾਲ	harmānnapāla
ਹਰ੍ਮੀਨ੍ਦੇਰ	harmīndēra
ਹਰ੍ਮੇਂਦ੍ਰ	harmēndra
ਹਰ੍ਸ਼ਰ੍ਧਾ	harśardhā
ਹਰ੍ਸ਼ਵਰ੍ਧਨ	harśavardhana
ਹਰ੍ਸ਼ਾਗੁਨ	harśāguna
ਹਰ੍ਸਿਰਤ	harsirata
ਹਸਨ	hasana
ਹਾਰਭਾਗ	hārabhāga
ਹਿਤੀਨਦੇਰ	hitīnadēra
ਹਿਤੇਨਦੇਰ	hitēnadēra
ਹਿਮ੍ਮਤ	him'mata
ਹਿਰੀਸ਼	hirīśa
ਹੁਅਲੀਨਾ	hu'alīnā
ਹੁਕੁਮਪਰਿਤ	hukumaparita
ਹੂਜਓਏ	hūja'ō'ē
ਹੇਤ	hēta
ਹੇਤਬੀਰ	hētabīra
ਹੇਮੀਨਦੇਰ	hēmīnadēra
ਹੇਯ੍ਮਾਂਨ੍ਪ੍ਰਿਤ	hēymānnprita
ਹੇਰਹੋ	hērahō
#
#
# Territory names from CLDR
ਅਸੈਂਸ਼ਨ ਟਾਪੂ	asainśana ṭāpū
ਅੰਡੋਰਾ	aḍōrā
ਸੰਯੁਕਤ ਅਰਬ ਅਮੀਰਾਤ	sayukata araba amīrāta
ਅਫ਼ਗਾਨਿਸਤਾਨ	afagānisatāna
ਐਂਟੀਗੁਆ ਅਤੇ ਬਾਰਬੁਡਾ	aiṇṭīgu'ā atē bārabuḍā
ਅੰਗੁਇਲਾ	agu'ilā
ਅਲਬਾਨੀਆ	alabānī'ā
ਅਰਮੀਨੀਆ	aramīnī'ā
ਅੰਗੋਲਾ	agōlā
ਅੰਟਾਰਕਟਿਕਾ	aṭārakaṭikā
ਅਰਜਨਟੀਨਾ	arajanaṭīnā
ਅਮੈਰੀਕਨ ਸਮੋਆ	amairīkana samō'ā
ਆਸਟਰੀਆ	āsaṭarī'ā
ਆਸਟ੍ਰੇਲੀਆ	āsaṭrēlī'ā
ਅਰੂਬਾ	arūbā
ਅਲੈਂਡ ਟਾਪੂ	alaiṇḍa ṭāpū
ਅਜ਼ਰਬਾਈਜਾਨ	azarabā'ījāna
ਬੋਸਨੀਆ ਅਤੇ ਹਰਜ਼ੇਗੋਵੀਨਾ	bōsanī'ā atē harazēgōvīnā
ਬਾਰਬਾਡੋਸ	bārabāḍōsa
ਬੰਗਲਾਦੇਸ਼	bagalādēśa
ਬੈਲਜੀਅਮ	bailajī'ama
ਬੁਰਕੀਨਾ ਫ਼ਾਸੋ	burakīnā fāsō
ਬੁਲਗਾਰੀਆ	bulagārī'ā
ਬਹਿਰੀਨ	bahirīna
ਬੁਰੁੰਡੀ	buruḍī
ਬੇਨਿਨ	bēnina
ਸੇਂਟ ਬਾਰਥੇਲੇਮੀ	sēṇṭa bārathēlēmī
ਬਰਮੂਡਾ	baramūḍā
ਬਰੂਨੇਈ	barūnē'ī
ਬੋਲੀਵੀਆ	bōlīvī'ā
ਕੈਰੇਬੀਆਈ ਨੀਦਰਲੈਂਡ	kairēbī'ā'ī nīdaralaiṇḍa
ਬ੍ਰਾਜ਼ੀਲ	brāzīla
ਬਹਾਮਾਸ	bahāmāsa
ਭੂਟਾਨ	bhūṭāna
ਬੌਵੇਟ ਟਾਪੂ	bauvēṭa ṭāpū
ਬੋਟਸਵਾਨਾ	bōṭasavānā
ਬੇਲਾਰੂਸ	bēlārūsa
ਬੇਲੀਜ਼	bēlīza
ਕੈਨੇਡਾ	kainēḍā
ਕੋਕੋਸ (ਕੀਲਿੰਗ) ਟਾਪੂ	kōkōsa (kīliga) ṭāpū
ਕਾਂਗੋ - ਕਿੰਸ਼ਾਸਾ	kāṅgō - kiśāsā
ਕਾਂਗੋ ਲੋਕਤੰਤਰੀ ਗਣਰਾਜ	kāṅgō lōkatatarī gaṇarāja
ਕੇਂਦਰੀ ਅਫ਼ਰੀਕੀ ਗਣਰਾਜ	kēndarī afarīkī gaṇarāja
ਕਾਂਗੋ - ਬ੍ਰਾਜ਼ਾਵਿਲੇ	kāṅgō - brāzāvilē
ਕਾਂਗੋ ਗਣਰਾਜ	kāṅgō gaṇarāja
ਸਵਿਟਜ਼ਰਲੈਂਡ	saviṭazaralaiṇḍa
ਕੋਟ ਡੀਵੋਆਰ	kōṭa ḍīvō'āra
ਆਇਵਰੀ ਕੋਸਟ	ā'ivarī kōsaṭa
ਕੁੱਕ ਟਾਪੂ	kuka ṭāpū
ਚਿਲੀ	cilī
ਕੈਮਰੂਨ	kaimarūna
ਚੀਨ	cīna
ਕੋਲੰਬੀਆ	kōlabī'ā
ਕਲਿੱਪਰਟਨ ਟਾਪੂ	kaliparaṭana ṭāpū
ਕੋਸਟਾ ਰੀਕਾ	kōsaṭā rīkā
ਕਿਊਬਾ	ki'ūbā
ਕੇਪ ਵਰਡੇ	kēpa varaḍē
ਕੁਰਾਕਾਓ	kurākā'ō
ਕ੍ਰਿਸਮਿਸ ਟਾਪੂ	krisamisa ṭāpū
ਸਾਇਪ੍ਰਸ	sā'iprasa
ਚੈਕ ਗਣਰਾਜ	caika gaṇarāja
ਜਰਮਨੀ	jaramanī
ਡੀਇਗੋ ਗਾਰਸੀਆ	ḍī'igō gārasī'ā
ਜ਼ੀਬੂਤੀ	zībūtī
ਡੈਨਮਾਰਕ	ḍainamāraka
ਡੋਮੀਨਿਕਾ	ḍōmīnikā
ਡੋਮੀਨਿਕਾਈ ਗਣਰਾਜ	ḍōmīnikā'ī gaṇarāja
ਅਲਜੀਰੀਆ	alajīrī'ā
ਸਿਓਟਾ ਅਤੇ ਮੇਲਿੱਲਾ	si'ōṭā atē mēlilā
ਇਕਵੇਡੋਰ	ikavēḍōra
ਇਸਟੋਨੀਆ	isaṭōnī'ā
ਮਿਸਰ	misara
ਪੱਛਮੀ ਸਹਾਰਾ	pachamī sahārā
ਇਰੀਟ੍ਰਿਆ	irīṭri'ā
ਸਪੇਨ	sapēna
ਇਥੋਪੀਆ	ithōpī'ā
ਯੂਰਪੀ ਯੂਨੀਅਨ	yūrapī yūnī'ana
ਫਿਨਲੈਂਡ	phinalaiṇḍa
ਫ਼ਿਜੀ	fijī
ਫ਼ਾਕਲੈਂਡ ਟਾਪੂ	fākalaiṇḍa ṭāpū
ਫ਼ਾਕਲੈਂਡ ਟਾਪੂ (ਆਈਲਾਸ ਮਾਲਵਿਨਾਸ)	fākalaiṇḍa ṭāpū (ā'īlāsa mālavināsa)
ਮਾਇਕ੍ਰੋਨੇਸ਼ੀਆ	mā'ikrōnēśī'ā
ਫੈਰੋ ਟਾਪੂ	phairō ṭāpū
ਫ਼ਰਾਂਸ	farānsa
ਗਬੋਨ	gabōna
ਯੂਨਾਈਟਡ ਕਿੰਗਡਮ	yūnā'īṭaḍa kigaḍama
ਗ੍ਰੇਨਾਡਾ	grēnāḍā
ਜਾਰਜੀਆ	jārajī'ā
ਫ਼ਰੈਂਚ ਗੁਆਨਾ	farain̄ca gu'ānā
ਗਰਨਜੀ	garanajī
ਘਾਨਾ	ghānā
ਜਿਬਰਾਲਟਰ	jibarālaṭara
ਗ੍ਰੀਨਲੈਂਡ	grīnalaiṇḍa
ਗੈਂਬੀਆ	gaimbī'ā
ਗਿਨੀ	ginī
ਗੁਆਡੇਲੋਪ	gu'āḍēlōpa
ਭੂ-ਖੰਡੀ ਗਿਨੀ	bhū-khaḍī ginī
ਗ੍ਰੀਸ	grīsa
ਦੱਖਣੀ ਜਾਰਜੀਆ ਅਤੇ ਦੱਖਣੀ ਸੈਂਡਵਿਚ ਟਾਪੂ	dakhaṇī jārajī'ā atē dakhaṇī saiṇḍavica ṭāpū
ਗੁਆਟੇਮਾਲਾ	gu'āṭēmālā
ਗੁਆਮ	gu'āma
ਗਿਨੀ-ਬਿਸਾਉ	ginī-bisā'u
ਗੁਯਾਨਾ	guyānā
ਹਾਂਗ ਕਾਂਗ ਐਸਏਆਰ ਚੀਨ	hāṅga kāṅga aisa'ē'āra cīna
ਹਾਂਗ ਕਾਂਗ	hāṅga kāṅga
ਹਰਡ ਤੇ ਮੈਕਡੋਨਾਲਡ ਟਾਪੂ	haraḍa tē maikaḍōnālaḍa ṭāpū
ਹੋਂਡੁਰਸ	hōṇḍurasa
ਕਰੋਏਸ਼ੀਆ	karō'ēśī'ā
ਹੈਤੀ	haitī
ਹੰਗਰੀ	hagarī
ਕੇਨਾਰੀ ਟਾਪੂ	kēnārī ṭāpū
ਇੰਡੋਨੇਸ਼ੀਆ	iḍōnēśī'ā
ਆਇਰਲੈਂਡ	ā'iralaiṇḍa
ਇਜ਼ਰਾਈਲ	izarā'īla
ਆਇਲ ਆਫ ਮੈਨ	ā'ila āpha maina
ਭਾਰਤ	bhārata
ਬਰਤਾਨਵੀ ਹਿੰਦ ਮਹਾਂਸਾਗਰ ਪ੍ਰਦੇਸ਼	baratānavī hida mahānsāgara pradēśa
ਇਰਾਕ	irāka
ਈਰਾਨ	īrāna
ਆਈਸਲੈਂਡ	ā'īsalaiṇḍa
ਇਟਲੀ	iṭalī
ਜਰਸੀ	jarasī
ਜਮਾਇਕਾ	jamā'ikā
ਜਾਰਡਨ	jāraḍana
ਜਪਾਨ	japāna
ਕੀਨੀਆ	kīnī'ā
ਕਿਰਗਿਜ਼ਸਤਾਨ	kiragizasatāna
ਕੰਬੋਡੀਆ	kabōḍī'ā
ਕਿਰਬਾਤੀ	kirabātī
ਕੋਮੋਰੋਸ	kōmōrōsa
ਸੈਂਟ ਕਿਟਸ ਐਂਡ ਨੇਵਿਸ	saiṇṭa kiṭasa aiṇḍa nēvisa
ਉੱਤਰੀ ਕੋਰੀਆ	utarī kōrī'ā
ਦੱਖਣੀ ਕੋਰੀਆ	dakhaṇī kōrī'ā
ਕੁਵੈਤ	kuvaita
ਕੇਮੈਨ ਟਾਪੂ	kēmaina ṭāpū
ਕਜ਼ਾਖਸਤਾਨ	kazākhasatāna
ਲਾਓਸ	lā'ōsa
ਲੈਬਨਾਨ	laibanāna
ਸੇਂਟ ਲੂਸੀਆ	sēṇṭa lūsī'ā
ਲਿਚੇਂਸਟਾਇਨ	licēnsaṭā'ina
ਸ੍ਰੀ ਲੰਕਾ	srī lakā
ਲਾਈਬੀਰੀਆ	lā'ībīrī'ā
ਲੇਸੋਥੋ	lēsōthō
ਲਿਥੁਆਨੀਆ	lithu'ānī'ā
ਲਕਜ਼ਮਬਰਗ	lakazamabaraga
ਲਾਟਵੀਆ	lāṭavī'ā
ਲੀਬੀਆ	lībī'ā
ਮੋਰੱਕੋ	mōrakō
ਮੋਨਾਕੋ	mōnākō
ਮੋਲਡੋਵਾ	mōlaḍōvā
ਮੋਂਟੇਨੇਗਰੋ	mōṇṭēnēgarō
ਸੇਂਟ ਮਾਰਟਿਨ	sēṇṭa māraṭina
ਮੈਡਾਗਾਸਕਰ	maiḍāgāsakara
ਮਾਰਸ਼ਲ ਟਾਪੂ	māraśala ṭāpū
ਮੈਕਡੋਨੀਆ	maikaḍōnī'ā
ਮੈਕਡੋਨੀਆ (ਪੂਰਵ ਯੂਗੋਸਲਾਵ ਮੈਕਡੋਨੀਆਈ ਗਣਰਾਜ)	maikaḍōnī'ā (pūrava yūgōsalāva maikaḍōnī'ā'ī gaṇarāja)
ਮਾਲੀ	mālī
ਮਿਆਂਮਾਰ (ਬਰਮਾ)	mi'āmmāra (baramā)
ਮੰਗੋਲੀਆ	magōlī'ā
ਮਕਾਉ ਐਸਏਆਰ ਚੀਨ	makā'u aisa'ē'āra cīna
ਮਕਾਉ	makā'u
ਉੱਤਰੀ ਮਾਰੀਆਨਾ ਟਾਪੂ	utarī mārī'ānā ṭāpū
ਮਾਰਟੀਨਿਕ	māraṭīnika
ਮੋਰਿਟਾਨੀਆ	mōriṭānī'ā
ਮੋਂਟਸੇਰਾਤ	mōṇṭasērāta
ਮਾਲਟਾ	mālaṭā
ਮੌਰਿਸ਼ਸ	mauriśasa
ਮਾਲਦੀਵ	māladīva
ਮਲਾਵੀ	malāvī
ਮੈਕਸੀਕੋ	maikasīkō
ਮਲੇਸ਼ੀਆ	malēśī'ā
ਮੋਜ਼ਾਮਬੀਕ	mōzāmabīka
ਨਾਮੀਬੀਆ	nāmībī'ā
ਨਿਊ ਕੈਲੇਡੋਨੀਆ	ni'ū kailēḍōnī'ā
ਨਾਈਜਰ	nā'ījara
ਨੋਰਫੌਕ ਟਾਪੂ	nōraphauka ṭāpū
ਨਾਈਜੀਰੀਆ	nā'ījīrī'ā
ਨਿਕਾਰਾਗੁਆ	nikārāgu'ā
ਨੀਦਰਲੈਂਡ	nīdaralaiṇḍa
ਨਾਰਵੇ	nāravē
ਨੇਪਾਲ	nēpāla
ਨਾਉਰੂ	nā'urū
ਨਿਯੂ	niyū
ਨਿਊਜ਼ੀਲੈਂਡ	ni'ūzīlaiṇḍa
ਓਮਾਨ	ōmāna
ਪਨਾਮਾ	panāmā
ਪੇਰੂ	pērū
ਫਰੈਂਚ ਪੋਲੀਨੇਸ਼ੀਆ	pharain̄ca pōlīnēśī'ā
ਪਾਪੂਆ ਨਿਊ ਗਿਨੀ	pāpū'ā ni'ū ginī
ਫਿਲੀਪੀਂਸ	philīpīnsa
ਪਾਕਿਸਤਾਨ	pākisatāna
ਪੋਲੈਂਡ	pōlaiṇḍa
ਸੈਂਟ ਪੀਅਰੇ ਐਂਡ ਮਿਕੇਲਨ	saiṇṭa pī'arē aiṇḍa mikēlana
ਪਿਟਕੇਰਨ ਟਾਪੂ	piṭakērana ṭāpū
ਪਿਊਰਟੋ ਰਿਕੋ	pi'ūraṭō rikō
ਫਿਲੀਸਤੀਨੀ ਖੇਤਰ	philīsatīnī khētara
ਫਿਲੀਸਤੀਨ	philīsatīna
ਪੁਰਤਗਾਲ	puratagāla
ਪਲਾਉ	palā'u
ਪੈਰਾਗਵੇ	pairāgavē
ਕਤਰ	katara
ਆਊਟਲਾਇੰਗ ਓਸ਼ੀਨੀਆ	ā'ūṭalā'iga ōśīnī'ā
ਰਿਯੂਨੀਅਨ	riyūnī'ana
ਰੋਮਾਨੀਆ	rōmānī'ā
ਸਰਬੀਆ	sarabī'ā
ਰੂਸ	rūsa
ਰਵਾਂਡਾ	ravāṇḍā
ਸਾਊਦੀ ਅਰਬ	sā'ūdī araba
ਸੋਲੋਮਨ ਟਾਪੂ	sōlōmana ṭāpū
ਸੇਸ਼ਲਸ	sēśalasa
ਸੂਡਾਨ	sūḍāna
ਸਵੀਡਨ	savīḍana
ਸਿੰਗਾਪੁਰ	sigāpura
ਸੇਂਟ ਹੇਲੇਨਾ	sēṇṭa hēlēnā
ਸਲੋਵੇਨੀਆ	salōvēnī'ā
ਸਵਾਲਬਰਡ ਅਤੇ ਜਾਨ ਮਾਯੇਨ	savālabaraḍa atē jāna māyēna
ਸਲੋਵਾਕੀਆ	salōvākī'ā
ਸਿਏਰਾ ਲਿਓਨ	si'ērā li'ōna
ਸੈਨ ਮਰੀਨੋ	saina marīnō
ਸੇਨੇਗਲ	sēnēgala
ਸੋਮਾਲੀਆ	sōmālī'ā
ਸੂਰੀਨਾਮ	sūrīnāma
ਦੱਖਣੀ ਸੂਡਾਨ	dakhaṇī sūḍāna
ਸਾਓ ਟੋਮ ਅਤੇ ਪ੍ਰਿੰਸੀਪੇ	sā'ō ṭōma atē prisīpē
ਅਲ ਸਲਵਾਡੋਰ	ala salavāḍōra
ਸਿੰਟ ਮਾਰਟੀਨ	siṭa māraṭīna
ਸੀਰੀਆ	sīrī'ā
ਸਵਾਜ਼ੀਲੈਂਡ	savāzīlaiṇḍa
ਟ੍ਰਿਸਟਾਨ ਦਾ ਕੁੰਹਾ	ṭrisaṭāna dā kuhā
ਟੁਰਕਸ ਅਤੇ ਕੈਕੋਸ ਟਾਪੂ	ṭurakasa atē kaikōsa ṭāpū
ਚਾਡ	cāḍa
ਫਰੈਂਚ ਦੱਖਣੀ ਪ੍ਰਦੇਸ਼	pharain̄ca dakhaṇī pradēśa
ਟੋਗੋ	ṭōgō
ਥਾਈਲੈਂਡ	thā'īlaiṇḍa
ਤਾਜਿਕਿਸਤਾਨ	tājikisatāna
ਟੋਕੇਲਾਉ	ṭōkēlā'u
ਤਿਮੋਰ-ਲੇਸਤੇ	timōra-lēsatē
ਪੂਰਬੀ ਤਿਮੋਰ	pūrabī timōra
ਤੁਰਕਮੇਨਿਸਤਾਨ	turakamēnisatāna
ਟਿਊਨੀਸ਼ੀਆ	ṭi'ūnīśī'ā
ਟੌਂਗਾ	ṭauṅgā
ਤੁਰਕੀ	turakī
ਟ੍ਰਿਨੀਡਾਡ ਅਤੇ ਟੋਬਾਗੋ	ṭrinīḍāḍa atē ṭōbāgō
ਟੁਵਾਲੂ	ṭuvālū
ਤਾਇਵਾਨ	tā'ivāna
ਤਨਜ਼ਾਨੀਆ	tanazānī'ā
ਯੂਕਰੇਨ	yūkarēna
ਯੂਗਾਂਡਾ	yūgāṇḍā
ਸੰਯੁਕਤ ਰਾਜ	sayukata rāja
ਉਰੂਗਵੇ	urūgavē
ਉਜ਼ਬੇਕਿਸਤਾਨ	uzabēkisatāna
ਵੈਟੀਕਨ ਸਿਟੀ	vaiṭīkana siṭī
ਸੇਂਟ ਵਿਨਸੈਂਟ ਐਂਡ ਗ੍ਰੇਨਾਡੀਨਸ	sēṇṭa vinasaiṇṭa aiṇḍa grēnāḍīnasa
ਵੇਨੇਜ਼ੂਏਲਾ	vēnēzū'ēlā
ਬ੍ਰਿਟਿਸ਼ ਵਰਜਿਨ ਟਾਪੂ	briṭiśa varajina ṭāpū
ਯੂ ਐਸ ਵਰਜਿਨ ਟਾਪੂ	yū aisa varajina ṭāpū
ਵੀਅਤਨਾਮ	vī'atanāma
ਵਾਨੂਆਟੂ	vānū'āṭū
ਵਾਲਿਸ ਅਤੇ ਫੂਟੂਨਾ	vālisa atē phūṭūnā
ਸਾਮੋਆ	sāmō'ā
ਕੋਸੋਵੋ	kōsōvō
ਯਮਨ	yamana
ਮਾਯੋਟੀ	māyōṭī
ਦੱਖਣੀ ਅਫਰੀਕਾ	dakhaṇī apharīkā
ਜ਼ਾਮਬੀਆ	zāmabī'ā
ਜ਼ਿੰਬਾਬਵੇ	zibābavē
ਅਣਪਛਾਤਾ ਖੇਤਰ	aṇapachātā khētara
