# Baby names
અંશ	انش
અકન્ગ્ષા	اكنجشا
અકશીની	اكشيني
અકસરા	اكسرا
અકાર્યસુતા	اكاريسوتا
અકાલકા	اكالكا
અકિતા	اكيتا
અક્ષધા	اكشدها
અક્ષ્યા	اكشيا
અક્સા	اكسا
અગ્નિશિખા	اجنيشيكها
અગ્રીમા	اجريما
અચલેંદ્ર	اتشليندر
અજન્તા	اجنتا
અજમુખી	اجموكهي
અજિયા	اجييا
અજીતા	اجيتا
અડ્યાદવૈતા	اديادوايتا
અદવૈકા	ادوايكا
અદિતરાજ	اديتراج
અદિત્યેશ	اديتييش
અદીતીયા	اديتييا
અદીરા	اديرا
અદેન્ય	اديني
અદ્રિતા	ادريتا
અદ્રિતી	ادريتي
અદ્વય	ادوي
અદ્વિકા	ادويكا
અદ્વેત	ادويت
અદ્વૈયા	ادواييا
અધીર	ادهير
અધીરતા	ادهيرتا
અધ્યાત્મ	ادهياتم
અબિનય	ابيني
અબિભવા	ابيبهوا
અબીનાવ	ابيناو
અબીશા	ابيشا
અબીસેશન	ابيسيشن
અબ્બીર	اببير
અભિજાત	ابهيجات
અભિજ્ઞાન	ابهيجنان
અભિનું	ابهينون
અભિપ્રિથિ	ابهيبريتهي
અભિમોદા	ابهيمودا
અભિરુચિ	ابهيروتشي
અભિવાદન	ابهيوادن
અભિસુમત	ابهيسومت
અભિસોકા	ابهيسوكا
અભીકાંક્ષા	ابهيكانكشا
અભીચંદ્ર	ابهيتشندر
અભીજુન	ابهيجون
અભીધર્મ	ابهيدهرم
અભીલેશ	ابهيليش
અભુ	ابهو
અભ્થા	ابهتها
અભ્રકાસિન	ابهركاسين
અરધ્યાય	اردهياي
અલંકારાપ્રિયા	النكارابرييا
અલંક્રિતા	النكريتا
અહીના	اهينا
આંદાલ	آندال
આંશી	آنشي
આએઇન્દ્રિ	آييندري
આકર્ષ	آكرش
આકાંક્ષ	آكانكش
આકામ્પન	آكامبن
આકાશ	آكاش
આકાશી	آكاشي
આકેશ	آكيش
આત્મજ	آتمج
આત્રયી	آتريي
આદાવન	آداون
આદિકવિ	آديكوي
આદિકેશ	آديكيش
આદિતિય	آديتيي
આદિત્વ	آديتو
આદિદેવ	آديديو
આદિશ	آديش
આદિશંકર	آديشنكر
આદિસેશ	آديسيش
આદીત્રી	آديتري
આદીલ	آديل
આદ્યા	آديا
આનંદતા	آنندتا
આનાધીતા	آنادهيتا
આનુષ	آنوش
આમાંની	آمانني
આયાતી	آياتي
આયુધ	آيوده
આરવી	آروي
આરા	آرا
આરાડ્યા	آراديا
આરાધક	آرادهك
આરાધના	آرادهنا
આરુન્ય	آروني
આરુપા	آروبا
આરોચન	آروتشن
આર્થ	آرته
આર્ય્થ્ય	آريتهي
આલય	آلي
આલિશા	آليشا
આલેઃયા	آليهايا
આલ્યા	آليا
આવાની	آواني
આવ્યા	آويا
આશાલી	آشالي
આશીર્વાદ	آشيرواد
આસ્યા	آسيا
આસ્વી	آسوي
આહ્નીક	آهنيك
ઇંદિરા	إنديرا
ઇંદિવર	إنديور
ઇંદુલેક્ષ	إندوليكش
ઇંદુશેખર	إندوشيكهر
ઇતિ	إتي
ઇતિશ્રી	إتيشري
ઇદિત્રી	إديتري
ઇનકી	إنكي
ઇન્કિત	إنكيت
ઇન્ગનામ	إنجنام
ઇન્દ્રતેજ	إندرتيج
ઇન્દ્રન	إندرن
ઇન્દ્રેશ	إندريش
ઇભાન	إبهان
ઇભ્યા	إبهيا
ઇયેનગર	إيينجر
ઇલવરસન	إلورسن
ઇલિસા	إليسا
ઇવાન	إوان
ઇશા	إشا
ઇશાયુ	إشايو
ઇસાર	إسار
ઇસીરી	إسيري
ઈઝ્રીને	إجهريني
ઈનિઅવેલન	إنياويلن
ઈનિયવન	إنييون
ઈન્દુસ	إندوس
ઈરીશ	إريش
ઈલ્વિકા	إلويكا
ઈશાંત	إشانت
ઈશિત	إشيت
ઈશ્મીતા	إشميتا
ઈશ્વ	إشو
ઈસાઈ	إساي
ઉજય	وجي
ઉજાગર	وجاجر
ઉજાસ	وجاس
ઉજીત્ર	وجيتر
ઉજેન્દ્ર	وجيندر
ઉજ્જાનિની	وججانيني
ઉજ્જ્વાલા	وججوالا
ઉત્કર્શ્રાજ	وتكرشراج
ઉત્કલ	وتكل
ઉત્કલીતા	وتكليتا
ઉત્કશાના	وتكشانا
ઉત્પત્તિ	وتبتتي
ઉત્પલ	وتبل
ઉત્વિક	وتويك
ઉત્સા	وتسا
ઉથીશા	وتهيشا
ઉદંત	ودنت
ઉદયાચલ	ودياتشل
ઉદરથી	ودرتهي
ઉદાર્શ	ودارش
ઉદેય	وديي
ઉદ્વંશ	ودونش
ઉધાયારની	ودهايارني
ઉપજય	وبجي
ઉપદા	وبدا
ઉપનાયિક	وبناييك
ઉપાગુપ્તા	وباجوبتا
ઉપેન્દ્રન	وبيندرن
ઉભય	وبهي
ઉમાંપુત્ર	ومانبوتر
ઉમાપત્ય	ومابتي
ઉમિકા	وميكا
ઉમેશ	وميش
ઉરિશિલ્લા	وريشيللا
ઉર્નીક	ورنيك
ઉર્મિલ	ورميل
ઉર્મિલા	ورميلا
ઉર્મી	ورمي
ઉર્વીશા	ورويشا
ઉલ્લાસીથા	وللاسيتها
ઉસહાસ	وسهاس
ઉસ્લુંનન	وسلوننن
ઊર્જિત	ورجيت
એઇલા	إييلا
એકદંતન	إيكدنتن
એકન્ષા	إيكنشا
એકાંશ	إيكانش
એકાચક્ર	إيكاتشكر
એકાવિરા	إيكاويرا
એકીશ	إيكيش
એકેસ્વારા	إيكيسوارا
એક્શીકા	إيكشيكا
એદોમ	إيدوم
એપ્શીતા	إيبشيتا
એલાવારાસન	إيلاواراسن
એલેના	إيلينا
એવાની	إيواني
એવોન	إيوون
એશંકા	إيشنكا
એશાન્ય	إيشاني
ઐસીરી	ايسيري
ઓજ્જસ્વીન	اوججسوين
ઓદથી	اودتهي
ઓનિશ	اونيش
ઓનીર	اونير
ઓન્નેશા	اوننيشا
ઓબલેશ	اوبليش
ઓમપતિ	اومبتي
ઓમવતી	اوموتي
ઓમિષા	اوميشا
ઓવીએ	اوويي
ઓહા	اوها
કંકના	كنكنا
કંજમ	كنجم
કંઠ	كنطه
કંવર	كنور
કતીરેશન	كتيريشن
કથીર	كتهير
કદિતુલા	كديتولا
કનક	كنك
કનીસા	كنيسا
કનુષ	كنوش
કપિલા	كبيلا
કમલનયન	كملنين
કમલાબંધુ	كملابندهو
કરબી	كربي
કરીના	كرينا
કરીશા	كريشا
કરીસમાં	كريسمان
કરુન્યા	كرونيا
કર્ણ	كرن
કર્તીગા	كرتيجا
કર્નાપ્રિયા	كرنابرييا
કર્નીકા	كرنيكا
કર્નીશ	كرنيش
કલમજીરરન્જિનિ	كلمجيررنجيني
કલાતર	كلاتر
કલાપક	كلابك
કલાપ્રિયા	كلابرييا
કલૈસેલવી	كلايسيلوي
કલ્પ	كلب
કલ્પેશ	كلبيش
કવચ	كوتش
કવિનયા	كوينيا
કવીપ્રનીતા	كويبرنيتا
કશિશ	كشيش
કશ્યપ	كشيب
કસ્તૂરી	كستوري
કહન	كهن
કાંવ	كانو
કાજળ	كاجر
કાત્યયાની	كاتيياني
કાદમ્બિની	كادمبيني
કાનાસુ	كاناسو
કાન્જીરા	كانجيرا
કામાખ્યા	كاماكهيا
કામિકા	كاميكا
કામીક	كاميك
કામેરીના	كاميرينا
કાયંશ	كاينش
કાયલવિલી	كايلويلي
કારૂકા	كاروكا
કાલપી	كالبي
કાલિંદી	كاليندي
કાલિરંજન	كاليرنجن
કાવ્યંશ	كاوينش
કાષ્ઠ	كاشطه
કિન્નેરા	كيننيرا
કિર્તિત	كيرتيت
કિશા	كيشا
કેતવ	كيتو
કેતિકા	كيتيكا
કેતીત	كيتيت
કેદારનાથ	كيدارناته
કેનિષા	كينيشا
કેયા	كييا
કેયાન	كييان
કેલ્વીન	كيلوين
કેવલકુમાર	كيولكومار
કેવિકા	كيويكا
કેવ્લીના	كيولينا
કેશિકા	كيشيكا
કેશિન	كيشين
કેશોરી	كيشوري
કેસવા	كيسوا
કૈરવી	كايروي
કૈલાશચંદ્ર	كايلاشتشندر
કૌશિક	كاوشيك
કૌશેય	كاوشيي
કૌસ્તુભી	كاوستوبهي
ખરાધ્વામ્સીને	كهرادهوامسيني
ખાદીર	كهادير
ખાવ્યા	كهاويا
ખુશ્બૂ	كهوشبو
ખેજલ	كهيجل
ગંગા	جنجا
ગંગિકા	جنجيكا
ગંગી	جنجي
ગંગેયા	جنجييا
ગંગેશ	جنجيش
ગંદિરા	جنديرا
ગંધા	جندها
ગંધાર	جندهار
ગજપતિ	ججبتي
ગ઼ુનસૂંદરી	جونسوندري
ગાંધામધના	جاندهامدهنا
ગાયન	جاين
ગાલવ	جالو
ગીતિકા	جيتيكا
ગીતીશા	جيتيشا
ગીતેશ	جيتيش
ગીત્શ	جيتش
ગીરિષા	جيريشا
ગીર્જેશ	جيرجيش
ગીવીથા	جيويتها
ગીહિતી	جيهيتي
ગુણવાથી	جونواتهي
ગુદાકેશ	جوداكيش
ગુનાક્ષી	جوناكشي
ગુનાનીધી	جونانيدهي
ગુનિના	جونينا
ગુનીત	جونيت
ગુરનામ	جورنام
ગુરીશ	جوريش
ગુરુશરણ	جوروشرن
ગોપાલ કૃષ્ણન	جوبال كرشنن
ગોવરી	جووري
ગોવ્થમી	جووتهمي
ગૌરિકાંત	جاوريكانت
ગૌરેશ	جاوريش
ગૌર્યનવી	جاورينوي
ગ્યાનવી	جيانوي
ગ્રહિત	جرهيت
ઘટા	جهطا
ઘનાનંદ	جهنانند
ઘુંગરૂ	جهونجرو
ચંચલાદવાલા	تشنتشلادوالا
ચંચારી	تشنتشاري
ચંચારીક	تشنتشاريك
ચંદિકા	تشنديكا
ચંદ્ર ભાન	تشندر بهان
ચંદ્રકિરણ	تشندركيرن
ચંદ્રકીર્તી	تشندركيرتي
ચંદ્રબિંદુ	تشندربيندو
ચક્રદેવ	تشكرديو
ચક્રિક	تشكريك
ચન્દ્રવદન	تشندرودن
ચન્દ્રહાસ	تشندرهاس
ચમેલી	تشميلي
ચરક	تشرك
ચરણજીત	تشرنجيت
ચરણરજ	تشرنرج
ચરિત	تشريت
ચરુલા	تشرولا
ચસ્મીતા	تشسميتا
ચાકરીન	تشاكرين
ચાને	تشاني
ચાન્નક્કા	تشاننككا
ચાન્નાય	تشانناي
ચારીકા	تشاريكا
ચારુદત્ત	تشارودتت
ચારુલતા	تشارولتا
ચારુશીલા	تشاروشيلا
ચિંટૂ	تشينطو
ચિતહેશ	تشيتهيش
ચિત્કલા	تشيتكلا
ચિત્તસ્વરૂપ	تشيتتسوروب
ચિત્રકુન્દાલા	تشيتركوندالا
ચિત્રલ	تشيترل
ચિત્રેશ	تشيتريش
ચિદાત્મા	تشيداتما
ચિધાત્મા	تشيدهاتما
ચિન્મય	تشينمي
ચિર્ત્રંગ	تشيرترنج
ચીન્નીઃ	تشيننيها
ચેથના	تشيتهنا
ચેનના	تشيننا
ચૈતન	تشايتن
ચૈત્રી	تشايتري
ચોલામિત્ર	تشولاميتر
ચૌનતા	تشاونتا
છાયા	تشهايا
જગતપાલ	ججتبال
જગદગુરુવે	ججدجورووي
જગદીપ	ججديب
જગન	ججن
જગિશ	ججيش
જગ્ગેર	جججير
જગ્સના	ججسنا
જનતા	جنتا
જનાદેવ	جناديو
જનાર્દનન	جناردنن
જનિતા	جنيتا
જન્મ	جنم
જમ્બાવતી	جمباوتي
જય ગોપાલ	جي جوبال
જયંતાસેના	جينتاسينا
જયદા	جيدا
જયન	جين
જયમેન	جيمين
જયલક્ષ્મી	جيلكشمي
જયલલીથા	جيلليتها
જયશેખર	جيشيكهر
જયહરી	جيهري
જયાકીર્તન	جياكيرتن
જયાપાદમાં	جيابادمان
જયાલક્ષ્મી	جيالكشمي
જય્મીની	جيميني
જલાગંધા	جلاجندها
જલાર્ક	جلارك
જલ્પેશ	جلبيش
જશપાલ	جشبال
જસ્લીના	جسلينا
જસ્વીથા	جسويتها
જસ્સીચા	جسسيتشا
જહાંગીર	جهانجير
જાગ્રત	جاجرت
જાગ્રવ	جاجرو
જાઝીમ	جاجهيم
જાતાવેદાસ	جاتاويداس
જાનકીરમન	جانكيرمن
જાનવી	جانوي
જાનહાન	جانهان
જાન્વી	جانوي
જામીની	جاميني
જાલેંદ્ર	جاليندر
જાહનવી	جاهنوي
જિનાભદ્ર	جينابهدر
જિલેશ	جيليش
જિલ્પા	جيلبا
જીગર	جيجر
જીતીશ	جيتيش
જીન	جين
જીન્શીત	جينشيت
જીમૂત	جيموت
જીલવ	جيلو
જીવા	جيوا
જીવિકા	جيويكا
જીવેશ	جيويش
જીશના	جيشنا
જીશું	جيشون
જુનીતા	جونيتا
જેગપ્રીયાન	جيجبرييان
જેતલ	جيتل
જેનીતા	جينيتا
જેબીશા	جيبيشا
જૈચંદ	جايتشند
જૈચરણ	جايتشرن
જૈદેવ	جايديو
જૈસંકર	جايسنكر
જૈસ્યા	جايسيا
જોયાત્રી	جوياتري
જોવાકી	جوواكي
જોવિતા	جوويتا
જોસ્યા	جوسيا
જ્ઞાન	جنان
જ્ઞાનાલ	جنانال
જ્યોસ્તના	جيوستنا
ઝંકાર	جهنكار
ઝરલ	جهرل
ઝાએઈ	جهايي
ઝારા	جهارا
ઝિનૂક	جهينوك
ઝુબીન	جهوبين
ઝુલિએર	جهوليير
ઝેનીલ	جهينيل
ઠરાનીકા	طهرانيكا
ડાલી	دالي
તંગમ	تنجم
તક્ષક	تكشك
તથાથાન	تتهاتهان
તનવી	تنوي
તનવીર	تنوير
તનિશ્ક	تنيشك
તનુપા	تنوبا
તન્નિષ્ઠા	تننيشطها
તન્વી શ્રી	تنوي شري
તપસેન્દ્ર	تبسيندر
તપસ્વિની	تبسويني
તમન	تمن
તમન્ના	تمننا
તમોનષ	تمونش
તયા	تيا
તરણ	ترن
તરનીજા	ترنيجا
તરુણી	تروني
તરુશ્રી	تروشري
તરોશ	تروش
તશા	تشا
તસ્મિ	تسمي
તસ્ય	تسي
તાનક	تانك
તાના	تانا
તાની	تاني
તાનીશતા	تانيشتا
તાન્વી	تانوي
તાન્વેશા	تانويشا
તામસી	تامسي
તામીલ્મરણ	تاميلمرن
તારક	تارك
તારકેશ	تاركيش
તારકેશ્વર	تاركيشور
તારાનીસેન	تارانيسين
તારોક	تاروك
તાલંક	تالنك
તાલીન	تالين
તાવીનીશ	تاوينيش
તિક્શીકા	تيكشيكا
તિજિલ	تيجيل
તિતિર	تيتير
તિનકા	تينكا
તિર્થાયાદ	تيرتهاياد
તિલકા	تيلكا
તિલોત્તમા	تيلوتتما
તીમિત	تيميت
તીમીતા	تيميتا
તીયાસા	تيياسا
તીરુગ્નાનમ	تيروجنانم
તીરુમેની	تيروميني
તીર્થરાજ	تيرتهراج
તીશા	تيشا
તુકારામ	توكارام
તુન્ગાર	تونجار
તુલસા	تولسا
તૃષા	ترشا
તેજસી	تيجسي
તેજસ્વીતા	تيجسويتا
તેજસ્વીની	تيجسويني
તેજેસ્વીની	تيجيسويني
તેજોભાદ્ર	تيجوبهادر
તેર્ષમ	تيرشم
તેહીહ્યા	تيهيهيا
તોમોગના	توموجنا
તોશાની	توشاني
તોશીન	توشين
તૌરુસ	تاوروس
ત્રિકાયા	تريكايا
ત્રિધાત્રી	تريدهاتري
ત્રિનાથ	تريناته
ત્રિભુવન	تريبهوون
ત્રિમૂર્તિ	تريمورتي
ત્રિયા	ترييا
ત્રિવેન્દ્ર	تريويندر
ત્રિશુલાંક	تريشولانك
ત્રિષર	تريشر
ત્રીનેશ	ترينيش
ત્રીભુવન	تريبهوون
ત્રીલોકાત્માને	تريلوكاتماني
ત્રીવીક્રમાં	تريويكرمان
ત્રીવીદ	تريويد
ત્રેયા	ترييا
થનીરિકા	تهنيريكا
થાનીકા	تهانيكا
થાનીષા	تهانيشا
થાનીસરી	تهانيسري
થાન્યસ્રી	تهانيسري
થામીલારાસન	تهاميلاراسن
થારન્યા	تهارنيا
થેન્મોલી	تهينمولي
થ્રાયા	تهرايا
દક્શીકા	دكشيكا
દક્ષિત	دكشيت
દક્ષેષ	دكشيش
દજ્શી	دجشي
દધીચિ	ددهيتشي
દયસરા	ديسرا
દયાકર	دياكر
દયાનીશ્કા	ديانيشكا
દરસાથ	درساته
દરહાસ	درهاس
દરિદ્રીયાનાશીની	دريدريياناشيني
દર્શિકા	درشيكا
દર્સીકા	درسيكا
દલજીત	دلجيت
દલ્શેર	دلشير
દશાગ્રીવા શીરોહરા	دشاجريوا شيروهرا
દસરાજા	دسراجا
દસ્માયા	دسمايا
દહા	دها
દહાના	دهانا
દાનુષ	دانوش
દારિકા	داريكا
દિક્ષી	ديكشي
દિપક્ષી	ديبكشي
દિપમ્શું	ديبمشون
દિપાશ્રી	ديباشري
દિપ્તા	ديبتا
દિશના	ديشنا
દીક્ષિકા	ديكشيكا
દીપનકર	ديبنكر
દીપમાળા	ديبمارا
દીપાના	ديبانا
દીપ્તિ	ديبتي
દેબન્શી	ديبنشي
દેબસ્મિતા	ديبسميتا
દેબાસીસ	ديباسيس
દેબોરહ	ديبوره
દેબ્પ્રસાદ	ديببرساد
દેવ કુમાર	ديو كومار
દેવકલી	ديوكلي
દેવકી	ديوكي
દેવતા	ديوتا
દેવમતિ	ديومتي
દેવર્સી	ديورسي
દેવાંગી	ديوانجي
દેવાંશ	ديوانش
દેવાજુતા	ديواجوتا
દેવાદાર્શીની	ديوادارشيني
દેવાદીત્યા	ديواديتيا
દેવાદ્યુમના	ديواديومنا
દેવાનંદન	ديوانندن
દેવાપી	ديوابي
દેવાલીના	ديوالينا
દેવિદાસ	ديويداس
દેવિના	ديوينا
દેવીકી	ديويكي
દેવેન્દ્રનાથ	ديويندرناته
દેવેન્દ્રશીકા	ديويندرشيكا
દેવેશી	ديويشي
દેવ્યમ	ديويم
દેવ્યાની	ديوياني
દેવ્વાન્તી	ديووانتي
દેશવા	ديشوا
દેશીકા	ديشيكا
દેસના	ديسنا
દેસીકા	ديسيكا
દેહ્ય	ديهي
દૈત્ય	دايتي
દૈના	داينا
દૈપાયન	دايباين
દૈવી	دايوي
ધક્શીતા	دهكشيتا
ધક્ષતા	دهكشتا
ધન લક્ષ્મી	دهن لكشمي
ધનધાન્યકી	دهندهانيكي
ધનશિકા	دهنشيكا
ધનિયા	دهنييا
ધનુંર્ધારા	دهنونردهارا
ધમેન્દ્ર	دهميندر
ધરમવીર	دهرموير
ધરાસુતા	دهراسوتا
ધર્મઅધ્યક્ષ	دهرمادهيكش
ધર્મકીર્તિ	دهرمكيرتي
ધર્મીશ્તા	دهرميشتا
ધવલ્યા	دهوليا
ધાર્શીકા	دهارشيكا
ધાવીશી	دهاويشي
ધિરા	دهيرا
ધીપ્ત્હા	دهيبتها
ધીમાહી	دهيماهي
ધૂન	دهون
ધૈર્ય	دهايري
ધ્રીશીકા	دهريشيكا
નંદ	نند
નંદકુમાર	نندكومار
નંદગોપાલ	نندجوبال
નક્શ	نكش
નક્ષાત્ર	نكشاتر
નગરજન	نجرجن
નબ્હિજ	نبهيج
નમસ્યૂ	نمسيو
નમીતા	نميتا
નયાજ	نياج
નયાસના	نياسنا
નરીતા	نريتا
નર્મદા	نرمدا
નવતેજ	نوتيج
નવિન	نوين
નાકીસકા	ناكيسكا
નાકુશ	ناكوش
નાગનાથ	ناجناته
નાગાંજલી	ناجانجلي
નાગાનંદિની	ناجاننديني
નાગાર્જુન	ناجارجون
નાગેસ્વારી	ناجيسواري
નાટકપ્રિય	ناطكبريي
નાથ	ناته
નાન્દુની	ناندوني
નાભિ	نابهي
નાયક	نايك
નાયકી	نايكي
નારંગ	نارنج
નારન	نارن
નારાયન	ناراين
નાર્સપ્પા	نارسببا
નાવાન્ય	ناواني
નાવાપ્રિયન	ناوابريين
નાશાલ	ناشال
નિકેતા	نيكيتا
નિખાલ	نيكهال
નિખિલ	نيكهيل
નિધન	نيدهن
નિપા	نيبا
નિબંધના	نيبندهنا
નિમેશ	نيميش
નિરામઈ	نيرامي
નિરામયા	نيراميا
નિરૂપા	نيروبا
નિલિની	نيليني
નિલ્લ	نيلل
નિશય	نيشي
નિશા	نيشا
નિશિ	نيشي
નિશિકા	نيشيكا
નિષ્ણાં	نيشنان
નિહિત	نيهيت
નીકુંજા	نيكونجا
નીકેશ્ય	نيكيشي
નીખેલ	نيكهيل
નીગી	نيجي
નીડી	نيدي
નીદિશ	نيديش
નીધા	نيدها
નીપા	نيبا
નીપુના	نيبونا
નીબેદીતા	نيبيديتا
નીરજ નયન	نيرج نين
નીરુધી	نيرودهي
નીરૈમાંથી	نيرايمانتهي
નીર્મુકતા	نيرموكتا
નીલંજન	نيلنجن
નીલાક્ષી	نيلاكشي
નીલ્પ્રબ્ભા	نيلبرببها
નીશીરા	نيشيرا
નીશોકા	نيشوكا
નીસ્ચીતા	نيستشيتا
નીસ્ચીથા	نيستشيتها
નેકા	نيكا
નેત્રતાવ	نيترتاو
નેમીચંદ	نيميتشند
નેવી	نيوي
નેશ્વારી	نيشواري
નૈનીશા	ناينيشا
નૈમિષા	نايميشا
નૈરુથી	نايروتهي
નૈલીકા	نايليكا
નૌરિન	ناورين
પંકજલોચના	بنكجلوتشنا
પંકિત	بنكيت
પંચમી	بنتشمي
પંડી	بندي
પંથ	بنته
પક્ષી	بكشي
પક્ષીન	بكشين
પઝ્હેની	بجههيني
પણ-ગેશ	بن-جيش
પત્ર	بتر
પત્રલિકા	بترليكا
પત્રીક	بتريك
પદમાંક્ષ્ય	بدمانكشي
પદમાવતી	بدماوتي
પદ્મ	بدم
પદ્માકર	بدماكر
પનિતા	بنيتا
પન્યશ્રી	بنيشري
પયોશ્નીકા	بيوشنيكا
પરમ	برم
પરમિલા	برميلا
પરવાસૂ	برواسو
પરસમે	برسمي
પરસ્માઈ	برسماي
પરાકાષ	براكاش
પરાક્રમ	براكرم
પરિચય	بريتشي
પરિષ	بريش
પરીસા	بريسا
પર્જન્ય	برجني
પર્નલ	برنل
પર્વત	بروت
પલાશરંજન	بلاشرنجن
પલોમી	بلومي
પલ્લબ	بللب
પલ્લવિની	بللويني
પલ્લવી	بللوي
પવીશ્ના	بويشنا
પહેલ	بهيل
પાઓલા	باولا
પાગલાવન	باجلاون
પાન્દિયન	بانديين
પારબ્રહ્મ	باربرهم
પારવાથી	بارواتهي
પારાવ	باراو
પાર્થવ	بارتهو
પાર્થિવ	بارتهيو
પાર્થીવેન્દ્ર	بارتهيويندر
પાર્વતી નંદન	باروتي نندن
પાર્વાથી	بارواتهي
પાવકી	باوكي
પાવના	باونا
પાવાકી	باواكي
પિંગલા	بينجلا
પીઅલ્લી	بياللي
પીતામ્બરા	بيتامبرا
પીનલ	بينل
પીયાશા	بيياشا
પીર્નાવ	بيرناو
પૂજન	بوجن
પૂર્ણલલીતા	بورنلليتا
પૂર્નાચંદ્રા	بورناتشندرا
પૂર્નામદા	بورنامدا
પૂર્વ	بورو
પૂર્વિકા	بورويكا
પૂર્વીજ્હા	بورويجها
પોંનન	بوننن
પોઉર્નીમાં	بوورنيمان
પોન્થારા	بونتهارا
પોરોમાં	بورومان
પોષ	بوش
પૌરવી	باوروي
પ્રંવુતા	برنووتا
પ્રગતીશા	برجتيشا
પ્રગ્યા	برجيا
પ્રણાલી	برنالي
પ્રનાદા	برنادا
પ્રન્જા	برنجا
પ્રભાકર	بربهاكر
પ્રભાતી	بربهاتي
પ્રભારૂપા	بربهاروبا
પ્રભાવતી	بربهاوتي
પ્રભ્રીતી	بربهريتي
પ્રહાર્શીની	برهارشيني
પ્રહાસા	برهاسا
પ્રાખ્યા	براكهيا
પ્રાણવાપ્રિયા	برانوابرييا
પ્રાનાદ	براناد
ફણીશ	بهنيش
ફલોની	بهلوني
ફુલ્લન	بهوللن
ફેની	بهيني
ફ્લાવીના	بهلاوينا
બત્નાસીદ્ધીકારા	بتناسيددهيكارا
બદરી	بدري
બન્દીન	بندين
બર્હન	برهن
બલામુરુગન	بلاموروجن
બલામ્બુ	بلامبو
બલ્લભ	بللبه
બવિયન	بويين
બસંતી	بسنتي
બસૂધા	بسودها
બાટલી	باطلي
બાલાજી	بالاجي
બાલારામ	بالارام
બાલેન્દ્ર	باليندر
બાહુબલી	باهوبلي
બાહુલ્ય	باهولي
બિંકા	بينكا
બિજય	بيجي
બિધાન	بيدهان
બિનોય	بينوي
બિભવાસુ	بيبهواسو
બિમલા	بيملا
બિમ્બ	بيمب
બિસાલા	بيسالا
બીકાશ	بيكاش
બીન્દુસાગર	بيندوساجر
બીબોસ્વાન	بيبوسوان
બીભાકર	بيبهاكر
બીલ્વાની	بيلواني
બીલ્વાનીલાયા	بيلوانيلايا
બુધીપ્રિયા	بودهيبرييا
બૂમિકા	بوميكا
બૃંદા	برندا
બેનીતા	بينيتا
બૈજયંતી	بايجينتي
બૈસાખી	بايساكهي
બૌમાંથી	باومانتهي
બ્રનુચિકા	برنوتشيكا
બ્રહ્માવતી	برهماوتي
બ્રિજબાલા	بريجبالا
ભગત	بهجت
ભગવંત	بهجونت
ભદ્રંગ	بهدرنج
ભદ્રક	بهدرك
ભદ્રકપિલ	بهدركبيل
ભરાન	بهران
ભર્તેશ	بهرتيش
ભવન	بهون
ભવરોગસ્યાભેશાજા	بهوروجسيابهيشاجا
ભવાની સંકર	بهواني سنكر
ભાગીરત	بهاجيرت
ભાગ્યશબરી	بهاجيشبري
ભાગ્યા	بهاجيا
ભાગ્યેશ	بهاجييش
ભાનુજ	بهانوج
ભાનુપ્રિયા	بهانوبرييا
ભાનુમિત્ર	بهانوميتر
ભારતી	بهارتي
ભારવી	بهاروي
ભારુ	بهارو
ભાર્ગવા	بهارجوا
ભાવાનીલ	بهاوانيل
ભાવાપ્રિયા	بهاوابرييا
ભાવામોચની	بهاواموتشني
ભાવાર્થ	بهاوارته
ભાવાલન	بهاوالن
ભાવિક	بهاويك
ભાવિન	بهاوين
ભાવેશ	بهاويش
ભાસુ	بهاسو
ભિમાંવેગ	بهيمانويج
ભીખી	بهيكهي
ભીમસેન	بهيمسين
ભીમાંન્શી	بهيماننشي
ભીલાનગના	بهيلانجنا
ભુવૈનીકા	بهوواينيكا
ભૂતપાલા	بهوتبالا
ભૂપેન્દ્ર	بهوبيندر
ભૂમીશ	بهوميش
ભૃગુ	بهرجو
ભેવીન	بهيوين
ભેસાજ	بهيساج
ભોજા	بهوجا
ભોલાનાથ	بهولاناته
મંગલા	منجلا
મંજુ પ્રસાદ	منجو برساد
મંજુનાથ	منجوناته
મંજુબાલા	منجوبالا
મંજૂશા	منجوشا
મંત	منت
મંત્રના	منترنا
મંથિકા	منتهيكا
મકર	مكر
મણિરત્ના	منيرتنا
મત્સ્યેંદ્ર	متسييندر
મદીન	مدين
મદુર	مدور
મધુ સ્મિતા	مدهو سميتا
મધુકાંત	مدهوكانت
મધુદીપ	مدهوديب
મધુમાંલી	مدهومانلي
મધુમાલતી	مدهومالتي
મધુલા	مدهولا
મધુલેખા	مدهوليكها
મનનશ	مننش
મનવિર	منوير
મનસ્વિન	منسوين
મનસ્વિની	منسويني
મનિભૂષણ	منيبهوشن
મનીતા	منيتا
મનીદીપ	منيديب
મનુજ	منوج
મનોથ	منوته
મનોભાવ	منوبهاو
મન્કુર	منكور
મયુરીની	ميوريني
મરીને	مريني
મલયજ	مليج
મલ્લિકા	ملليكا
મલ્લિકાર્જુન	ملليكارجون
મલ્લિગા	ملليجا
મલ્લી	مللي
મલ્લુ	مللو
મસરા	مسرا
મહંથી	مهنتهي
મહાત્મન	مهاتمن
મહાનંદ	مهانند
મહાપુરુષ	مهابوروش
મહાબુદ્ધિ	مهابوددهي
મહાર્થ	مهارته
મહાર્વીન	مهاروين
મહાલીંગ	مهالينج
મહાલ્યા	مهاليا
મહાશ્રી	مهاشري
મહિપતિ	مهيبتي
મહીથા	مهيتها
મહેંદ્રા	مهيندرا
માંગેશ	مانجيش
માંધુનીકા	ماندهونيكا
માંનાર્પ	ماننارب
માંનીક્યા	ماننيكيا
માંનીચ	ماننيتش
માંનીવ	ماننيو
માંનુંસ્મીથા	ماننونسميتها
માંનોત	ماننوت
માંન્ગીરી	ماننجيري
માંન્તીકા	ماننتيكا
માંન્દામારી	ماننداماري
માંન્દારિકા	ماننداريكا
માંલાવાશ્રી	مانلاواشري
માતંગા	ماتنجا
માતેઃ	ماتيها
માત્રે	ماتري
માથુર	ماتهور
માધવ દાસ	مادهو داس
માધવિલતા	مادهويلتا
માધાન	مادهان
માધુજ	مادهوج
માનજ	مانج
માનવિત	مانويت
માનીન્ત	مانينت
માન્દાવિક	مانداويك
મારવી	ماروي
મારીરાજ	ماريراج
મારુત	ماروت
માર્કાન્દાય	ماركانداي
માર્ગશી	مارجشي
માર્ગી	مارجي
માર્દવ	ماردو
માર્મિક	مارميك
માલતી	مالتي
માલથી	مالتهي
માલારવિલી	مالارويلي
માલારાવન	مالاراون
માલિની	ماليني
માહિતા	ماهيتا
મેધાસ્વી	ميدهاسوي
મૈથીલ્ય	مايتهيلي
મૈનાલી	ماينالي
મૈનાવી	مايناوي
મૈમત	مايمت
મૌલિકા	ماوليكا
મૌસુમ	ماوسوم
યજ્નારૂપ	يجناروب
યતિકા	يتيكا
યદુ	يدو
યદુક્રિષ્ના	يدوكريشنا
યદુવીર	يدووير
યમ્યા	يميا
યશિત	يشيت
યશોધર	يشودهر
યશ્દીપ	يشديب
યશ્વી	يشوي
યાઝટ	ياجهط
યાતિયાસા	ياتيياسا
યામાજીત	ياماجيت
યાશીકા	ياشيكا
યાશ્રી	ياشري
યાસી	ياسي
યાહ્વી	ياهوي
યીશાઈ	ييشاي
યુકાશ્રી	يوكاشري
યુક્ત	يوكت
યુગ	يوج
યુગંશ	يوجنش
યુગન	يوجن
યુગ્મ	يوجم
યુધાજિત	يودهاجيت
યુધિસઠિર	يودهيسطهير
યુનાય	يوناي
યુવંશ	يوونش
યુવાની	يوواني
યુવિક	يوويك
યૂરા	يورا
યેધાંત	ييدهانت
યેનાક્ષી	ييناكشي
યોગજ	يوجج
યોગદા	يوجدا
યોગના	يوجنا
યોગાવી	يوجاوي
યોગી	يوجي
યોગ્યથા	يوجيتها
યોનેન્દ્ર	يونيندر
યૌષા	ياوشا
રંગનાથ	رنجناته
રંતાજ	رنتاج
રકશ્ન્ડા	ركشندا
રકીશી	ركيشي
રક્તકમળ	ركتكمر
રક્ષ્ય	ركشي
રઘુનાથ	رجهوناته
રજીની	رجيني
રતન	رتن
રત્ના કુમાર	رتنا كومار
રત્નાબલી	رتنابلي
રત્નાવલી	رتناولي
રદીતે	رديتي
રનક	رنك
રનવા	رنوا
રનામીતા	رناميتا
રમિતા	رميتا
રમેશ	رميش
રમ્બેશ	رمبيش
રમ્યક	رميك
રયાપ્પા	رياببا
રવિકાંત	رويكانت
રવિકુમાર	رويكومار
રવીતેજા	رويتيجا
રવીન	روين
રવીન્ધાર	رويندهار
રવીશ	رويش
રવેન	روين
રશેષ	رشيش
રશ્મી	رشمي
રસવંત	رسونت
રહલ	رهل
રહસ્ય	رهسي
રાકવી	راكوي
રાખિ	راكهي
રાગાવર્દીની	راجاورديني
રાગ્વેદ	راجويد
રાજન	راجن
રાજરમણ	راجرمن
રાજલક્ષ્મી	راجلكشمي
રાજસેકરણ	راجسيكرن
રાજાન	راجان
રાજિંદર	راجيندر
રાજુસ	راجوس
રાજેંદ્ર	راجيندر
રાજેશ્રી	راجيشري
રાજ્કલા	راجكلا
રાજ્યશ્રી	راجيشري
રાજ્વિકા	راجويكا
રાત્રિ	راتري
રાધક	رادهك
રાધા	رادها
રાનું	رانون
રામ	رام
રામ  સેવક	رام  سيوك
રામનાથ	رامناته
રામરા	رامرا
રામસ્વરૂપ	رامسوروب
રામાંભાદ્રણ	رامانبهادرن
રામાધુતા	رامادهوتا
રાવના	راونا
રાસબિહારી	راسبيهاري
રિન્કલ	رينكل
રિસા	ريسا
રીકાર્નાવ	ريكارناو
રીકીતા	ريكيتا
રીકીશા	ريكيشا
રીગ્વેદીતા	ريجويديتا
રીથ	ريته
રીથેકા	ريتهيكا
રીધી	ريدهي
રીનું	رينون
રીન્સીન	رينسين
રીમા	ريما
રીશીતા	ريشيتا
રીહાનના	ريهاننا
રેચિકા	ريتشيكا
રેનેશ	رينيش
રેમિથા	ريميتها
રેશમી	ريشمي
રોનક	رونك
લકી	لكي
લક્ષિતા	لكشيتا
લક્ષ્મી શ્રીનિવાસ	لكشمي شرينيواس
લક્ષ્મીદેવી	لكشميديوي
લક્ષ્મીનાથ	لكشميناته
લગાન	لجان
લજ્જા	لججا
લજ્જાન	لججان
લજ્જાવતી	لججاوتي
લતા	لتا
લબોની	لبوني
લલિતામોહના	لليتاموهنا
લશિકા	لشيكا
લાઈના	لاينا
લાકેશ	لاكيش
લાક્શેતા	لاكشيتا
લાચ્મન	لاتشمن
લાતીશ	لاتيش
લાધી	لادهي
લારીસા	لاريسا
લાર્મિકા	لارميكا
લાલીતેશ	لاليتيش
લાલીત્યા	لاليتيا
લાલીમા	لاليما
લાવણ્ય	لاوني
લાવીશ	لاويش
લાસીવીન્રાજ	لاسيوينراج
લાસુશા	لاسوشا
લિંગાધ્યક્ષ	لينجادهيكش
લીકીથ	ليكيته
લીથીકા	ليتهيكا
લીનું	لينون
લીન્નેત	ليننيت
લીમીશા	ليميشا
લીલાધર	ليلادهر
લીલાવર્તી	ليلاورتي
લીશાંત	ليشانت
લુંહાન	لونهان
લુકેશા	لوكيشا
લૂની	لوني
લેઓરા	لياورا
લેખિત	ليكهيت
લેના	لينا
લેમ્મીએ	ليمميي
લોઉકિક	لووكيك
લોકનાથ	لوكناته
લોકનેત્ર	لوكنيتر
લોકાજિત	لوكاجيت
લોકેન્દ્ર	لوكيندر
લોક્ષી	لوكشي
લોપેશ	لوبيش
લોલા	لولا
લોલિતા	لوليتا
લોવ્યમ	لوويم
લોશીની	لوشيني
લોહિની	لوهيني
વંદિત	ونديت
વંશજા	ونشجا
વંહી	ونهي
વકૃત	وكرت
વક્ષ	وكش
વજરાંગ	وجرانج
વજ્રબાહૂ	وجرباهو
વજ્રાકાયા	وجراكايا
વજ્રિન	وجرين
વજ્રેશ્વરી	وجريشوري
વનદેવ	ونديو
વનાની	وناني
વયુનંદ	ويونند
વય્યા	وييا
વરજોત્તામાં	ورجوتتامان
વરદરાજ	وردراج
વરદાન	وردان
વરપ્રદા	وربردا
વરલક્ષ્મી	ورلكشمي
વરિયાસ	وريياس
વર્ધીન	وردهين
વર્શિની	ورشيني
વલાવન	ولاون
વલ્લભ	وللبه
વશીતા	وشيتا
વસંતા	وسنتا
વસતીન	وستين
વસવી	وسوي
વસુલ	وسول
વાક્પતિ	واكبتي
વાચસ્પતિ	واتشسبتي
વાચ્ય	واتشي
વાજ્રહાસ્તા	واجرهاستا
વાનામાલી	وانامالي
વાનાવારાયણ	واناواراين
વાનૈપકા-વેરીન્દોન	وانايبكا-ويريندون
વામન	وامن
વામાંનીએ	واماننيي
વાર	وار
વાલકય	والكي
વાલી	والي
વાસંતાપ્રભા	واسنتابربها
વાસુકી	واسوكي
વાસુમાંથા	واسومانتها
વિઅર	ويار
વિકાસીની	ويكاسيني
વિકાસ્ની	ويكاسني
વિક્ષિત	ويكشيت
વિદ્વાથ	ويدواته
વિધિ	ويدهي
વિનતા	وينتا
વિબુષા	ويبوشا
વિભાવા	ويبهاوا
વિમલા	ويملا
વિરબાહુ	ويرباهو
વિલાસિની	ويلاسيني
વીક્ષા	ويكشا
વીચિકા	ويتشيكا
વીજીલા	ويجيلا
વીની	ويني
વીમા	ويما
વીરોત્તમ	ويروتتم
વેક્રાંત	ويكرانت
વેગવાહીની	ويجواهيني
વેણુગોપાલ	وينوجوبال
વેત્રિવાલ	ويتريوال
વેદાંશી	ويدانشي
વેદાત્મન	ويداتمن
વેદાત્મને	ويداتمني
વેદાર્થ	ويدارته
વેદીષ	ويديش
વેધા	ويدها
વેધાસ	ويدهاس
વેધીકા	ويدهيكا
વેનાહ	ويناه
વેનીધર	وينيدهر
વેન્કાત્શીવા	وينكاتشيوا
વેન્નેલા	ويننيلا
વેલુ	ويلو
વેવેશા	ويويشا
વૈજનાથ	وايجناته
વૈદાહી	وايداهي
વૈદ્યનાથ	وايديناته
વૈધે	وايدهي
વૈનાવિન	وايناوين
વૈશાકા	وايشاكا
વૈશાખી	وايشاكهي
વૈશાલી	وايشالي
વૈશ્વિક	وايشويك
વૈષ્ણવી	وايشنوي
વૈસાખી	وايساكهي
સંચાલી	سنتشالي
સંજય	سنجي
સંજીથા	سنجيتها
સંજુકતા	سنجوكتا
સંતવાના	سنتوانا
સંદીતી	سنديتي
સંદીપન	سنديبن
સંભાવના	سنبهاونا
સંયક્તા	سنيكتا
સંવિકા	سنويكا
સંસ્કૃતિ	سنسكرتي
સંસ્કૃતી	سنسكرتي
સકલ	سكل
સક્તીવેલ	سكتيويل
સક્શિક	سكشيك
સક્શીન્યા	سكشينيا
સક્ષમ	سكشم
સચંદ્ર	ستشندر
સજૂ	سجو
સદગુરૂ	سدجورو
સદબિંદુ	سدبيندو
સદરુ	سدرو
સદા શિવમ	سدا شيوم
સદાશિવ	سداشيو
સદિવા	سديوا
સદ્વિખા	سدويكها
સનવ	سنو
સનીલ	سنيل
સનેશ	سنيش
સનૈતા	سنايتا
સપર્ણા	سبرنا
સપુષ્પા	سبوشبا
સપ્તોર્શી	سبتورشي
સબરીનાથાન	سبريناتهان
સભ્રાંત	سبهرانت
સમન્યુ	سمنيو
સમબરણ	سمبرن
સમભ્દ્ધા	سمبهددها
સમય	سمي
સમરવીર	سمروير
સમાંર્ધ	سمانرده
સમાધાન	سمادهان
સમિયા	سمييا
સમીક્ક્સા	سميككسا
સમીક્ષા	سميكشا
સમ્બુદ્ધા	سمبوددها
સમ્યનાતન	سميناتن
સમ્રીધ	سمريده
સમ્હીઠા	سمهيطها
સરલા	سرلا
સર્જના	سرجنا
સહલાદ	سهلاد
સહસ્ત્રજિત	سهسترجيت
સહસ્વીની	سهسويني
સહુરી	سهوري
સહૃદય	سهردي
સહેજ	سهيج
સહોજ	سهوج
સહ્ય	سهي
સાંદીપની	سانديبني
સાઈ અમર્ત્ય	ساي امرتي
સાઈ કાર્તિક	ساي كارتيك
સાઈ દાસ	ساي داس
સાઈ સુરિયા	ساي سورييا
સાતેજ	ساتيج
સાદ્રીશી	سادريشي
સાધકા	سادهكا
સાધન	سادهن
સાનંદના	سانندنا
સાનવી તારીતા	سانوي تاريتا
સાનાવી	ساناوي
સાન્વી	سانوي
સાફલ્ય	سابهلي
સાબી	سابي
સામલી	ساملي
સામાન	سامان
સારંગી	سارنجي
સારસ	سارس
સારાવતી	ساراوتي
સાલીની	ساليني
સાહસ્રપાત	ساهسربات
સાહુલ	ساهول
સેન્ડી	سيندي
સૈનિ	سايني
સૈનું	ساينون
સૈય્યન	ساييين
સૈલેન્દ્ર	سايليندر
સૈશા	سايشا
હંસરાજ	هنسراج
હંસાવાથ્ય	هنساواتهي
હંસિન	هنسين
હંસીની	هنسيني
હઝેલ	هجهيل
હનસીકા	هنسيكا
હનાર્વીન	هناروين
હનુમાન	هنومان
હમૃથા	همرتها
હમ્સિની	همسيني
હરશું	هرشون
હરા	هرا
હરિઅક્સા	هرياكسا
હરિકિશન	هريكيشن
હરિદા	هريدا
હરિનાક્ષી	هريناكشي
હરિમંતી	هريمنتي
હરી	هري
હરી કિશન	هري كيشن
હરીકરણ	هريكرن
હરીદર્પા	هريدربا
હરીદાસાપ્રિયા	هريداسابرييا
હરીદીપ	هريديب
હરીધામ	هريدهام
હરીવલ્લભ	هريوللبه
હરીશ્વ	هريشو
હર્લીના	هرلينا
હર્શાશ્રી	هرشاشري
હર્શિક	هرشيك
હર્ષ વીર	هرش وير
હર્ષિતા	هرشيتا
હર્સ્વીતા	هرسويتا
હલેય	هليي
હવીસા	هويسا
હશન	هشن
હસીક	هسيك
હસીથા	هسيتها
હસ્મીથા	هسميتها
હાકેશ	هاكيش
હાનીકા	هانيكا
હાર્શીની	هارشيني
હાહન	هاهن
હિડિંબા	هيدينبا
હિતાંશી	هيتانشي
હિતેક્ષા	هيتيكشا
હિતેન્દ્ર	هيتيندر
હિનલ	هينل
હિનેશ	هينيش
હિમાકાર	هيماكار
હિમાઘ્ના	هيماجهنا
હિમાલ	هيمال
હિશા	هيشا
હિશેતા	هيشيتا
હીમીર	هيمير
હીરકની	هيركني
હીરાન્યાપ્પા	هيرانياببا
હીર્નાક્ષી	هيرناكشي
હીલ્લેય	هيلليي
હુમીશા	هوميشا
હુમૈલા	هومايلا
હેઇઅન	هييان
હેત	هيت
હેતની	هيتني
હેતવ	هيتو
હેત્વિક	هيتويك
હેમંત	هيمنت
હેમદેવ	هيمديو
હેમલતા	هيملتا
હેમા	هيما
હેમાઁગી	هيمانجي
હેમાંગા	هيمانجا
હેમાકેશ	هيماكيش
હેમાલા	هيمالا
હેમાલી	هيمالي
હેમાવતી	هيماوتي
હેમીતા	هيميتا
હેયન	هيين
હેશીકા	هيشيكا
હોનહાર	هونهار
હ્રિથિક	هريتهيك
હ્રીત્વિકા	هريتويكا
હ્રીદાન	هريدان
હ્રીવાન	هريوان
હ્રીશાંત	هريشانت
હ્રીશાબ	هريشاب
હ્રીશુલ	هريشول
હ્રુધાઈ	هرودهاي
