# Baby names
અંશ	அஂஶ
અકન્ગ્ષા	அகந்க்ஷா
અકશીની	அகஶீநீ
અકસરા	அகஸரா
અકાર્યસુતા	அகார்யஸுதா
અકાલકા	அகாலகா
અકિતા	அகிதா
અક્ષધા	அக்ஷதா
અક્ષ્યા	அக்ஷ்யா
અક્સા	அக்ஸா
અગ્નિશિખા	அக்நிஶிகா
અગ્રીમા	அக்ரீமா
અચલેંદ્ર	அசலேஂத்ர
અજન્તા	அஜந்தா
અજમુખી	அஜமுகீ
અજિયા	அஜியா
અજીતા	அஜீதா
અડ્યાદવૈતા	அட்யாதவைதா
અદવૈકા	அதவைகா
અદિતરાજ	அதிதராஜ
અદિત્યેશ	அதித்யேஶ
અદીતીયા	அதீதீயா
અદીરા	அதீரா
અદેન્ય	அதேந்ய
અદ્રિતા	அத்ரிதா
અદ્રિતી	அத்ரிதீ
અદ્વય	அத்வய
અદ્વિકા	அத்விகா
અદ્વેત	அத்வேத
અદ્વૈયા	அத்வையா
અધીર	அதீர
અધીરતા	அதீரதா
અધ્યાત્મ	அத்யாத்ம
અબિનય	அபிநய
અબિભવા	அபிபவா
અબીનાવ	அபீநாவ
અબીશા	அபீஶா
અબીસેશન	அபீஸேஶந
અબ્બીર	அப்பீர
અભિજાત	அபிஜாத
અભિજ્ઞાન	அபிஜ்ஞாந
અભિનું	அபிநுஂ
અભિપ્રિથિ	அபிப்ரிதி
અભિમોદા	அபிமோதா
અભિરુચિ	அபிருசி
અભિવાદન	அபிவாதந
અભિસુમત	அபிஸுமத
અભિસોકા	அபிஸோகா
અભીકાંક્ષા	அபீகாஂக்ஷா
અભીચંદ્ર	அபீசஂத்ர
અભીજુન	அபீஜுந
અભીધર્મ	அபீதர்ம
અભીલેશ	அபீலேஶ
અભુ	அபு
અભ્થા	அப்தா
અભ્રકાસિન	அப்ரகாஸிந
અરધ્યાય	அரத்யாய
અલંકારાપ્રિયા	அலஂகாராப்ரியா
અલંક્રિતા	அலஂக்ரிதா
અહીના	அஹீநா
આંદાલ	ஆஂதால
આંશી	ஆஂஶீ
આએઇન્દ્રિ	ஆஏஇந்த்ரி
આકર્ષ	ஆகர்ஷ
આકાંક્ષ	ஆகாஂக்ஷ
આકામ્પન	ஆகாம்பந
આકાશ	ஆகாஶ
આકાશી	ஆகாஶீ
આકેશ	ஆகேஶ
આત્મજ	ஆத்மஜ
આત્રયી	ஆத்ரயீ
આદાવન	ஆதாவந
આદિકવિ	ஆதிகவி
આદિકેશ	ஆதிகேஶ
આદિતિય	ஆதிதிய
આદિત્વ	ஆதித்வ
આદિદેવ	ஆதிதேவ
આદિશ	ஆதிஶ
આદિશંકર	ஆதிஶஂகர
આદિસેશ	ஆதிஸேஶ
આદીત્રી	ஆதீத்ரீ
આદીલ	ஆதீல
આદ્યા	ஆத்யா
આનંદતા	ஆநஂததா
આનાધીતા	ஆநாதீதா
આનુષ	ஆநுஷ
આમાંની	ஆமாஂநீ
આયાતી	ஆயாதீ
આયુધ	ஆயுத
આરવી	ஆரவீ
આરા	ஆரா
આરાડ્યા	ஆராட்யா
આરાધક	ஆராதக
આરાધના	ஆராதநா
આરુન્ય	ஆருந்ய
આરુપા	ஆருபா
આરોચન	ஆரோசந
આર્થ	ஆர்த
આર્ય્થ્ય	ஆர்ய்த்ய
આલય	ஆலய
આલિશા	ஆலிஶா
આલેઃયા	ஆலேஃயா
આલ્યા	ஆல்யா
આવાની	ஆவாநீ
આવ્યા	ஆவ்யா
આશાલી	ஆஶாலீ
આશીર્વાદ	ஆஶீர்வாத
આસ્યા	ஆஸ்யா
આસ્વી	ஆஸ்வீ
આહ્નીક	ஆஹ்நீக
ઇંદિરા	இஂதிரா
ઇંદિવર	இஂதிவர
ઇંદુલેક્ષ	இஂதுலேக்ஷ
ઇંદુશેખર	இஂதுஶேகர
ઇતિ	இதி
ઇતિશ્રી	இதிஶ்ரீ
ઇદિત્રી	இதித்ரீ
ઇનકી	இநகீ
ઇન્કિત	இந்கித
ઇન્ગનામ	இந்கநாம
ઇન્દ્રતેજ	இந்த்ரதேஜ
ઇન્દ્રન	இந்த்ரந
ઇન્દ્રેશ	இந்த்ரேஶ
ઇભાન	இபாந
ઇભ્યા	இப்யா
ઇયેનગર	இயேநகர
ઇલવરસન	இலவரஸந
ઇલિસા	இலிஸா
ઇવાન	இவாந
ઇશા	இஶா
ઇશાયુ	இஶாயு
ઇસાર	இஸார
ઇસીરી	இஸீரீ
ઈઝ્રીને	ஈச்ரீநே
ઈનિઅવેલન	ஈநிஅவேலந
ઈનિયવન	ஈநியவந
ઈન્દુસ	ஈந்துஸ
ઈરીશ	ஈரீஶ
ઈલ્વિકા	ஈல்விகா
ઈશાંત	ஈஶாஂத
ઈશિત	ஈஶித
ઈશ્મીતા	ஈஶ்மீதா
ઈશ્વ	ஈஶ்வ
ઈસાઈ	ஈஸாஈ
ઉજય	உஜய
ઉજાગર	உஜாகர
ઉજાસ	உஜாஸ
ઉજીત્ર	உஜீத்ர
ઉજેન્દ્ર	உஜேந்த்ர
ઉજ્જાનિની	உஜ்ஜாநிநீ
ઉજ્જ્વાલા	உஜ்ஜ்வாலா
ઉત્કર્શ્રાજ	உத்கர்ஶ்ராஜ
ઉત્કલ	உத்கல
ઉત્કલીતા	உத்கலீதா
ઉત્કશાના	உத்கஶாநா
ઉત્પત્તિ	உத்பத்தி
ઉત્પલ	உத்பல
ઉત્વિક	உத்விக
ઉત્સા	உத்ஸா
ઉથીશા	உதீஶா
ઉદંત	உதஂத
ઉદયાચલ	உதயாசல
ઉદરથી	உதரதீ
ઉદાર્શ	உதார்ஶ
ઉદેય	உதேய
ઉદ્વંશ	உத்வஂஶ
ઉધાયારની	உதாயாரநீ
ઉપજય	உபஜய
ઉપદા	உபதா
ઉપનાયિક	உபநாயிக
ઉપાગુપ્તા	உபாகுப்தா
ઉપેન્દ્રન	உபேந்த்ரந
ઉભય	உபய
ઉમાંપુત્ર	உமாஂபுத்ர
ઉમાપત્ય	உமாபத்ய
ઉમિકા	உமிகா
ઉમેશ	உமேஶ
ઉરિશિલ્લા	உரிஶில்லா
ઉર્નીક	உர்நீக
ઉર્મિલ	உர்மில
ઉર્મિલા	உர்மிலா
ઉર્મી	உர்மீ
ઉર્વીશા	உர்வீஶா
ઉલ્લાસીથા	உல்லாஸீதா
ઉસહાસ	உஸஹாஸ
ઉસ્લુંનન	உஸ்லுஂநந
ઊર્જિત	ஊர்ஜித
એઇલા	ஏஇலா
એકદંતન	ஏகதஂதந
એકન્ષા	ஏகந்ஷா
એકાંશ	ஏகாஂஶ
એકાચક્ર	ஏகாசக்ர
એકાવિરા	ஏகாவிரா
એકીશ	ஏகீஶ
એકેસ્વારા	ஏகேஸ்வாரா
એક્શીકા	ஏக்ஶீகா
એદોમ	ஏதோம
એપ્શીતા	ஏப்ஶீதா
એલાવારાસન	ஏலாவாராஸந
એલેના	ஏலேநா
એવાની	ஏவாநீ
એવોન	ஏவோந
એશંકા	ஏஶஂகா
એશાન્ય	ஏஶாந்ய
ઐસીરી	ஐஸீரீ
ઓજ્જસ્વીન	ஓஜ்ஜஸ்வீந
ઓદથી	ஓததீ
ઓનિશ	ஓநிஶ
ઓનીર	ஓநீர
ઓન્નેશા	ஓந்நேஶா
ઓબલેશ	ஓபலேஶ
ઓમપતિ	ஓமபதி
ઓમવતી	ஓமவதீ
ઓમિષા	ஓமிஷா
ઓવીએ	ஓவீஏ
ઓહા	ஓஹா
કંકના	கஂகநா
કંજમ	கஂஜம
કંઠ	கஂட
કંવર	கஂவர
કતીરેશન	கதீரேஶந
કથીર	கதீர
કદિતુલા	கதிதுலா
કનક	கநக
કનીસા	கநீஸா
કનુષ	கநுஷ
કપિલા	கபிலா
કમલનયન	கமலநயந
કમલાબંધુ	கமலாபஂது
કરબી	கரபீ
કરીના	கரீநா
કરીશા	கரீஶா
કરીસમાં	கரீஸமாஂ
કરુન્યા	கருந்யா
કર્ણ	கர்ண
કર્તીગા	கர்தீகா
કર્નાપ્રિયા	கர்நாப்ரியா
કર્નીકા	கர்நீகா
કર્નીશ	கர்நீஶ
કલમજીરરન્જિનિ	கலமஜீரரந்ஜிநி
કલાતર	கலாதர
કલાપક	கலாபக
કલાપ્રિયા	கலாப்ரியா
કલૈસેલવી	கலைஸேலவீ
કલ્પ	கல்ப
કલ્પેશ	கல்பேஶ
કવચ	கவச
કવિનયા	கவிநயா
કવીપ્રનીતા	கவீப்ரநீதா
કશિશ	கஶிஶ
કશ્યપ	கஶ்யப
કસ્તૂરી	கஸ்தூரீ
કહન	கஹந
કાંવ	காஂவ
કાજળ	காஜள
કાત્યયાની	காத்யயாநீ
કાદમ્બિની	காதம்பிநீ
કાનાસુ	காநாஸு
કાન્જીરા	காந்ஜீரா
કામાખ્યા	காமாக்யா
કામિકા	காமிகா
કામીક	காமீக
કામેરીના	காமேரீநா
કાયંશ	காயஂஶ
કાયલવિલી	காயலவிலீ
કારૂકા	காரூகா
કાલપી	காலபீ
કાલિંદી	காலிஂதீ
કાલિરંજન	காலிரஂஜந
કાવ્યંશ	காவ்யஂஶ
કાષ્ઠ	காஷ்ட
કિન્નેરા	கிந்நேரா
કિર્તિત	கிர்தித
કિશા	கிஶா
કેતવ	கேதவ
કેતિકા	கேதிகா
કેતીત	கேதீத
કેદારનાથ	கேதாரநாத
કેનિષા	கேநிஷா
કેયા	கேயா
કેયાન	கேயாந
કેલ્વીન	கேல்வீந
કેવલકુમાર	கேவலகுமார
કેવિકા	கேவிகா
કેવ્લીના	கேவ்லீநா
કેશિકા	கேஶிகா
કેશિન	கேஶிந
કેશોરી	கேஶோரீ
કેસવા	கேஸவா
કૈરવી	கைரவீ
કૈલાશચંદ્ર	கைலாஶசஂத்ர
કૌશિક	கௌஶிக
કૌશેય	கௌஶேய
કૌસ્તુભી	கௌஸ்துபீ
ખરાધ્વામ્સીને	கராத்வாம்ஸீநே
ખાદીર	காதீர
ખાવ્યા	காவ்யா
ખુશ્બૂ	குஶ்பூ
ખેજલ	கேஜல
ગંગા	கஂகா
ગંગિકા	கஂகிகா
ગંગી	கஂகீ
ગંગેયા	கஂகேயா
ગંગેશ	கஂகேஶ
ગંદિરા	கஂதிரா
ગંધા	கஂதா
ગંધાર	கஂதார
ગજપતિ	கஜபதி
ગ઼ુનસૂંદરી	குநஸூஂதரீ
ગાંધામધના	காஂதாமதநா
ગાયન	காயந
ગાલવ	காலவ
ગીતિકા	கீதிகா
ગીતીશા	கீதீஶா
ગીતેશ	கீதேஶ
ગીત્શ	கீத்ஶ
ગીરિષા	கீரிஷா
ગીર્જેશ	கீர்ஜேஶ
ગીવીથા	கீவீதா
ગીહિતી	கீஹிதீ
ગુણવાથી	குணவாதீ
ગુદાકેશ	குதாகேஶ
ગુનાક્ષી	குநாக்ஷீ
ગુનાનીધી	குநாநீதீ
ગુનિના	குநிநா
ગુનીત	குநீத
ગુરનામ	குரநாம
ગુરીશ	குரீஶ
ગુરુશરણ	குருஶரண
ગોપાલ કૃષ્ણન	கோபால க்ரிஷ்ணந
ગોવરી	கோவரீ
ગોવ્થમી	கோவ்தமீ
ગૌરિકાંત	கௌரிகாஂத
ગૌરેશ	கௌரேஶ
ગૌર્યનવી	கௌர்யநவீ
ગ્યાનવી	க்யாநவீ
ગ્રહિત	க்ரஹித
ઘટા	கடா
ઘનાનંદ	கநாநஂத
ઘુંગરૂ	குஂகரூ
ચંચલાદવાલા	சஂசலாதவாலா
ચંચારી	சஂசாரீ
ચંચારીક	சஂசாரீக
ચંદિકા	சஂதிகா
ચંદ્ર ભાન	சஂத்ர பாந
ચંદ્રકિરણ	சஂத்ரகிரண
ચંદ્રકીર્તી	சஂத்ரகீர்தீ
ચંદ્રબિંદુ	சஂத்ரபிஂது
ચક્રદેવ	சக்ரதேவ
ચક્રિક	சக்ரிக
ચન્દ્રવદન	சந்த்ரவதந
ચન્દ્રહાસ	சந்த்ரஹாஸ
ચમેલી	சமேலீ
ચરક	சரக
ચરણજીત	சரணஜீத
ચરણરજ	சரணரஜ
ચરિત	சரித
ચરુલા	சருலா
ચસ્મીતા	சஸ்மீதா
ચાકરીન	சாகரீந
ચાને	சாநே
ચાન્નક્કા	சாந்நக்கா
ચાન્નાય	சாந்நாய
ચારીકા	சாரீகா
ચારુદત્ત	சாருதத்த
ચારુલતા	சாருலதா
ચારુશીલા	சாருஶீலா
ચિંટૂ	சிஂடூ
ચિતહેશ	சிதஹேஶ
ચિત્કલા	சித்கலா
ચિત્તસ્વરૂપ	சித்தஸ்வரூப
ચિત્રકુન્દાલા	சித்ரகுந்தாலா
ચિત્રલ	சித்ரல
ચિત્રેશ	சித்ரேஶ
ચિદાત્મા	சிதாத்மா
ચિધાત્મા	சிதாத்மா
ચિન્મય	சிந்மய
ચિર્ત્રંગ	சிர்த்ரஂக
ચીન્નીઃ	சீந்நீஃ
ચેથના	சேதநா
ચેનના	சேநநா
ચૈતન	சைதந
ચૈત્રી	சைத்ரீ
ચોલામિત્ર	சோலாமித்ர
ચૌનતા	சௌநதா
છાયા	சாயா
જગતપાલ	ஜகதபால
જગદગુરુવે	ஜகதகுருவே
જગદીપ	ஜகதீப
જગન	ஜகந
જગિશ	ஜகிஶ
જગ્ગેર	ஜக்கேர
જગ્સના	ஜக்ஸநா
જનતા	ஜநதா
જનાદેવ	ஜநாதேவ
જનાર્દનન	ஜநார்தநந
જનિતા	ஜநிதா
જન્મ	ஜந்ம
જમ્બાવતી	ஜம்பாவதீ
જય ગોપાલ	ஜய கோபால
જયંતાસેના	ஜயஂதாஸேநா
જયદા	ஜயதா
જયન	ஜயந
જયમેન	ஜயமேந
જયલક્ષ્મી	ஜயலக்ஷ்மீ
જયલલીથા	ஜயலலீதா
જયશેખર	ஜயஶேகர
જયહરી	ஜயஹரீ
જયાકીર્તન	ஜயாகீர்தந
જયાપાદમાં	ஜயாபாதமாஂ
જયાલક્ષ્મી	ஜயாலக்ஷ்மீ
જય્મીની	ஜய்மீநீ
જલાગંધા	ஜலாகஂதா
જલાર્ક	ஜலார்க
જલ્પેશ	ஜல்பேஶ
જશપાલ	ஜஶபால
જસ્લીના	ஜஸ்லீநா
જસ્વીથા	ஜஸ்வீதா
જસ્સીચા	ஜஸ்ஸீசா
જહાંગીર	ஜஹாஂகீர
જાગ્રત	ஜாக்ரத
જાગ્રવ	ஜாக்ரவ
જાઝીમ	ஜாசீம
જાતાવેદાસ	ஜாதாவேதாஸ
જાનકીરમન	ஜாநகீரமந
જાનવી	ஜாநவீ
જાનહાન	ஜாநஹாந
જાન્વી	ஜாந்வீ
જામીની	ஜாமீநீ
જાલેંદ્ર	ஜாலேஂத்ர
જાહનવી	ஜாஹநவீ
જિનાભદ્ર	ஜிநாபத்ர
જિલેશ	ஜிலேஶ
જિલ્પા	ஜில்பா
જીગર	ஜீகர
જીતીશ	ஜீதீஶ
જીન	ஜீந
જીન્શીત	ஜீந்ஶீத
જીમૂત	ஜீமூத
જીલવ	ஜீலவ
જીવા	ஜீவா
જીવિકા	ஜீவிகா
જીવેશ	ஜீவேஶ
જીશના	ஜீஶநா
જીશું	ஜீஶுஂ
જુનીતા	ஜுநீதா
જેગપ્રીયાન	ஜேகப்ரீயாந
જેતલ	ஜேதல
જેનીતા	ஜேநீதா
જેબીશા	ஜேபீஶா
જૈચંદ	ஜைசஂத
જૈચરણ	ஜைசரண
જૈદેવ	ஜைதேவ
જૈસંકર	ஜைஸஂகர
જૈસ્યા	ஜைஸ்யா
જોયાત્રી	ஜோயாத்ரீ
જોવાકી	ஜோவாகீ
જોવિતા	ஜோவிதா
જોસ્યા	ஜோஸ்யா
જ્ઞાન	ஜ்ஞாந
જ્ઞાનાલ	ஜ்ஞாநால
જ્યોસ્તના	ஜ்யோஸ்தநா
ઝંકાર	சஂகார
ઝરલ	சரல
ઝાએઈ	சாஏஈ
ઝારા	சாரா
ઝિનૂક	சிநூக
ઝુબીન	சுபீந
ઝુલિએર	சுலிஏர
ઝેનીલ	சேநீல
ઠરાનીકા	டராநீகா
ડાલી	டாலீ
તંગમ	தஂகம
તક્ષક	தக்ஷக
તથાથાન	ததாதாந
તનવી	தநவீ
તનવીર	தநவீர
તનિશ્ક	தநிஶ்க
તનુપા	தநுபா
તન્નિષ્ઠા	தந்நிஷ்டா
તન્વી શ્રી	தந்வீ ஶ்ரீ
તપસેન્દ્ર	தபஸேந்த்ர
તપસ્વિની	தபஸ்விநீ
તમન	தமந
તમન્ના	தமந்நா
તમોનષ	தமோநஷ
તયા	தயா
તરણ	தரண
તરનીજા	தரநீஜா
તરુણી	தருணீ
તરુશ્રી	தருஶ்ரீ
તરોશ	தரோஶ
તશા	தஶா
તસ્મિ	தஸ்மி
તસ્ય	தஸ்ய
તાનક	தாநக
તાના	தாநா
તાની	தாநீ
તાનીશતા	தாநீஶதா
તાન્વી	தாந்வீ
તાન્વેશા	தாந்வேஶா
તામસી	தாமஸீ
તામીલ્મરણ	தாமீல்மரண
તારક	தாரக
તારકેશ	தாரகேஶ
તારકેશ્વર	தாரகேஶ்வர
તારાનીસેન	தாராநீஸேந
તારોક	தாரோக
તાલંક	தாலஂக
તાલીન	தாலீந
તાવીનીશ	தாவீநீஶ
તિક્શીકા	திக்ஶீகா
તિજિલ	திஜில
તિતિર	திதிர
તિનકા	திநகா
તિર્થાયાદ	திர்தாயாத
તિલકા	திலகா
તિલોત્તમા	திலோத்தமா
તીમિત	தீமித
તીમીતા	தீமீதா
તીયાસા	தீயாஸா
તીરુગ્નાનમ	தீருக்நாநம
તીરુમેની	தீருமேநீ
તીર્થરાજ	தீர்தராஜ
તીશા	தீஶா
તુકારામ	துகாராம
તુન્ગાર	துந்கார
તુલસા	துலஸா
તૃષા	த்ரிஷா
તેજસી	தேஜஸீ
તેજસ્વીતા	தேஜஸ்வீதா
તેજસ્વીની	தேஜஸ்வீநீ
તેજેસ્વીની	தேஜேஸ்வீநீ
તેજોભાદ્ર	தேஜோபாத்ர
તેર્ષમ	தேர்ஷம
તેહીહ્યા	தேஹீஹ்யா
તોમોગના	தோமோகநா
તોશાની	தோஶாநீ
તોશીન	தோஶீந
તૌરુસ	தௌருஸ
ત્રિકાયા	த்ரிகாயா
ત્રિધાત્રી	த்ரிதாத்ரீ
ત્રિનાથ	த்ரிநாத
ત્રિભુવન	த்ரிபுவந
ત્રિમૂર્તિ	த்ரிமூர்தி
ત્રિયા	த்ரியா
ત્રિવેન્દ્ર	த்ரிவேந்த்ர
ત્રિશુલાંક	த்ரிஶுலாஂக
ત્રિષર	த்ரிஷர
ત્રીનેશ	த்ரீநேஶ
ત્રીભુવન	த்ரீபுவந
ત્રીલોકાત્માને	த்ரீலோகாத்மாநே
ત્રીવીક્રમાં	த்ரீவீக்ரமாஂ
ત્રીવીદ	த்ரீவீத
ત્રેયા	த்ரேயா
થનીરિકા	தநீரிகா
થાનીકા	தாநீகா
થાનીષા	தாநீஷா
થાનીસરી	தாநீஸரீ
થાન્યસ્રી	தாந்யஸ்ரீ
થામીલારાસન	தாமீலாராஸந
થારન્યા	தாரந்யா
થેન્મોલી	தேந்மோலீ
થ્રાયા	த்ராயா
દક્શીકા	தக்ஶீகா
દક્ષિત	தக்ஷித
દક્ષેષ	தக்ஷேஷ
દજ્શી	தஜ்ஶீ
દધીચિ	ததீசி
દયસરા	தயஸரா
દયાકર	தயாகர
દયાનીશ્કા	தயாநீஶ்கா
દરસાથ	தரஸாத
દરહાસ	தரஹாஸ
દરિદ્રીયાનાશીની	தரித்ரீயாநாஶீநீ
દર્શિકા	தர்ஶிகா
દર્સીકા	தர்ஸீகா
દલજીત	தலஜீத
દલ્શેર	தல்ஶேர
દશાગ્રીવા શીરોહરા	தஶாக்ரீவா ஶீரோஹரா
દસરાજા	தஸராஜா
દસ્માયા	தஸ்மாயா
દહા	தஹா
દહાના	தஹாநா
દાનુષ	தாநுஷ
દારિકા	தாரிகா
દિક્ષી	திக்ஷீ
દિપક્ષી	திபக்ஷீ
દિપમ્શું	திபம்ஶுஂ
દિપાશ્રી	திபாஶ்ரீ
દિપ્તા	திப்தா
દિશના	திஶநா
દીક્ષિકા	தீக்ஷிகா
દીપનકર	தீபநகர
દીપમાળા	தீபமாளா
દીપાના	தீபாநா
દીપ્તિ	தீப்தி
દેબન્શી	தேபந்ஶீ
દેબસ્મિતા	தேபஸ்மிதா
દેબાસીસ	தேபாஸீஸ
દેબોરહ	தேபோரஹ
દેબ્પ્રસાદ	தேப்ப்ரஸாத
દેવ કુમાર	தேவ குமார
દેવકલી	தேவகலீ
દેવકી	தேவகீ
દેવતા	தேவதா
દેવમતિ	தேவமதி
દેવર્સી	தேவர்ஸீ
દેવાંગી	தேவாஂகீ
દેવાંશ	தேவாஂஶ
દેવાજુતા	தேவாஜுதா
દેવાદાર્શીની	தேவாதார்ஶீநீ
દેવાદીત્યા	தேவாதீத்யா
દેવાદ્યુમના	தேவாத்யுமநா
દેવાનંદન	தேவாநஂதந
દેવાપી	தேவாபீ
દેવાલીના	தேவாலீநா
દેવિદાસ	தேவிதாஸ
દેવિના	தேவிநா
દેવીકી	தேவீகீ
દેવેન્દ્રનાથ	தேவேந்த்ரநாத
દેવેન્દ્રશીકા	தேவேந்த்ரஶீகா
દેવેશી	தேவேஶீ
દેવ્યમ	தேவ்யம
દેવ્યાની	தேவ்யாநீ
દેવ્વાન્તી	தேவ்வாந்தீ
દેશવા	தேஶவா
દેશીકા	தேஶீகா
દેસના	தேஸநா
દેસીકા	தேஸீகா
દેહ્ય	தேஹ்ய
દૈત્ય	தைத்ய
દૈના	தைநா
દૈપાયન	தைபாயந
દૈવી	தைவீ
ધક્શીતા	தக்ஶீதா
ધક્ષતા	தக்ஷதா
ધન લક્ષ્મી	தந லக்ஷ்மீ
ધનધાન્યકી	தநதாந்யகீ
ધનશિકા	தநஶிகா
ધનિયા	தநியா
ધનુંર્ધારા	தநுஂர்தாரா
ધમેન્દ્ર	தமேந்த்ர
ધરમવીર	தரமவீர
ધરાસુતા	தராஸுதா
ધર્મઅધ્યક્ષ	தர்மஅத்யக்ஷ
ધર્મકીર્તિ	தர்மகீர்தி
ધર્મીશ્તા	தர்மீஶ்தா
ધવલ્યા	தவல்யா
ધાર્શીકા	தார்ஶீகா
ધાવીશી	தாவீஶீ
ધિરા	திரா
ધીપ્ત્હા	தீப்த்ஹா
ધીમાહી	தீமாஹீ
ધૂન	தூந
ધૈર્ય	தைர்ய
ધ્રીશીકા	த்ரீஶீகா
નંદ	நஂத
નંદકુમાર	நஂதகுமார
નંદગોપાલ	நஂதகோபால
નક્શ	நக்ஶ
નક્ષાત્ર	நக்ஷாத்ர
નગરજન	நகரஜந
નબ્હિજ	நப்ஹிஜ
નમસ્યૂ	நமஸ்யூ
નમીતા	நமீதா
નયાજ	நயாஜ
નયાસના	நயாஸநா
નરીતા	நரீதா
નર્મદા	நர்மதா
નવતેજ	நவதேஜ
નવિન	நவிந
નાકીસકા	நாகீஸகா
નાકુશ	நாகுஶ
નાગનાથ	நாகநாத
નાગાંજલી	நாகாஂஜலீ
નાગાનંદિની	நாகாநஂதிநீ
નાગાર્જુન	நாகார்ஜுந
નાગેસ્વારી	நாகேஸ்வாரீ
નાટકપ્રિય	நாடகப்ரிய
નાથ	நாத
નાન્દુની	நாந்துநீ
નાભિ	நாபி
નાયક	நாயக
નાયકી	நாயகீ
નારંગ	நாரஂக
નારન	நாரந
નારાયન	நாராயந
નાર્સપ્પા	நார்ஸப்பா
નાવાન્ય	நாவாந்ய
નાવાપ્રિયન	நாவாப்ரியந
નાશાલ	நாஶால
નિકેતા	நிகேதா
નિખાલ	நிகால
નિખિલ	நிகில
નિધન	நிதந
નિપા	நிபா
નિબંધના	நிபஂதநா
નિમેશ	நிமேஶ
નિરામઈ	நிராமஈ
નિરામયા	நிராமயா
નિરૂપા	நிரூபா
નિલિની	நிலிநீ
નિલ્લ	நில்ல
નિશય	நிஶய
નિશા	நிஶா
નિશિ	நிஶி
નિશિકા	நிஶிகா
નિષ્ણાં	நிஷ்ணாஂ
નિહિત	நிஹித
નીકુંજા	நீகுஂஜா
નીકેશ્ય	நீகேஶ்ய
નીખેલ	நீகேல
નીગી	நீகீ
નીડી	நீடீ
નીદિશ	நீதிஶ
નીધા	நீதா
નીપા	நீபா
નીપુના	நீபுநா
નીબેદીતા	நீபேதீதா
નીરજ નયન	நீரஜ நயந
નીરુધી	நீருதீ
નીરૈમાંથી	நீரைமாஂதீ
નીર્મુકતા	நீர்முகதா
નીલંજન	நீலஂஜந
નીલાક્ષી	நீலாக்ஷீ
નીલ્પ્રબ્ભા	நீல்ப்ரப்பா
નીશીરા	நீஶீரா
નીશોકા	நீஶோகா
નીસ્ચીતા	நீஸ்சீதா
નીસ્ચીથા	நீஸ்சீதா
નેકા	நேகா
નેત્રતાવ	நேத்ரதாவ
નેમીચંદ	நேமீசஂத
નેવી	நேவீ
નેશ્વારી	நேஶ்வாரீ
નૈનીશા	நைநீஶா
નૈમિષા	நைமிஷா
નૈરુથી	நைருதீ
નૈલીકા	நைலீகா
નૌરિન	நௌரிந
પંકજલોચના	பஂகஜலோசநா
પંકિત	பஂகித
પંચમી	பஂசமீ
પંડી	பஂடீ
પંથ	பஂத
પક્ષી	பக்ஷீ
પક્ષીન	பக்ஷீந
પઝ્હેની	பச்ஹேநீ
પણ-ગેશ	பண-கேஶ
પત્ર	பத்ர
પત્રલિકા	பத்ரலிகா
પત્રીક	பத்ரீக
પદમાંક્ષ્ય	பதமாஂக்ஷ்ய
પદમાવતી	பதமாவதீ
પદ્મ	பத்ம
પદ્માકર	பத்மாகர
પનિતા	பநிதா
પન્યશ્રી	பந்யஶ்ரீ
પયોશ્નીકા	பயோஶ்நீகா
પરમ	பரம
પરમિલા	பரமிலா
પરવાસૂ	பரவாஸூ
પરસમે	பரஸமே
પરસ્માઈ	பரஸ்மாஈ
પરાકાષ	பராகாஷ
પરાક્રમ	பராக்ரம
પરિચય	பரிசய
પરિષ	பரிஷ
પરીસા	பரீஸா
પર્જન્ય	பர்ஜந்ய
પર્નલ	பர்நல
પર્વત	பர்வத
પલાશરંજન	பலாஶரஂஜந
પલોમી	பலோமீ
પલ્લબ	பல்லப
પલ્લવિની	பல்லவிநீ
પલ્લવી	பல்லவீ
પવીશ્ના	பவீஶ்நா
પહેલ	பஹேல
પાઓલા	பாஓலா
પાગલાવન	பாகலாவந
પાન્દિયન	பாந்தியந
પારબ્રહ્મ	பாரப்ரஹ்ம
પારવાથી	பாரவாதீ
પારાવ	பாராவ
પાર્થવ	பார்தவ
પાર્થિવ	பார்திவ
પાર્થીવેન્દ્ર	பார்தீவேந்த்ர
પાર્વતી નંદન	பார்வதீ நஂதந
પાર્વાથી	பார்வாதீ
પાવકી	பாவகீ
પાવના	பாவநா
પાવાકી	பாவாகீ
પિંગલા	பிஂகலா
પીઅલ્લી	பீஅல்லீ
પીતામ્બરા	பீதாம்பரா
પીનલ	பீநல
પીયાશા	பீயாஶா
પીર્નાવ	பீர்நாவ
પૂજન	பூஜந
પૂર્ણલલીતા	பூர்ணலலீதா
પૂર્નાચંદ્રા	பூர்நாசஂத்ரா
પૂર્નામદા	பூர்நாமதா
પૂર્વ	பூர்வ
પૂર્વિકા	பூர்விகா
પૂર્વીજ્હા	பூர்வீஜ்ஹா
પોંનન	போஂநந
પોઉર્નીમાં	போஉர்நீமாஂ
પોન્થારા	போந்தாரா
પોરોમાં	போரோமாஂ
પોષ	போஷ
પૌરવી	பௌரவீ
પ્રંવુતા	ப்ரஂவுதா
પ્રગતીશા	ப்ரகதீஶா
પ્રગ્યા	ப்ரக்யா
પ્રણાલી	ப்ரணாலீ
પ્રનાદા	ப்ரநாதா
પ્રન્જા	ப்ரந்ஜா
પ્રભાકર	ப்ரபாகர
પ્રભાતી	ப்ரபாதீ
પ્રભારૂપા	ப்ரபாரூபா
પ્રભાવતી	ப்ரபாவதீ
પ્રભ્રીતી	ப்ரப்ரீதீ
પ્રહાર્શીની	ப்ரஹார்ஶீநீ
પ્રહાસા	ப்ரஹாஸா
પ્રાખ્યા	ப்ராக்யா
પ્રાણવાપ્રિયા	ப்ராணவாப்ரியா
પ્રાનાદ	ப்ராநாத
ફણીશ	பணீஶ
ફલોની	பலோநீ
ફુલ્લન	புல்லந
ફેની	பேநீ
ફ્લાવીના	ப்லாவீநா
બત્નાસીદ્ધીકારા	பத்நாஸீத்தீகாரா
બદરી	பதரீ
બન્દીન	பந்தீந
બર્હન	பர்ஹந
બલામુરુગન	பலாமுருகந
બલામ્બુ	பலாம்பு
બલ્લભ	பல்லப
બવિયન	பவியந
બસંતી	பஸஂதீ
બસૂધા	பஸூதா
બાટલી	பாடலீ
બાલાજી	பாலாஜீ
બાલારામ	பாலாராம
બાલેન્દ્ર	பாலேந்த்ர
બાહુબલી	பாஹுபலீ
બાહુલ્ય	பாஹுல்ய
બિંકા	பிஂகா
બિજય	பிஜய
બિધાન	பிதாந
બિનોય	பிநோய
બિભવાસુ	பிபவாஸு
બિમલા	பிமலா
બિમ્બ	பிம்ப
બિસાલા	பிஸாலா
બીકાશ	பீகாஶ
બીન્દુસાગર	பீந்துஸாகர
બીબોસ્વાન	பீபோஸ்வாந
બીભાકર	பீபாகர
બીલ્વાની	பீல்வாநீ
બીલ્વાનીલાયા	பீல்வாநீலாயா
બુધીપ્રિયા	புதீப்ரியா
બૂમિકા	பூமிகா
બૃંદા	ப்ரிஂதா
બેનીતા	பேநீதா
બૈજયંતી	பைஜயஂதீ
બૈસાખી	பைஸாகீ
બૌમાંથી	பௌமாஂதீ
બ્રનુચિકા	ப்ரநுசிகா
બ્રહ્માવતી	ப்ரஹ்மாவதீ
બ્રિજબાલા	ப்ரிஜபாலா
ભગત	பகத
ભગવંત	பகவஂத
ભદ્રંગ	பத்ரஂக
ભદ્રક	பத்ரக
ભદ્રકપિલ	பத்ரகபில
ભરાન	பராந
ભર્તેશ	பர்தேஶ
ભવન	பவந
ભવરોગસ્યાભેશાજા	பவரோகஸ்யாபேஶாஜா
ભવાની સંકર	பவாநீ ஸஂகர
ભાગીરત	பாகீரத
ભાગ્યશબરી	பாக்யஶபரீ
ભાગ્યા	பாக்யா
ભાગ્યેશ	பாக்யேஶ
ભાનુજ	பாநுஜ
ભાનુપ્રિયા	பாநுப்ரியா
ભાનુમિત્ર	பாநுமித்ர
ભારતી	பாரதீ
ભારવી	பாரவீ
ભારુ	பாரு
ભાર્ગવા	பார்கவா
ભાવાનીલ	பாவாநீல
ભાવાપ્રિયા	பாவாப்ரியா
ભાવામોચની	பாவாமோசநீ
ભાવાર્થ	பாவார்த
ભાવાલન	பாவாலந
ભાવિક	பாவிக
ભાવિન	பாவிந
ભાવેશ	பாவேஶ
ભાસુ	பாஸு
ભિમાંવેગ	பிமாஂவேக
ભીખી	பீகீ
ભીમસેન	பீமஸேந
ભીમાંન્શી	பீமாஂந்ஶீ
ભીલાનગના	பீலாநகநா
ભુવૈનીકા	புவைநீகா
ભૂતપાલા	பூதபாலா
ભૂપેન્દ્ર	பூபேந்த்ர
ભૂમીશ	பூமீஶ
ભૃગુ	ப்ரிகு
ભેવીન	பேவீந
ભેસાજ	பேஸாஜ
ભોજા	போஜா
ભોલાનાથ	போலாநாத
મંગલા	மஂகலா
મંજુ પ્રસાદ	மஂஜு ப்ரஸாத
મંજુનાથ	மஂஜுநாத
મંજુબાલા	மஂஜுபாலா
મંજૂશા	மஂஜூஶா
મંત	மஂத
મંત્રના	மஂத்ரநா
મંથિકા	மஂதிகா
મકર	மகர
મણિરત્ના	மணிரத்நா
મત્સ્યેંદ્ર	மத்ஸ்யேஂத்ர
મદીન	மதீந
મદુર	மதுர
મધુ સ્મિતા	மது ஸ்மிதா
મધુકાંત	மதுகாஂத
મધુદીપ	மதுதீப
મધુમાંલી	மதுமாஂலீ
મધુમાલતી	மதுமாலதீ
મધુલા	மதுலா
મધુલેખા	மதுலேகா
મનનશ	மநநஶ
મનવિર	மநவிர
મનસ્વિન	மநஸ்விந
મનસ્વિની	மநஸ்விநீ
મનિભૂષણ	மநிபூஷண
મનીતા	மநீதா
મનીદીપ	மநீதீப
મનુજ	மநுஜ
મનોથ	மநோத
મનોભાવ	மநோபாவ
મન્કુર	மந்குர
મયુરીની	மயுரீநீ
મરીને	மரீநே
મલયજ	மலயஜ
મલ્લિકા	மல்லிகா
મલ્લિકાર્જુન	மல்லிகார்ஜுந
મલ્લિગા	மல்லிகா
મલ્લી	மல்லீ
મલ્લુ	மல்லு
મસરા	மஸரா
મહંથી	மஹஂதீ
મહાત્મન	மஹாத்மந
મહાનંદ	மஹாநஂத
મહાપુરુષ	மஹாபுருஷ
મહાબુદ્ધિ	மஹாபுத்தி
મહાર્થ	மஹார்த
મહાર્વીન	மஹார்வீந
મહાલીંગ	மஹாலீஂக
મહાલ્યા	மஹால்யா
મહાશ્રી	மஹாஶ்ரீ
મહિપતિ	மஹிபதி
મહીથા	மஹீதா
મહેંદ્રા	மஹேஂத்ரா
માંગેશ	மாஂகேஶ
માંધુનીકા	மாஂதுநீகா
માંનાર્પ	மாஂநார்ப
માંનીક્યા	மாஂநீக்யா
માંનીચ	மாஂநீச
માંનીવ	மாஂநீவ
માંનુંસ્મીથા	மாஂநுஂஸ்மீதா
માંનોત	மாஂநோத
માંન્ગીરી	மாஂந்கீரீ
માંન્તીકા	மாஂந்தீகா
માંન્દામારી	மாஂந்தாமாரீ
માંન્દારિકા	மாஂந்தாரிகா
માંલાવાશ્રી	மாஂலாவாஶ்ரீ
માતંગા	மாதஂகா
માતેઃ	மாதேஃ
માત્રે	மாத்ரே
માથુર	மாதுர
માધવ દાસ	மாதவ தாஸ
માધવિલતા	மாதவிலதா
માધાન	மாதாந
માધુજ	மாதுஜ
માનજ	மாநஜ
માનવિત	மாநவித
માનીન્ત	மாநீந்த
માન્દાવિક	மாந்தாவிக
મારવી	மாரவீ
મારીરાજ	மாரீராஜ
મારુત	மாருத
માર્કાન્દાય	மார்காந்தாய
માર્ગશી	மார்கஶீ
માર્ગી	மார்கீ
માર્દવ	மார்தவ
માર્મિક	மார்மிக
માલતી	மாலதீ
માલથી	மாலதீ
માલારવિલી	மாலாரவிலீ
માલારાવન	மாலாராவந
માલિની	மாலிநீ
માહિતા	மாஹிதா
મેધાસ્વી	மேதாஸ்வீ
મૈથીલ્ય	மைதீல்ய
મૈનાલી	மைநாலீ
મૈનાવી	மைநாவீ
મૈમત	மைமத
મૌલિકા	மௌலிகா
મૌસુમ	மௌஸும
યજ્નારૂપ	யஜ்நாரூப
યતિકા	யதிகா
યદુ	யது
યદુક્રિષ્ના	யதுக்ரிஷ்நா
યદુવીર	யதுவீர
યમ્યા	யம்யா
યશિત	யஶித
યશોધર	யஶோதர
યશ્દીપ	யஶ்தீப
યશ્વી	யஶ்வீ
યાઝટ	யாசட
યાતિયાસા	யாதியாஸா
યામાજીત	யாமாஜீத
યાશીકા	யாஶீகா
યાશ્રી	யாஶ்ரீ
યાસી	யாஸீ
યાહ્વી	யாஹ்வீ
યીશાઈ	யீஶாஈ
યુકાશ્રી	யுகாஶ்ரீ
યુક્ત	யுக்த
યુગ	யுக
યુગંશ	யுகஂஶ
યુગન	யுகந
યુગ્મ	யுக்ம
યુધાજિત	யுதாஜித
યુધિસઠિર	யுதிஸடிர
યુનાય	யுநாய
યુવંશ	யுவஂஶ
યુવાની	யுவாநீ
યુવિક	யுவிக
યૂરા	யூரா
યેધાંત	யேதாஂத
યેનાક્ષી	யேநாக்ஷீ
યોગજ	யோகஜ
યોગદા	யோகதா
યોગના	யோகநா
યોગાવી	யோகாவீ
યોગી	யோகீ
યોગ્યથા	யோக்யதா
યોનેન્દ્ર	யோநேந்த்ர
યૌષા	யௌஷா
રંગનાથ	ரஂகநாத
રંતાજ	ரஂதாஜ
રકશ્ન્ડા	ரகஶ்ந்டா
રકીશી	ரகீஶீ
રક્તકમળ	ரக்தகமள
રક્ષ્ય	ரக்ஷ்ய
રઘુનાથ	ரகுநாத
રજીની	ரஜீநீ
રતન	ரதந
રત્ના કુમાર	ரத்நா குமார
રત્નાબલી	ரத்நாபலீ
રત્નાવલી	ரத்நாவலீ
રદીતે	ரதீதே
રનક	ரநக
રનવા	ரநவா
રનામીતા	ரநாமீதா
રમિતા	ரமிதா
રમેશ	ரமேஶ
રમ્બેશ	ரம்பேஶ
રમ્યક	ரம்யக
રયાપ્પા	ரயாப்பா
રવિકાંત	ரவிகாஂத
રવિકુમાર	ரவிகுமார
રવીતેજા	ரவீதேஜா
રવીન	ரவீந
રવીન્ધાર	ரவீந்தார
રવીશ	ரவீஶ
રવેન	ரவேந
રશેષ	ரஶேஷ
રશ્મી	ரஶ்மீ
રસવંત	ரஸவஂத
રહલ	ரஹல
રહસ્ય	ரஹஸ்ய
રાકવી	ராகவீ
રાખિ	ராகி
રાગાવર્દીની	ராகாவர்தீநீ
રાગ્વેદ	ராக்வேத
રાજન	ராஜந
રાજરમણ	ராஜரமண
રાજલક્ષ્મી	ராஜலக்ஷ்மீ
રાજસેકરણ	ராஜஸேகரண
રાજાન	ராஜாந
રાજિંદર	ராஜிஂதர
રાજુસ	ராஜுஸ
રાજેંદ્ર	ராஜேஂத்ர
રાજેશ્રી	ராஜேஶ்ரீ
રાજ્કલા	ராஜ்கலா
રાજ્યશ્રી	ராஜ்யஶ்ரீ
રાજ્વિકા	ராஜ்விகா
રાત્રિ	ராத்ரி
રાધક	ராதக
રાધા	ராதா
રાનું	ராநுஂ
રામ	ராம
રામ  સેવક	ராம  ஸேவக
રામનાથ	ராமநாத
રામરા	ராமரா
રામસ્વરૂપ	ராமஸ்வரூப
રામાંભાદ્રણ	ராமாஂபாத்ரண
રામાધુતા	ராமாதுதா
રાવના	ராவநா
રાસબિહારી	ராஸபிஹாரீ
રિન્કલ	ரிந்கல
રિસા	ரிஸா
રીકાર્નાવ	ரீகார்நாவ
રીકીતા	ரீகீதா
રીકીશા	ரீகீஶா
રીગ્વેદીતા	ரீக்வேதீதா
રીથ	ரீத
રીથેકા	ரீதேகா
રીધી	ரீதீ
રીનું	ரீநுஂ
રીન્સીન	ரீந்ஸீந
રીમા	ரீமா
રીશીતા	ரீஶீதா
રીહાનના	ரீஹாநநா
રેચિકા	ரேசிகா
રેનેશ	ரேநேஶ
રેમિથા	ரேமிதா
રેશમી	ரேஶமீ
રોનક	ரோநக
લકી	லகீ
લક્ષિતા	லக்ஷிதா
લક્ષ્મી શ્રીનિવાસ	லக்ஷ்மீ ஶ்ரீநிவாஸ
લક્ષ્મીદેવી	லக்ஷ்மீதேவீ
લક્ષ્મીનાથ	லக்ஷ்மீநாத
લગાન	லகாந
લજ્જા	லஜ்ஜா
લજ્જાન	லஜ்ஜாந
લજ્જાવતી	லஜ்ஜாவதீ
લતા	லதா
લબોની	லபோநீ
લલિતામોહના	லலிதாமோஹநா
લશિકા	லஶிகா
લાઈના	லாஈநா
લાકેશ	லாகேஶ
લાક્શેતા	லாக்ஶேதா
લાચ્મન	லாச்மந
લાતીશ	லாதீஶ
લાધી	லாதீ
લારીસા	லாரீஸா
લાર્મિકા	லார்மிகா
લાલીતેશ	லாலீதேஶ
લાલીત્યા	லாலீத்யா
લાલીમા	லாலீமா
લાવણ્ય	லாவண்ய
લાવીશ	லாவீஶ
લાસીવીન્રાજ	லாஸீவீந்ராஜ
લાસુશા	லாஸுஶா
લિંગાધ્યક્ષ	லிஂகாத்யக்ஷ
લીકીથ	லீகீத
લીથીકા	லீதீகா
લીનું	லீநுஂ
લીન્નેત	லீந்நேத
લીમીશા	லீமீஶா
લીલાધર	லீலாதர
લીલાવર્તી	லீலாவர்தீ
લીશાંત	லீஶாஂத
લુંહાન	லுஂஹாந
લુકેશા	லுகேஶா
લૂની	லூநீ
લેઓરા	லேஓரா
લેખિત	லேகித
લેના	லேநா
લેમ્મીએ	லேம்மீஏ
લોઉકિક	லோஉகிக
લોકનાથ	லோகநாத
લોકનેત્ર	லோகநேத்ர
લોકાજિત	லோகாஜித
લોકેન્દ્ર	லோகேந்த்ர
લોક્ષી	லோக்ஷீ
લોપેશ	லோபேஶ
લોલા	லோலா
લોલિતા	லோலிதா
લોવ્યમ	லோவ்யம
લોશીની	லோஶீநீ
લોહિની	லோஹிநீ
વંદિત	வஂதித
વંશજા	வஂஶஜா
વંહી	வஂஹீ
વકૃત	வக்ரித
વક્ષ	வக்ஷ
વજરાંગ	வஜராஂக
વજ્રબાહૂ	வஜ்ரபாஹூ
વજ્રાકાયા	வஜ்ராகாயா
વજ્રિન	வஜ்ரிந
વજ્રેશ્વરી	வஜ்ரேஶ்வரீ
વનદેવ	வநதேவ
વનાની	வநாநீ
વયુનંદ	வயுநஂத
વય્યા	வய்யா
વરજોત્તામાં	வரஜோத்தாமாஂ
વરદરાજ	வரதராஜ
વરદાન	வரதாந
વરપ્રદા	வரப்ரதா
વરલક્ષ્મી	வரலக்ஷ்மீ
વરિયાસ	வரியாஸ
વર્ધીન	வர்தீந
વર્શિની	வர்ஶிநீ
વલાવન	வலாவந
વલ્લભ	வல்லப
વશીતા	வஶீதா
વસંતા	வஸஂதா
વસતીન	வஸதீந
વસવી	வஸவீ
વસુલ	வஸுல
વાક્પતિ	வாக்பதி
વાચસ્પતિ	வாசஸ்பதி
વાચ્ય	வாச்ய
વાજ્રહાસ્તા	வாஜ்ரஹாஸ்தா
વાનામાલી	வாநாமாலீ
વાનાવારાયણ	வாநாவாராயண
વાનૈપકા-વેરીન્દોન	வாநைபகா-வேரீந்தோந
વામન	வாமந
વામાંનીએ	வாமாஂநீஏ
વાર	வார
વાલકય	வாலகய
વાલી	வாலீ
વાસંતાપ્રભા	வாஸஂதாப்ரபா
વાસુકી	வாஸுகீ
વાસુમાંથા	வாஸுமாஂதா
વિઅર	விஅர
વિકાસીની	விகாஸீநீ
વિકાસ્ની	விகாஸ்நீ
વિક્ષિત	விக்ஷித
વિદ્વાથ	வித்வாத
વિધિ	விதி
વિનતા	விநதா
વિબુષા	விபுஷா
વિભાવા	விபாவா
વિમલા	விமலா
વિરબાહુ	விரபாஹு
વિલાસિની	விலாஸிநீ
વીક્ષા	வீக்ஷா
વીચિકા	வீசிகா
વીજીલા	வீஜீலா
વીની	வீநீ
વીમા	வீமா
વીરોત્તમ	வீரோத்தம
વેક્રાંત	வேக்ராஂத
વેગવાહીની	வேகவாஹீநீ
વેણુગોપાલ	வேணுகோபால
વેત્રિવાલ	வேத்ரிவால
વેદાંશી	வேதாஂஶீ
વેદાત્મન	வேதாத்மந
વેદાત્મને	வேதாத்மநே
વેદાર્થ	வேதார்த
વેદીષ	வேதீஷ
વેધા	வேதா
વેધાસ	வேதாஸ
વેધીકા	வேதீகா
વેનાહ	வேநாஹ
વેનીધર	வேநீதர
વેન્કાત્શીવા	வேந்காத்ஶீவா
વેન્નેલા	வேந்நேலா
વેલુ	வேலு
વેવેશા	வேவேஶா
વૈજનાથ	வைஜநாத
વૈદાહી	வைதாஹீ
વૈદ્યનાથ	வைத்யநாத
વૈધે	வைதே
વૈનાવિન	வைநாவிந
વૈશાકા	வைஶாகா
વૈશાખી	வைஶாகீ
વૈશાલી	வைஶாலீ
વૈશ્વિક	வைஶ்விக
વૈષ્ણવી	வைஷ்ணவீ
વૈસાખી	வைஸாகீ
સંચાલી	ஸஂசாலீ
સંજય	ஸஂஜய
સંજીથા	ஸஂஜீதா
સંજુકતા	ஸஂஜுகதா
સંતવાના	ஸஂதவாநா
સંદીતી	ஸஂதீதீ
સંદીપન	ஸஂதீபந
સંભાવના	ஸஂபாவநா
સંયક્તા	ஸஂயக்தா
સંવિકા	ஸஂவிகா
સંસ્કૃતિ	ஸஂஸ்க்ரிதி
સંસ્કૃતી	ஸஂஸ்க்ரிதீ
સકલ	ஸகல
સક્તીવેલ	ஸக்தீவேல
સક્શિક	ஸக்ஶிக
સક્શીન્યા	ஸக்ஶீந்யா
સક્ષમ	ஸக்ஷம
સચંદ્ર	ஸசஂத்ர
સજૂ	ஸஜூ
સદગુરૂ	ஸதகுரூ
સદબિંદુ	ஸதபிஂது
સદરુ	ஸதரு
સદા શિવમ	ஸதா ஶிவம
સદાશિવ	ஸதாஶிவ
સદિવા	ஸதிவா
સદ્વિખા	ஸத்விகா
સનવ	ஸநவ
સનીલ	ஸநீல
સનેશ	ஸநேஶ
સનૈતા	ஸநைதா
સપર્ણા	ஸபர்ணா
સપુષ્પા	ஸபுஷ்பா
સપ્તોર્શી	ஸப்தோர்ஶீ
સબરીનાથાન	ஸபரீநாதாந
સભ્રાંત	ஸப்ராஂத
સમન્યુ	ஸமந்யு
સમબરણ	ஸமபரண
સમભ્દ્ધા	ஸமப்த்தா
સમય	ஸமய
સમરવીર	ஸமரவீர
સમાંર્ધ	ஸமாஂர்த
સમાધાન	ஸமாதாந
સમિયા	ஸமியா
સમીક્ક્સા	ஸமீக்க்ஸா
સમીક્ષા	ஸமீக்ஷா
સમ્બુદ્ધા	ஸம்புத்தா
સમ્યનાતન	ஸம்யநாதந
સમ્રીધ	ஸம்ரீத
સમ્હીઠા	ஸம்ஹீடா
સરલા	ஸரலா
સર્જના	ஸர்ஜநா
સહલાદ	ஸஹலாத
સહસ્ત્રજિત	ஸஹஸ்த்ரஜித
સહસ્વીની	ஸஹஸ்வீநீ
સહુરી	ஸஹுரீ
સહૃદય	ஸஹ்ரிதய
સહેજ	ஸஹேஜ
સહોજ	ஸஹோஜ
સહ્ય	ஸஹ்ய
સાંદીપની	ஸாஂதீபநீ
સાઈ અમર્ત્ય	ஸாஈ அமர்த்ய
સાઈ કાર્તિક	ஸாஈ கார்திக
સાઈ દાસ	ஸாஈ தாஸ
સાઈ સુરિયા	ஸாஈ ஸுரியா
સાતેજ	ஸாதேஜ
સાદ્રીશી	ஸாத்ரீஶீ
સાધકા	ஸாதகா
સાધન	ஸாதந
સાનંદના	ஸாநஂதநா
સાનવી તારીતા	ஸாநவீ தாரீதா
સાનાવી	ஸாநாவீ
સાન્વી	ஸாந்வீ
સાફલ્ય	ஸாபல்ய
સાબી	ஸாபீ
સામલી	ஸாமலீ
સામાન	ஸாமாந
સારંગી	ஸாரஂகீ
સારસ	ஸாரஸ
સારાવતી	ஸாராவதீ
સાલીની	ஸாலீநீ
સાહસ્રપાત	ஸாஹஸ்ரபாத
સાહુલ	ஸாஹுல
સેન્ડી	ஸேந்டீ
સૈનિ	ஸைநி
સૈનું	ஸைநுஂ
સૈય્યન	ஸைய்யந
સૈલેન્દ્ર	ஸைலேந்த்ர
સૈશા	ஸைஶா
હંસરાજ	ஹஂஸராஜ
હંસાવાથ્ય	ஹஂஸாவாத்ய
હંસિન	ஹஂஸிந
હંસીની	ஹஂஸீநீ
હઝેલ	ஹசேல
હનસીકા	ஹநஸீகா
હનાર્વીન	ஹநார்வீந
હનુમાન	ஹநுமாந
હમૃથા	ஹம்ரிதா
હમ્સિની	ஹம்ஸிநீ
હરશું	ஹரஶுஂ
હરા	ஹரா
હરિઅક્સા	ஹரிஅக்ஸா
હરિકિશન	ஹரிகிஶந
હરિદા	ஹரிதா
હરિનાક્ષી	ஹரிநாக்ஷீ
હરિમંતી	ஹரிமஂதீ
હરી	ஹரீ
હરી કિશન	ஹரீ கிஶந
હરીકરણ	ஹரீகரண
હરીદર્પા	ஹரீதர்பா
હરીદાસાપ્રિયા	ஹரீதாஸாப்ரியா
હરીદીપ	ஹரீதீப
હરીધામ	ஹரீதாம
હરીવલ્લભ	ஹரீவல்லப
હરીશ્વ	ஹரீஶ்வ
હર્લીના	ஹர்லீநா
હર્શાશ્રી	ஹர்ஶாஶ்ரீ
હર્શિક	ஹர்ஶிக
હર્ષ વીર	ஹர்ஷ வீர
હર્ષિતા	ஹர்ஷிதா
હર્સ્વીતા	ஹர்ஸ்வீதா
હલેય	ஹலேய
હવીસા	ஹவீஸா
હશન	ஹஶந
હસીક	ஹஸீக
હસીથા	ஹஸீதா
હસ્મીથા	ஹஸ்மீதா
હાકેશ	ஹாகேஶ
હાનીકા	ஹாநீகா
હાર્શીની	ஹார்ஶீநீ
હાહન	ஹாஹந
હિડિંબા	ஹிடிஂபா
હિતાંશી	ஹிதாஂஶீ
હિતેક્ષા	ஹிதேக்ஷா
હિતેન્દ્ર	ஹிதேந்த்ர
હિનલ	ஹிநல
હિનેશ	ஹிநேஶ
હિમાકાર	ஹிமாகார
હિમાઘ્ના	ஹிமாக்நா
હિમાલ	ஹிமால
હિશા	ஹிஶா
હિશેતા	ஹிஶேதா
હીમીર	ஹீமீர
હીરકની	ஹீரகநீ
હીરાન્યાપ્પા	ஹீராந்யாப்பா
હીર્નાક્ષી	ஹீர்நாக்ஷீ
હીલ્લેય	ஹீல்லேய
હુમીશા	ஹுமீஶா
હુમૈલા	ஹுமைலா
હેઇઅન	ஹேஇஅந
હેત	ஹேத
હેતની	ஹேதநீ
હેતવ	ஹேதவ
હેત્વિક	ஹேத்விக
હેમંત	ஹேமஂத
હેમદેવ	ஹேமதேவ
હેમલતા	ஹேமலதா
હેમા	ஹேமா
હેમાઁગી	ஹேமாஂகீ
હેમાંગા	ஹேமாஂகா
હેમાકેશ	ஹேமாகேஶ
હેમાલા	ஹேமாலா
હેમાલી	ஹேமாலீ
હેમાવતી	ஹேமாவதீ
હેમીતા	ஹேமீதா
હેયન	ஹேயந
હેશીકા	ஹேஶீகா
હોનહાર	ஹோநஹார
હ્રિથિક	ஹ்ரிதிக
હ્રીત્વિકા	ஹ்ரீத்விகா
હ્રીદાન	ஹ்ரீதாந
હ્રીવાન	ஹ்ரீவாந
હ્રીશાંત	ஹ்ரீஶாஂத
હ્રીશાબ	ஹ்ரீஶாப
હ્રીશુલ	ஹ்ரீஶுல
હ્રુધાઈ	ஹ்ருதாஈ
#
#
# Territory names from CLDR
એસેન્શન આઇલેન્ડ	ஏஸேந்ஶந ஆஇலேந்ட
ઍંડોરા	ஏஂடோரா
યુનાઇટેડ આરબ અમીરાત	யுநாஇடேட ஆரப அமீராத
અફઘાનિસ્તાન	அபகாநிஸ்தாந
એન્ટીગુઆ અને બર્મુડા	ஏந்டீகுஆ அநே பர்முடா
ઍંગ્વિલા	ஏஂக்விலா
અલ્બેનિયા	அல்பேநியா
આર્મેનિયા	ஆர்மேநியா
અંગોલા	அஂகோலா
એન્ટાર્કટિકા	ஏந்டார்கடிகா
આર્જેન્ટીના	ஆர்ஜேந்டீநா
અમેરીકન સમોઆ	அமேரீகந ஸமோஆ
ઑસ્ટ્રિયા	ஒஸ்ட்ரியா
ઑસ્ટ્રેલિયા	ஒஸ்ட்ரேலியா
અરુબા	அருபா
એલેંડ ટાપુઓ	ஏலேஂட டாபுஓ
અઝરબૈજાન	அசரபைஜாந
બોસ્નિયા અને હર્ઝેગોવિના	போஸ்நியா அநே ஹர்சேகோவிநா
બાર્બાડોસ	பார்பாடோஸ
બાંગ્લાદેશ	பாஂக்லாதேஶ
બેલ્જીયમ	பேல்ஜீயம
બુર્કિના ફાસો	புர்கிநா பாஸோ
બલ્ગેરિયા	பல்கேரியா
બેહરીન	பேஹரீந
બુરુંડી	புருஂடீ
બેનિન	பேநிந
સેન્ટ બાર્થેલેમી	ஸேந்ட பார்தேலேமீ
બર્મુડા	பர்முடா
બ્રુનેઇ	ப்ருநேஇ
બોલિવિયા	போலிவியா
કેરેબિયન નેધરલેન્ડ્ઝ	கேரேபியந நேதரலேந்ட்ச
બ્રાઝિલ	ப்ராசில
બહામાસ	பஹாமாஸ
ભૂટાન	பூடாந
બૌવેત આઇલેન્ડ	பௌவேத ஆஇலேந்ட
બોત્સ્વાના	போத்ஸ்வாநா
બેલારુસ	பேலாருஸ
બેલીઝ	பேலீச
કેનેડા	கேநேடா
કોકોઝ (કીલીંગ) આઇલેન્ડ્સ	கோகோச (கீலீஂக) ஆஇலேந்ட்ஸ
કોંગો - કિંશાસા	கோஂகோ - கிஂஶாஸா
કોંગો (ડીઆરસી)	கோஂகோ (டீஆரஸீ)
સેન્ટ્રલ આફ્રિકન રીપબ્લિક	ஸேந்ட்ரல ஆப்ரிகந ரீபப்லிக
કોંગો - બ્રાઝાવિલે	கோஂகோ - ப்ராசாவிலே
કોંગો (પ્રજાસત્તાક)	கோஂகோ (ப்ரஜாஸத்தாக)
સ્વિટ્ઝર્લૅન્ડ	ஸ்விட்சர்லாந்ட
કોટ ડી આઇવરી	கோட டீ ஆஇவரீ
આઇવરી કોસ્ટ	ஆஇவரீ கோஸ்ட
કુક આઇલેન્ડ્સ	குக ஆஇலேந்ட்ஸ
ચિલી	சிலீ
કૅમરૂન	காமரூந
ચીન	சீந
કોલમ્બિયા	கோலம்பியா
ક્લિપરટન આઇલેન્ડ	க்லிபரடந ஆஇலேந்ட
કોસ્ટા રિકા	கோஸ்டா ரிகா
ક્યુબા	க்யுபா
કૅપ વર્ડે	காப வர்டே
કુરાકાઓ	குராகாஓ
ક્રિસમસ આઇલેન્ડ	க்ரிஸமஸ ஆஇலேந்ட
સાયપ્રસ	ஸாயப்ரஸ
ચેક રીપબ્લિક	சேக ரீபப்லிக
જર્મની	ஜர்மநீ
ડિએગો ગારસિઆ	டிஏகோ காரஸிஆ
જીબૌટી	ஜீபௌடீ
ડેનમાર્ક	டேநமார்க
ડોમિનિકા	டோமிநிகா
ડોમિનિકન રીપબ્લિક	டோமிநிகந ரீபப்லிக
અલ્જીરિયા	அல்ஜீரியா
સ્યુટા અને મેલિલા	ஸ்யுடா அநே மேலிலா
એક્વાડોર	ஏக்வாடோர
એસ્ટોનિયા	ஏஸ்டோநியா
ઇજિપ્ત	இஜிப்த
પશ્ચિમી સહારા	பஶ்சிமீ ஸஹாரா
એરિટ્રિયા	ஏரிட்ரியா
સ્પેન	ஸ்பேந
ઇથિઓપિયા	இதிஓபியா
યુરોપિયન સંઘ	யுரோபியந ஸஂக
ફિનલેન્ડ	பிநலேந்ட
ફીજી	பீஜீ
ફૉકલેન્ડ ટાપુઓ	பாகலேந்ட டாபுஓ
ફૉકલેન્ડ ટાપુઓ (ઇસ્લાસ માલવિનસ)	பாகலேந்ட டாபுஓ (இஸ்லாஸ மாலவிநஸ)
માઇક્રોનેશિયા	மாஇக்ரோநேஶியா
ફૅરો ટાપુઓ	பாரோ டாபுஓ
ફ્રાંસ	ப்ராஂஸ
ગેબન	கேபந
યુનાઇટેડ કિંગડમ	யுநாஇடேட கிஂகடம
ગ્રેનેડા	க்ரேநேடா
જ્યોર્જીયા	ஜ்யோர்ஜீயா
ફ્રેંચ ગયાના	ப்ரேஂச கயாநா
ગ્વેર્નસે	க்வேர்நஸே
ઘાના	காநா
જીબ્રાલ્ટર	ஜீப்ரால்டர
ગ્રીનલેન્ડ	க்ரீநலேந்ட
ગેમ્બિયા	கேம்பியா
ગિની	கிநீ
ગ્વાડેલોપ	க்வாடேலோப
ઇક્વેટોરિયલ ગિની	இக்வேடோரியல கிநீ
ગ્રીસ	க்ரீஸ
દક્ષિણ જ્યોર્જીયા અને દક્ષિણ સેન્ડવિચ આઇલેન્ડ્સ	தக்ஷிண ஜ்யோர்ஜீயா அநே தக்ஷிண ஸேந்டவிச ஆஇலேந்ட்ஸ
ગ્વાટેમાલા	க்வாடேமாலா
ગ્વામ	க்வாம
ગિની-બિસાઉ	கிநீ-பிஸாஉ
ગયાના	கயாநா
હોંગકોંગ SAR ચીન	ஹோஂககோஂக SAR சீந
હોંગ કોંગ	ஹோஂக கோஂக
હર્ડ અને મેકડોનાલ્ડ આઇલેન્ડ્સ	ஹர்ட அநே மேகடோநால்ட ஆஇலேந்ட்ஸ
હોન્ડુરસ	ஹோந்டுரஸ
ક્રોએશિયા	க்ரோஏஶியா
હૈતિ	ஹைதி
હંગેરી	ஹஂகேரீ
કૅનેરી ટાપુઓ	காநேரீ டாபுஓ
ઇન્ડોનેશિયા	இந்டோநேஶியா
આયર્લેન્ડ	ஆயர்லேந்ட
ઇઝરાઇલ	இசராஇல
આઈલ ઓફ મૅન	ஆஈல ஓப மாந
ભારત	பாரத
બ્રિટિશ ઇન્ડિયન ઓશન ટેરિટરી	ப்ரிடிஶ இந்டியந ஓஶந டேரிடரீ
ઇરાક	இராக
ઈરાન	ஈராந
આઇસલેન્ડ	ஆஇஸலேந்ட
ઇટાલી	இடாலீ
જર્સી	ஜர்ஸீ
જમૈકા	ஜமைகா
જોર્ડન	ஜோர்டந
જાપાન	ஜாபாந
કેન્યા	கேந்யா
કિર્ગિઝ્સ્તાન	கிர்கிச்ஸ்தாந
કંબોડિયા	கஂபோடியா
કિરિબાટી	கிரிபாடீ
કોમોરસ	கோமோரஸ
સેન્ટ કિટ્સ અને નેવિસ	ஸேந்ட கிட்ஸ அநே நேவிஸ
ઉત્તર કોરિયા	உத்தர கோரியா
દક્ષિણ કોરિયા	தக்ஷிண கோரியா
કુવૈત	குவைத
કેમેન ટાપુઓ	கேமேந டாபுஓ
કઝાકિસ્તાન	கசாகிஸ்தாந
લાઓસ	லாஓஸ
લેબનોન	லேபநோந
સેન્ટ લુસિયા	ஸேந்ட லுஸியா
લૈચટેંસ્ટેઇન	லைசடேஂஸ்டேஇந
શ્રીલંકા	ஶ்ரீலஂகா
લાઇબેરિયા	லாஇபேரியா
લેસોથો	லேஸோதோ
લિથુઆનિયા	லிதுஆநியா
લક્ઝમબર્ગ	லக்சமபர்க
લાત્વિયા	லாத்வியா
લિબિયા	லிபியா
મોરોક્કો	மோரோக்கோ
મોનાકો	மோநாகோ
મોલડોવા	மோலடோவா
મૉન્ટેંનેગ્રો	மாந்டேஂநேக்ரோ
સેન્ટ માર્ટિન	ஸேந்ட மார்டிந
મેડાગાસ્કર	மேடாகாஸ்கர
માર્શલ આઇલેન્ડ્સ	மார்ஶல ஆஇலேந்ட்ஸ
મેસેડોનિયા	மேஸேடோநியா
મેસેડોનિયા (FYROM)	மேஸேடோநியா (FYROM)
માલી	மாலீ
મ્યાંમાર (બર્મા)	ம்யாஂமார (பர்மா)
મંગોલિયા	மஂகோலியா
મકાઉ SAR ચીન	மகாஉ SAR சீந
મકાઉ	மகாஉ
ઉત્તરીય મારિયાના આઇલેન્ડ્સ	உத்தரீய மாரியாநா ஆஇலேந்ட்ஸ
માર્ટીનીક	மார்டீநீக
મૌરિટાનિયા	மௌரிடாநியா
મોંટસેરાત	மோஂடஸேராத
માલ્ટા	மால்டா
મોરિશિયસ	மோரிஶியஸ
માલદિવ્સ	மாலதிவ்ஸ
માલાવી	மாலாவீ
મેક્સિકો	மேக்ஸிகோ
મલેશિયા	மலேஶியா
મોઝામ્બિક	மோசாம்பிக
નામિબિયા	நாமிபியா
ન્યુ સેલેડોનિયા	ந்யு ஸேலேடோநியா
નાઇજર	நாஇஜர
નોરફૉક ટાપુ	நோரபாக டாபு
નાઇજીરીયા	நாஇஜீரீயா
નિકારાગુઆ	நிகாராகுஆ
નેધરલેન્ડ	நேதரலேந்ட
નૉર્વે	நார்வே
નેપાળ	நேபாள
નૌરુ	நௌரு
નીયુ	நீயு
ન્યુઝીલેન્ડ	ந்யுசீலேந்ட
ઓમાન	ஓமாந
પનામા	பநாமா
પેરુ	பேரு
ફ્રેંચ પોલિનેશિયા	ப்ரேஂச போலிநேஶியா
પાપુઆ ન્યૂ ગિની	பாபுஆ ந்யூ கிநீ
ફિલીપાઇન્સ	பிலீபாஇந்ஸ
પાકિસ્તાન	பாகிஸ்தாந
પોલેંડ	போலேஂட
સેન્ટ પિયર અને મીક્વેલન	ஸேந்ட பியர அநே மீக்வேலந
પીટકૈર્ન આઇલેન્ડ્સ	பீடகைர்ந ஆஇலேந்ட்ஸ
પ્યુઅર્ટો રિકો	ப்யுஅர்டோ ரிகோ
પેલેસ્ટિનિયન ટેરિટરી	பேலேஸ்டிநியந டேரிடரீ
પેલેસ્ટાઇન	பேலேஸ்டாஇந
પોર્ટુગલ	போர்டுகல
પલાઉ	பலாஉ
પેરાગ્વે	பேராக்வே
કતાર	கதார
આઉટલાઈન્ગ ઓશનિયા	ஆஉடலாஈந்க ஓஶநியா
રીયુનિયન	ரீயுநியந
રોમાનિયા	ரோமாநியா
સર્બિયા	ஸர்பியா
રશિયા	ரஶியா
રવાંડા	ரவாஂடா
સાઉદી અરેબિયા	ஸாஉதீ அரேபியா
સોલોમન આઇલેન્ડ્સ	ஸோலோமந ஆஇலேந்ட்ஸ
સેશેલ્સ	ஸேஶேல்ஸ
સુદાન	ஸுதாந
સ્વીડન	ஸ்வீடந
સિંગાપુર	ஸிஂகாபுர
સેન્ટ હેલેના	ஸேந்ட ஹேலேநா
સ્લોવેનિયા	ஸ்லோவேநியா
સ્વાલબર્ડ અને જેન મેયન	ஸ்வாலபர்ட அநே ஜேந மேயந
સ્લોવેકિયા	ஸ்லோவேகியா
સીએરા લેઓન	ஸீஏரா லேஓந
સૅન મેરિનો	ஸாந மேரிநோ
સેનેગલ	ஸேநேகல
સોમાલિયા	ஸோமாலியா
સુરીનામ	ஸுரீநாம
દક્ષિણ સુદાન	தக்ஷிண ஸுதாந
સાઓ ટૉમ અને પ્રિંસિપે	ஸாஓ டாம அநே ப்ரிஂஸிபே
એલ સેલ્વાડોર	ஏல ஸேல்வாடோர
સિંટ માર્ટેન	ஸிஂட மார்டேந
સીરિયા	ஸீரியா
સ્વાઝિલેન્ડ	ஸ்வாசிலேந்ட
ત્રિસ્તાન દા કુન્હા	த்ரிஸ்தாந தா குந்ஹா
તુર્ક્સ અને કાઇકોસ ટાપુઓ	துர்க்ஸ அநே காஇகோஸ டாபுஓ
ચાડ	சாட
ફ્રેંચ સદર્ન ટેરિટરીઝ	ப்ரேஂச ஸதர்ந டேரிடரீச
ટોગો	டோகோ
થાઇલેંડ	தாஇலேஂட
તાજીકિસ્તાન	தாஜீகிஸ்தாந
ટોકેલાઉ	டோகேலாஉ
તિમોર-લેસ્તે	திமோர-லேஸ்தே
પૂર્વ તિમોર	பூர்வ திமோர
તુર્કમેનિસ્તાન	துர்கமேநிஸ்தாந
ટ્યુનિશિયા	ட்யுநிஶியா
ટોંગા	டோஂகா
તુર્કી	துர்கீ
ટ્રિનીદાદ અને ટોબેગો	ட்ரிநீதாத அநே டோபேகோ
તુવાલુ	துவாலு
તાઇવાન	தாஇவாந
તાંઝાનિયા	தாஂசாநியா
યુક્રેન	யுக்ரேந
યુગાંડા	யுகாஂடா
સંયુક્ત રાજ્ય આઉટલાઇંગ આયલેન્ડ્સ	ஸஂயுக்த ராஜ்ய ஆஉடலாஇஂக ஆயலேந்ட்ஸ
સંયુકત રાજ્ય અમેરિકા	ஸஂயுகத ராஜ்ய அமேரிகா
ઉરુગ્વે	உருக்வே
ઉઝ્બેકિસ્તાન	உச்பேகிஸ்தாந
વેટિકન સિટી	வேடிகந ஸிடீ
સેન્ટ વિન્સેટ અને ગ્રેનેડીન્સ	ஸேந்ட விந்ஸேட அநே க்ரேநேடீந்ஸ
વેનેઝુએલા	வேநேசுஏலா
બ્રિટિશ વર્જિન ટાપુઓ	ப்ரிடிஶ வர்ஜிந டாபுஓ
વિયેતનામ	வியேதநாம
વાનુઆતુ	வாநுஆது
વેલીસ અને ફ્યુટુના	வேலீஸ அநே ப்யுடுநா
સમોઆ	ஸமோஆ
કોસોવો	கோஸோவோ
યેમેન	யேமேந
મેયોટ	மேயோட
દક્ષિણ આફ્રિકા	தக்ஷிண ஆப்ரிகா
ઝામ્બિયા	சாம்பியா
ઝિમ્બાબ્વે	சிம்பாப்வே
અજ્ઞાત પ્રદેશ	அஜ்ஞாத ப்ரதேஶ
