# Baby names
ଅକର୍ଯସୁଟ	অকর্যসুট
ଅଚଲା	অচলা
ଅଚିଟ୍	অচিট্
ଅଦିତା	অদিতা
ଅଦ୍ବୈଯା	অদ্বৈযা
ଅଫ୍ର	অফ্র
ଅବିଶ	অবিশ
ଅବ୍ଭିନବ୍	অব্ভিনব্
ଅଭିନତ	অভিনত
ଅଭିନିତି	অভিনিতি
ଅଭିପ୍ରିତି	অভিপ্রিতি
ଅଭିମନି	অভিমনি
ଅଭିରତି	অভিরতি
ଅଭିସର୍	অভিসর্
ଆଅଶ୍ନା	আঅশ্না
ଆଇଶ୍	আইশ্
ଆଗନେଯ	আগনেয
ଆଗନେୟା	আগনেয়া
ଆଘନ୍ୟା	আঘন্য়া
ଆଟିଶ୍	আটিশ্
ଆଡିତ୍	আডিত্
ଆଡ୍ରିଟି	আড্রিটি
ଆତ୍ମିକ	আত্মিক
ଆଦବିକା	আদবিকা
ଆଦିନାଥ୍	আদিনাথ্
ଆଧାବ୍	আধাব্
ଆନଗଟ୍	আনগট্
ଆନନ୍ଦସ୍ବରୁପ୍	আনন্দস্বরুপ্
ଆନଶଲ୍	আনশল্
ଆନାଲ୍	আনাল্
ଆପଟ୍	আপট্
ଆମୁକଥା	আমুকথা
ଆଯୁ	আযু
ଆରଣା	আরণা
ଆରଥ୍	আরথ্
ଆରବ୍	আরব্
ଆରଭି	আরভি
ଆରିଟ୍	আরিট্
ଆରୁନା	আরুনা
ଆରୁଶା	আরুশা
ଆର୍ଥୀ	আর্থী
ଆର୍ନବ୍	আর্নব্
ଆରୟାନ୍	আরয়ান্
ଆରୟାମନ୍	আরয়ামন্
ଆଲିୟଃ	আলিয়ঃ
ଆଶାଲତା	আশালতা
ଆସ୍ତ	আস্ত
ଆସ୍ମି	আস্মি
ଇକ୍ଶିତା	ইক্শিতা
ଇଟନ୍	ইটন্
ଇଡିକା	ইডিকা
ଇନକନ୍ଟା	ইনকন্টা
ଇନିଯବନ୍	ইনিযবন্
ଇନେଶ୍	ইনেশ্
ଇନ୍ଡରେଶ୍	ইন্ডরেশ্
ଇନ୍ଡୁକାନ୍ଟ୍	ইন্ডুকান্ট্
ଇନ୍ଡୁଜ୍	ইন্ডুজ্
ଇନ୍ଡ୍ରଯନି	ইন্ড্রযনি
ଇପ୍ସିଟା	ইপ্সিটা
ଇବାନ୍କା	ইবান্কা
ଇଭ୍ଯା	ইভ্যা
ଇମ୍ପାଲ୍	ইম্পাল্
ଇମ୍ଲା	ইম্লা
ଇରାନା	ইরানা
ଇରେନ୍ପ୍ରୀଟ୍	ইরেন্প্রীট্
ଇଲବେନିଲ୍	ইলবেনিল্
ଇଲିଶା	ইলিশা
ଇଶା କ୍ରିଟିକ୍	ইশা ক্রিটিক্
ଇଶି	ইশি
ଇଶିର୍	ইশির্
ଇସାଇଅରାସୁ	ইসাইঅরাসু
ଇସ୍ଶୁ	ইস্শু
ଇହା	ইহা
ଇହାମ୍	ইহাম্
ଈଶାନି	ঈশানি
ଉଜାଲା	উজালা
ଉଜ୍ଜାନିନି	উজ্জানিনি
ଉଟନ୍କା	উটন্কা
ଉଟ୍କର୍ଶା	উট্কর্শা
ଉଡାନ୍ଟିକା	উডান্টিকা
ଉଡିଶା	উডিশা
ଉଡେଯ୍	উডেয্
ଉଡ୍ଡିଶ୍	উড্ডিশ্
ଉଡ୍ଯମ୍	উড্যম্
ଉତାମି	উতামি
ଉତିରା	উতিরা
ଉନ୍ନତିଶ୍	উন্নতিশ্
ଉନ୍ନଭ୍	উন্নভ্
ଉନ୍ନିକ୍ରିଶ୍ନନ୍	উন্নিক্রিশ্নন্
ଉନ୍ମାଇବିଲମ୍ବି	উন্মাইবিলম্বি
ଉପାନ୍ଶୁ	উপান্শু
ଉପେନ୍ଡ୍ରା	উপেন্ড্রা
ଉପ୍ଜୀତ୍	উপ্জীত্
ଉପ୍ମା	উপ্মা
ଉମା	উমা
ଉର୍ବଶି	উর্বশি
ଉର୍ବଶୀ	উর্বশী
ଉର୍ବିଶ୍	উর্বিশ্
ଉଶା ଲକ୍ଶି	উশা লক্শি
ଉଶ୍ନିସିନ୍	উশ্নিসিন্
ଉସ୍ରି	উস্রি
ଊର୍ଜିଟ୍	ঊর্জিট্
ଏଇରାବଟି	এইরাবটি
ଏକଚକ୍ରା	একচক্রা
ଏକଚନ୍ଡ୍ର	একচন্ড্র
ଏକଚିତ୍	একচিত্
ଏକବିରା	একবিরা
ଏକଲିଙା	একলিঙা
ଏକ୍ଟା	এক্টা
ଏକ୍ଲବ୍ଯ	এক্লব্য
ଏଗୈଅରସୁ	এগৈঅরসু
ଏଡୋମ୍	এডোম্
ଏଦସ୍	এদস্
ଏରା	এরা
ଏଲବେନ୍ଦନ୍	এলবেন্দন্
ଏଲିକା	এলিকা
ଏଲିଲ୍ବେନ୍ଡନ୍	এলিল্বেন্ডন্
ଏଶଞା	এশঞা
ଏଶନି	এশনি
ଏଶନ୍ଶ୍	এশন্শ্
ଏଶ୍ନି	এশ্নি
ଏଶ୍ମା	এশ্মা
ଓଜାସ୍ବୁଇଟା	ওজাস্বুইটা
ଓଜାସ୍ବୁଇନି	ওজাস্বুইনি
ଓବିଶ୍କର୍	ওবিশ্কর্
ଓମାନା	ওমানা
ଓମାର୍ଜୀଟ୍	ওমার্জীট্
ଓମ୍ଜା	ওম্জা
ଓମ୍ଡୁଟ୍ଟ୍	ওম্ডুট্ট্
କଟେଲ୍ଯ୍ନ୍	কটেল্য্ন্
କନକବଟି	কনকবটি
କନିସା	কনিসা
କନ୍ଡର୍ପା	কন্ডর্পা
କନ୍ନକି	কন্নকি
କନ୍ଶ୍	কন্শ্
କନ୍ହୈଯାଲାଲ୍	কন্হৈযালাল্
କପିଲେଶ୍	কপিলেশ্
କପୀଶ୍	কপীশ্
କପୀଶ୍ବୁଅର୍	কপীশ্বুঅর্
କବଲ୍	কবল্
କବିତା	কবিতা
କବିନଯା	কবিনযা
କମଲ୍ନଯନ୍	কমল্নযন্
କମେଶ୍ବୁଅର୍	কমেশ্বুঅর্
କମୋଡ୍	কমোড্
କଯଲ୍ବିଲି	কযল্বিলি
କରିଶ୍ମା	করিশ্মা
କରୁନାକର୍	করুনাকর্
କରୋନା	করোনা
କର୍ଟାର୍	কর্টার্
କର୍ତି	কর্তি
କର୍ତୀକ୍	কর্তীক্
କର୍ହିକ୍	কর্হিক্
କଲବତି	কলবতি
କଲୈଅରସି	কলৈঅরসি
କଲ୍ପା	কল্পা
କଲ୍ବା	কল্বা
କଶିଶ୍	কশিশ্
କଶ୍ମିରା	কশ্মিরা
କସିଶ୍	কসিশ্
କସ୍ନି	কস্নি
କସ୍ସମଲି	কস্সমলি
କହର୍	কহর্
କହ୍ଲିମା	কহ্লিমা
କାକଲି	কাকলি
କାକୋଲି	কাকোলি
କାକ୍ଶା	কাক্শা
କାଜୋଲ୍	কাজোল্
କାଡନ୍ମ୍ବରି	কাডন্ম্বরি
କାନ୍ଟି	কান্টি
କାଲିକା	কালিকা
କାଲିଚରନ୍	কালিচরন্
କାଲିନ୍ଡି	কালিন্ডি
କାଲିଯା	কালিযা
କାଲିରନ୍ଜନ୍	কালিরন্জন্
କୈରବ୍	কৈরব্
କୈଲାସ୍	কৈলাস্
କୌଶିକା	কৌশিকা
କୌଶ୍ଲେନ୍ଡେର୍	কৌশ্লেন্ডের্
ଗଙାଡଟ୍ଟ୍	গঙাডট্ট্
ଗଙେଶ୍	গঙেশ্
ଗଜନନ	গজনন
ଗଜାନନ୍ଡ୍	গজানন্ড্
ଗଜ୍ରୁପ୍	গজ্রুপ্
ଗନଦ୍ଯକ୍ଶିନା	গনদ্যক্শিনা
ଗନରାଜ୍	গনরাজ্
ଗମ୍ଭିର୍	গম্ভির্
ଗରିଶିଟ୍	গরিশিট্
ଗରିଶ୍ଟ୍	গরিশ্ট্
ଗରୁଡ୍	গরুড্
ଗାର୍ଗୀ	গার্গী
ଗିଟାନ୍ଜଲି	গিটান্জলি
ଗିଟିକା	গিটিকা
ଗିବ୍ସୋନ୍	গিব্সোন্
ଗିରିଜନନ୍ଡନ୍	গিরিজনন্ডন্
ଗିରିଶରନ୍	গিরিশরন্
ଗୀଟାନ୍ଜଲି	গীটান্জলি
ଗୀଟାସ୍ରି	গীটাস্রি
ଗୀତିକା	গীতিকা
ଗୁନସେକରନ୍	গুনসেকরন্
ଗୁନିତା	গুনিতা
ଗୁଫାମ୍	গুফাম্
ଗୁରୁ	গুরু
ଗୁରୁ ଗୁଗନ୍	গুরু গুগন্
ଗୁରୁସାରନ୍	গুরুসারন্
ଗେଯା	গেযা
ଗୋଉରଙି	গোউরঙি
ଗୋଟମ୍	গোটম্
ଗୋଡବରି	গোডবরি
ଗୋପାଲ୍	গোপাল্
ଗୋପିନାତନ୍	গোপিনাতন্
ଗୋପୁ	গোপু
ଗୋବିଲ୍	গোবিল্
ଗୋରଖ୍	গোরখ্
ଗୋଲୋଚନ୍	গোলোচন্
ଗୌରଂଗୀ	গৌরংগী
ଗ୍ନନଲିଆ	গ্ননলিআ
ଗ୍ଯାନା	গ্যানা
ଗ୍ରହିଲ୍	গ্রহিল্
ଗ୍ରିତେଶ୍	গ্রিতেশ্
ଘନମଲିକା	ঘনমলিকা
ଘନଲିଙା	ঘনলিঙা
ଘୁଲିକା	ঘুলিকা
ଚଟୁର୍ଭୁଜା	চটুর্ভুজা
ଚଟୁର୍ଭୁଜ୍	চটুর্ভুজ্
ଚନ୍ଚଲା	চন্চলা
ଚନ୍ଡା ବର୍ମନ୍	চন্ডা বর্মন্
ଚନ୍ଡେର୍	চন্ডের্
ଚନ୍ଡ୍ରକାନ୍ଟା	চন্ড্রকান্টা
ଚନ୍ଡ୍ରକିର୍ତି	চন্ড্রকির্তি
ଚନ୍ଡ୍ରଡିଟ୍ଯା	চন্ড্রডিট্যা
ଚନ୍ଡ୍ରନାତ୍	চন্ড্রনাত্
ଚନ୍ଡ୍ରପ୍ରକାଶ୍	চন্ড্রপ্রকাশ্
ଚନ୍ଡ୍ରବାତି	চন্ড্রবাতি
ଚନ୍ଡ୍ରମୋଉଲି	চন্ড্রমোউলি
ଚନ୍ଡ୍ରଲେଖା	চন্ড্রলেখা
ଚନ୍ଡ୍ରସହୋଡରି	চন্ড্রসহোডরি
ଚନ୍ଡ୍ରାକିରନ୍	চন্ড্রাকিরন্
ଚନ୍ଡ୍ରେଯୀ	চন্ড্রেযী
ଚନ୍ଡ୍ର୍ପୀଡ୍	চন্ড্র্পীড্
ଚମ୍ପା	চম্পা
ଚମ୍ପିକା	চম্পিকা
ଚରନ୍ଜୀଟ୍	চরন্জীট্
ଚରନ୍ଡେବ୍	চরন্ডেব্
ଚରିଟା	চরিটা
ଚରୁପ୍ରଭା	চরুপ্রভা
ଚରୁଲେଖା	চরুলেখা
ଚରୁଶିଲା	চরুশিলা
ଚାଯା	চাযা
ଚିଟ୍ରିଟା	চিট্রিটা
ଚିଡକଶ୍	চিডকশ্
ଚିଡାନନ୍ଡ୍	চিডানন্ড্
ଚିତ୍ରା	চিত্রা
ଚିନ୍କଲ୍	চিন্কল্
ଚିନ୍ଟନା	চিন্টনা
ଚିନ୍ଟନିକା	চিন্টনিকা
ଚିନ୍ଟଲ୍	চিন্টল্
ଚିନ୍ମଯୁ	চিন্মযু
ଚିରନ୍ଜିବ୍	চিরন্জিব্
ଚିରନ୍ଜୀବି	চিরন্জীবি
ଚିରୁ	চিরু
ଚୁଟ୍କି	চুট্কি
ଚେଟକ୍	চেটক্
ଚେନ୍ନା	চেন্না
ଚେମ୍ମଲ୍	চেম্মল্
ଚେରିତ୍	চেরিত্
ଚେଲନ୍	চেলন্
ଚେଲିଯନ୍	চেলিযন্
ଚେଲୁବା	চেলুবা
ଚୈଟ୍ରା	চৈট্রা
ଚୈନ୍	চৈন্
ଚୋଲାନ୍	চোলান্
ଚ୍ହଯାନ୍କ୍	চ্হযান্ক্
ଜଗଟି	জগটি
ଜଗଟ୍ଗୁରୁ	জগট্গুরু
ଜଗଡମ୍ବିକା	জগডম্বিকা
ଜଗଡ୍ବନ୍ଡୁ	জগড্বন্ডু
ଜଗନ୍ନାତନ୍	জগন্নাতন্
ଜଗନ୍ମଯୀ	জগন্মযী
ଜଗ୍ଜିବନ୍	জগ্জিবন্
ଜଗ୍ଜୀବନ୍	জগ্জীবন্
ଜନକିଭୁଶନ୍	জনকিভুশন্
ଜନଦର୍ନ୍	জনদর্ন্
ଜନାନି	জনানি
ଜନାର୍ଦନା	জনার্দনা
ଜମୁନା	জমুনা
ଜଯ ପ୍ରଟୀକ୍	জয প্রটীক্
ଜଯ ପ୍ରିଯା	জয প্রিযা
ଜଯପୋର୍ନା	জযপোর্না
ଜଯସ୍ରି	জযস্রি
ଜଯାନନ୍ଡ୍	জযানন্ড্
ଜଯ୍କିଶନ୍	জয্কিশন্
ଜଯ୍ସ୍ରୀ	জয্স্রী
ଜଲକ୍	জলক্
ଜଲନ୍ହିଲି	জলন্হিলি
ଜଲ୍ଦର୍	জল্দর্
ଜଶି	জশি
ଜଶୋଡା	জশোডা
ଜସମିଟ୍	জসমিট্
ଜସ୍ବୁଇତା	জস্বুইতা
ଜସ୍ମେର୍	জস্মের্
ଜାଗ୍ରୁଟି	জাগ্রুটি
ଜାନବି	জানবি
ଜାନ୍	জান্
ଜାନ୍ଜର୍	জান্জর্
ଜାବିଅନ୍	জাবিঅন্
ଜାବେଶ୍	জাবেশ্
ଜାହି	জাহি
ଜିଗନଶା	জিগনশা
ଜିଗ୍ଯାଶା	জিগ্যাশা
ଜିତ୍ଯା	জিত্যা
ଜିନ୍ସ୍ଯ୍	জিন্স্য্
ଜିବଟି	জিবটি
ଜିଯା ଉଶସ୍	জিযা উশস্
ଜିଶା	জিশা
ଜୀବିଟା	জীবিটা
ଜୀବ୍ନୀ	জীব্নী
ଜେନିଶା	জেনিশা
ଜେନ୍ସ୍ଯ୍	জেন্স্য্
ଜେଯରଟ୍ନମ୍	জেযরট্নম্
ଜେଲସ୍ମି	জেলস্মি
ଜେସ୍ରି	জেস্রি
ଜେହନ୍ନଜ୍	জেহন্নজ্
ଜୈଚନ୍ଡ୍ରନ୍	জৈচন্ড্রন্
ଜୈଟୈଶ୍	জৈটৈশ্
ଜୈଡଯାଲ୍	জৈডযাল্
ଜୈନନ୍ଡ୍	জৈনন্ড্
ଜୈନିଶ୍	জৈনিশ্
ଜୈନେଶ୍	জৈনেশ্
ଜୈବୀର୍	জৈবীর্
ଜୈବୁଅନ୍ଟ୍	জৈবুঅন্ট্
ଜୈମନ୍	জৈমন্
ଜୈଶନ୍କର୍	জৈশন্কর্
ଜୈସୁଦନ୍	জৈসুদন্
ଜୋଲ୍ଯ୍	জোল্য্
ଝିନୁକ୍	ঝিনুক্
ଝିଲ୍ମିଲ୍	ঝিল্মিল্
ଟିଟିର୍	টিটির্
ଟିଲୋଟ୍ଟମା	টিলোট্টমা
ଟିସ୍ଟା	টিস্টা
ଟେଜସ୍ବୁଇନ୍	টেজস্বুইন্
ଟୋଶନ୍	টোশন্
ଟ୍ରୈଲୋକ୍ବା	ট্রৈলোক্বা
ଡଦିଜା	ডদিজা
ଡବୀଟ୍	ডবীট্
ଡାନିଶ୍	ডানিশ্
ଣିଲାନ୍ଜନା	ণিলান্জনা
ତଙାଡୁରାଇ	তঙাডুরাই
ତଙାମନି	তঙামনি
ତଙାରାଜ୍	তঙারাজ্
ତତ୍ବ	তত্ব
ତନଯ୍ମୀ	তনয্মী
ତନିଆ	তনিআ
ତନିଗାଇ	তনিগাই
ତନିଶ୍କ	তনিশ্ক
ତନିଶ୍ତା	তনিশ্তা
ତନୁଜ୍	তনুজ্
ତନୋଜ୍	তনোজ্
ତନ୍ଶୁ	তন্শু
ତପସ୍ଯା	তপস্যা
ତବୁ	তবু
ତମୋଘ୍ନା	তমোঘ্না
ତରକାର୍ ସେର୍ରୋନ୍	তরকার্ সের্রোন্
ତରକ୍	তরক্
ତରଶ	তরশ
ତରାନିକା	তরানিকা
ତର୍ଜ୍ନି	তর্জ্নি
ତର୍ପନ୍	তর্পন্
ତର୍ଲି	তর্লি
ତର୍ଶିନି	তর্শিনি
ତଶ୍ବି	তশ্বি
ତହାନ୍	তহান্
ତାରା	তারা
ତିଇବ୍ଯେଶ୍	তিইব্যেশ্
ତିବ୍ଯାନ୍	তিব্যান্
ତିରୁଚନ୍ଡ୍ରା	তিরুচন্ড্রা
ତୀକ୍ଶିକ	তীক্শিক
ତୀନିଶ୍	তীনিশ্
ତୁମ୍କି	তুম্কি
ତେଜସ୍	তেজস্
ତେଜସ୍ବ୍ବିତ	তেজস্ব্বিত
ତେଜି	তেজি
ତେଜୋବିକସ୍	তেজোবিকস্
ତେଜ୍	তেজ্
ତେଶିନୀ	তেশিনী
ତୋମୋଗ୍ନା	তোমোগ্না
ତ୍ରିଲୂକାମନ୍	ত্রিলূকামন্
ତ୍ରିଲୋକ୍	ত্রিলোক্
ତ୍ରିଶ୍	ত্রিশ্
ତ୍ରେଶା	ত্রেশা
ଦକ୍ଶକ୍	দক্শক্
ଦକ୍ଶେଶ୍	দক্শেশ্
ଦଜ୍ଶି	দজ্শি
ଦଞଟା	দঞটা
ଦଞ୍ଟା	দঞ্টা
ଦଟ୍ଟଟ୍ରି	দট্টট্রি
ଦନନ୍ଜଯ୍	দনন্জয্
ଦନଶ୍ରି	দনশ্রি
ଦନିଏଲ୍	দনিএল্
ଦନିଶ୍ଟା	দনিশ্টা
ଦନିଶ୍ତା	দনিশ্তা
ଦନୁଶ୍	দনুশ্
ଦନୁଶ୍ରି	দনুশ্রি
ଦନେଶି	দনেশি
ଦନ୍ବି	দন্বি
ଦବିନ୍	দবিন্
ଦବୀନା	দবীনা
ଦଯନିଟା	দযনিটা
ଦଯମଯୀ	দযমযী
ଦଯରାମ୍	দযরাম্
ଦରହସି	দরহসি
ଦର୍ମେନ୍ଦର୍	দর্মেন্দর্
ଦର୍ରେନ୍	দর্রেন্
ଦସା	দসা
ଦାମିନି	দামিনি
ଦୀକ୍ଶି	দীক্শি
ଦୀନା	দীনা
ଦୀପକ୍ରାଜ୍	দীপক্রাজ্
ଦୀପଶ୍ରି	দীপশ্রি
ଦୀପେଶ୍	দীপেশ্
ଦୀପ୍ଟିକା	দীপ্টিকা
ଦୀପ୍ଟିମୋଯୀ	দীপ্টিমোযী
ଦୀପ୍ମାଲା	দীপ্মালা
ଦୀପ୍ଯୋଗ୍	দীপ্যোগ্
ଦୀଶ୍ନା	দীশ্না
ଦୀହେର୍	দীহের্
ଦେକ୍ଶିତ୍	দেক্শিত্
ଦେନିଶ୍	দেনিশ্
ଦେବ ପ୍ରିଯା	দেব প্রিযা
ଦେବର୍ପନା	দেবর্পনা
ଦେବାର୍ଟି	দেবার্টি
ଦେବିକ୍	দেবিক্
ଦେବିଡାସ୍	দেবিডাস্
ଦେବିଲାଲ୍	দেবিলাল্
ଦେବେନ୍	দেবেন্
ଦେବେନ୍ଡ୍ରନାତ୍	দেবেন্ড্রনাত্
ଦେବେନ୍ଡ୍ରଶିକା	দেবেন্ড্রশিকা
ଦେବେଶି	দেবেশি
ଦେବ୍ ନରେନ୍	দেব্ নরেন্
ଦେବ୍କି	দেব্কি
ଦେବ୍ଜନି	দেব্জনি
ଦେବ୍ଯଶି	দেব্যশি
ଦେଲୀନା	দেলীনা
ଦେଶ୍ନୀ	দেশ্নী
ଦେହଯ୍	দেহয্
ଦୈବି	দৈবি
ଦୈବିକ୍	দৈবিক্
ନକ୍ଶା	নক্শা
ନଖ୍ରାଜ୍	নখ্রাজ্
ନଗନାତ୍	নগনাত্
ନଗାନ୍ଜଲି	নগান্জলি
ନଗ୍ଗର୍	নগ্গর্
ନଗ୍ଦର୍	নগ্দর্
ନଙୈ	নঙৈ
ନଚ୍ନି	নচ্নি
ନଟ୍ରାଜ୍	নট্রাজ্
ନଡୀଶ୍	নডীশ্
ନନ୍ଡି	নন্ডি
ନବନୀତା	নবনীতা
ନବରାଜ୍	নবরাজ্
ନବରାନ୍ଜନି	নবরান্জনি
ନବିନା	নবিনা
ନବିନ୍ଡ୍	নবিন্ড্
ନବିଲ୍	নবিল্
ନବୁଅଲ୍	নবুঅল্
ନବେଶା	নবেশা
ନବ୍କର୍	নব্কর্
ନବ୍କିରନ୍	নব্কিরন্
ନବ୍କୁନ୍ଜ୍	নব্কুন্জ্
ନବ୍ଯା ଦୁର୍ଗା	নব্যা দুর্গা
ନଭଯନ୍	নভযন্
ନଭା	নভা
ନଭିଜ୍	নভিজ্
ନଭିତା	নভিতা
ନମି	নমি
ନମିଟା	নমিটা
ନମିଟ୍	নমিট্
ନମିତା	নমিতা
ନମିଶା	নমিশা
ନମ୍ଡେବ୍	নম্ডেব্
ନରସିମ୍ହା	নরসিম্হা
ନରେନ୍ଡ୍ରନ୍	নরেন্ড্রন্
ନର୍ମଡ୍	নর্মড্
ନର୍ରେଶ୍	নর্রেশ্
ନଲିନାକ୍ଶ୍	নলিনাক্শ্
ନାଇଟିକ୍	নাইটিক্
ନାଲନ୍	নালন্
ନାଲବେନ୍ଭା	নালবেন্ভা
ନିକ୍କି	নিক্কি
ନିଦି	নিদি
ନିଲମ୍ବରି	নিলম্বরি
ନୀଇଲ୍	নীইল্
ନୀଜା	নীজা
ନୀତୁ	নীতু
ନୀରାଜା	নীরাজা
ନୀଲବତି	নীলবতি
ନୀଲବ୍ଜା	নীলব্জা
ନୀଲମେଗନ୍	নীলমেগন্
ନୀଲଯା	নীলযা
ନୀଲୁ	নীলু
ନୀଲ୍	নীল্
ନୀଲ୍ମାଦବ୍	নীল্মাদব্
ନୀହା	নীহা
ନେଟ୍ରାବଟି	নেট্রাবটি
ନେଡୁମରନ୍	নেডুমরন্
ନେମି	নেমি
ନେର୍ଯା	নের্যা
ନେଲ୍ବିନ୍	নেল্বিন্
ନୈମିଶ୍	নৈমিশ্
ପଝନନ୍ଡାବର୍	পঝনন্ডাবর্
ପତଲା	পতলা
ପତୋଜ୍	পতোজ্
ପତ୍ରଲିକା	পত্রলিকা
ପଦାମବତି	পদামবতি
ପଦ୍ମଜା	পদ্মজা
ପଦ୍ମବସା	পদ্মবসা
ପଦ୍ମମଲଧର	পদ্মমলধর
ପଦ୍ମଯନି	পদ্মযনি
ପଦ୍ମାଗ୍ରିହ	পদ্মাগ্রিহ
ପଦ୍ମାମୁଖୀ	পদ্মামুখী
ପଦ୍ମୋଡ୍ଭବ	পদ্মোড্ভব
ପଦ୍ମ୍	পদ্ম্
ପନିଟା	পনিটা
ପନ୍କଜା	পন্কজা
ପନ୍ଖୁଡି	পন্খুডি
ପନ୍ଖୁରି	পন্খুরি
ପନ୍ଚଜନା	পন্চজনা
ପନ୍ଚାବକ୍ଟ୍ରା	পন্চাবক্ট্রা
ପନ୍ଡୁ	পন্ডু
ପନ୍ନାଲାଲ୍	পন্নালাল্
ପବନ୍ କୁମାର୍	পবন্ কুমার্
ପବିକରାନ୍	পবিকরান্
ପବେଶ୍	পবেশ্
ପବ୍ଲୀନ୍	পব্লীন্
ପରବାସୁ	পরবাসু
ପରବି	পরবি
ପରବ୍	পরব্
ପରମାର୍ତା	পরমার্তা
ପରମେସ୍ବୁଅରି	পরমেস্বুঅরি
ପରିକା	পরিকা
ପରିକେତ୍	পরিকেত্
ପରିଜଟ୍	পরিজট্
ପରିତୋଶ୍	পরিতোশ্
ପରିସା	পরিসা
ପର୍ଦୁ	পর্দু
ପର୍ନାଦ୍	পর্নাদ্
ପର୍ନାଲ୍	পর্নাল্
ପର୍ନି	পর্নি
ପର୍ନିତା	পর্নিতা
ପର୍ବି	পর্বি
ପର୍ବୁଇନ୍ଡେର୍	পর্বুইন্ডের্
ପର୍ମିତା	পর্মিতা
ପର୍ମେଶ୍ବୁଅର୍	পর্মেশ্বুঅর্
ପର୍ଶ୍ବା	পর্শ্বা
ପଲକ୍	পলক্
ପଲକ୍ଶି	পলক্শি
ପଲାନି କୁମାର୍	পলানি কুমার্
ପଲ୍ବିଶ୍	পল্বিশ্
ପାଚକ୍	পাচক্
ପାବକି	পাবকি
ପାବନ୍	পাবন্
ପାର୍ତନ୍	পার্তন্
ପାର୍ତିଭ୍	পার্তিভ্
ପାର୍ବଟିନନ୍ଡନ୍	পার্বটিনন্ডন্
ପିଯାଶା	পিযাশা
ପିଯୁଶା	পিযুশা
ପୀଟଶ୍ମା	পীটশ্মা
ପୂଜିତା	পূজিতা
ପୂବିତନା	পূবিতনা
ପୂରିକା	পূরিকা
ପେର୍ନିତା	পের্নিতা
ପୋଉଶାଲି	পোউশালি
ପ୍ରଭା	প্রভা
ପ୍ରଭାବତ୍ଯ୍	প্রভাবত্য্
ପ୍ରାନ୍ବି	প্রান্বি
ଫନିଶ୍ବୁଅର୍	ফনিশ্বুঅর্
ଫଲାନି	ফলানি
ଫେରଲ୍	ফেরল্
ବକ୍ରାଭୁଜ୍	বক্রাভুজ্
ବକ୍ରୁତ୍	বক্রুত্
ବଗ୍ମିନେ	বগ্মিনে
ବଟୁକ୍	বটুক্
ବତତ୍ମଜ୍	বতত্মজ্
ବତ୍ସ୍ଯଯନ୍	বত্স্যযন্
ବନବରାଯନ୍	বনবরাযন্
ବନାର୍	বনার্
ବନିନି	বনিনি
ବନିଲା	বনিলা
ବନିସ୍ରୀ	বনিস্রী
ବନ୍କା	বন্কা
ବନ୍ଦୁ	বন্দু
ବନ୍ବିହାରି	বন্বিহারি
ବନ୍ଭଟ୍ଟ୍	বন্ভট্ট্
ବନ୍ମାଲା	বন্মালা
ବନ୍ମ୍ଜଲଜ୍	বন্ম্জলজ্
ବନ୍ଶି	বন্শি
ବନ୍ଶିଟା	বন্শিটা
ବନ୍ଶିଲ୍	বন্শিল্
ବନ୍ସରି	বন্সরি
ବବଞା	ববঞা
ବମାନିଏ	বমানিএ
ବମ୍ସି	বম্সি
ବମ୍ସୀ	বম্সী
ବଯୁନ୍	বযুন্
ବରଦବିନଯକା	বরদবিনযকা
ବରଲକ୍ଶ୍ମି	বরলক্শ্মি
ବରୁନ୍	বরুন্
ବରେନ୍ଡ୍ରା	বরেন্ড্রা
ବର୍ଚେକା	বর্চেকা
ବର୍ଦମାନ୍	বর্দমান্
ବର୍ଦାନ୍	বর্দান্
ବର୍ନିକା	বর্নিকা
ବର୍ଶନା	বর্শনা
ବର୍ଶନି	বর্শনি
ବର୍ଶିକା	বর্শিকা
ବଲାବନ୍	বলাবন্
ବଲେନ୍ଡୁ	বলেন্ডু
ବଲ୍ମେକି	বল্মেকি
ବଲ୍ଲକି	বল্লকি
ବଲ୍ଲି	বল্লি
ବସନ୍ଟାପ୍ରଭା	বসন্টাপ্রভা
ବସନ୍ଟି	বসন্টি
ବସନ୍ତ୍	বসন্ত্
ବସବି	বসবি
ବସବ୍	বসব্
ବସୁପତି	বসুপতি
ବସ୍ଟିନ୍	বস্টিন্
ବାଗ୍ଡେବି	বাগ্ডেবি
ବାଚି	বাচি
ବାନି	বানি
ବାଲା ଗୋବିନ୍ଡ୍	বালা গোবিন্ড্
ବାଲ୍ ଗୋପଲ୍	বাল্ গোপল্
ବାସି	বাসি
ବାସୁଦା	বাসুদা
ବାସୁଲକ୍ଶ୍ମି	বাসুলক্শ্মি
ବିତିକା	বিতিকা
ବିଭା	বিভা
ବିଲ୍ବୁଆସ୍ରି	বিল্বুআস্রি
ବିଶ୍ନୁ	বিশ্নু
ବୀଦାସ୍ରୀ	বীদাস্রী
ବୀନାବନି	বীনাবনি
ବୀରସୁନ୍ଡରି	বীরসুন্ডরি
ବୁଆମନ୍	বুআমন্
ବୁଆମିକା	বুআমিকা
ବୁବନା	বুবনা
ବେଡାନ୍	বেডান্
ବେଡାନ୍ଶି	বেডান্শি
ବେଡିତା	বেডিতা
ବେଦା	বেদা
ବେମ୍ବରାସି	বেম্বরাসি
ବେଲ୍	বেল্
ବୈଜାଯନ୍ଟି	বৈজাযন্টি
ବୈଡିଶ୍	বৈডিশ্
ବୈଦିକ୍	বৈদিক্
ବୈନବି	বৈনবি
ବୈବଟ୍	বৈবট্
ବୈରବି	বৈরবি
ବୈଶାଲି	বৈশালি
ବୈଶେକା	বৈশেকা
ବୈଶ୍ନବି	বৈশ্নবি
ବୈଶ୍ନୋଦେବି	বৈশ্নোদেবি
ବୈଶ୍ନୋବ୍	বৈশ্নোব্
ବ୍ରିଜା	ব্রিজা
ବ୍ରିତ୍ହି	ব্রিত্হি
ବ୍ରିଶା	ব্রিশা
ବ୍ରୁନ୍ଡା	ব্রুন্ডা
ଭନଦବ୍ଯା	ভনদব্যা
ଭଶ୍ବିକା	ভশ্বিকা
ଭସ୍କରା	ভস্করা
ଭାwନା	ভাwনা
ଭାଗ୍ବୁଅଟି	ভাগ্বুঅটি
ଭାଗ୍ବୁଅନ୍ଟି	ভাগ্বুঅন্টি
ଭାଗ୍ଯ	ভাগ্য
ଭାଗ୍ଯନନ୍ଡନା	ভাগ্যনন্ডনা
ଭାଗ୍ଯଶ୍ରି	ভাগ্যশ্রি
ଭାବଲନ୍	ভাবলন্
ଭାବିକ୍	ভাবিক্
ଭାରବି	ভারবি
ଭାସ୍କରି	ভাস্করি
ଭାସ୍ବୁଅତ୍	ভাস্বুঅত্
ଭିଶ୍ମା	ভিশ্মা
ଭୁମା	ভুমা
ଭୌଟିକ୍	ভৌটিক্
ଭୌମି	ভৌমি
ଭ୍ରିତି	ভ্রিতি
ଭ୍ରୁହନ୍ତ୍	ভ্রুহন্ত্
ମଗନ୍	মগন্
ମଙଲମ୍	মঙলম্
ମଙଲା	মঙলা
ମଙିରି	মঙিরি
ମଙୈ	মঙৈ
ମଡନ୍ମୋହନ୍	মডন্মোহন্
ମଡୁର୍	মডুর্
ମଦୁ ବିନ୍ଡୁ	মদু বিন্ডু
ମଦୁକ୍	মদুক্
ମଦୁଚନ୍ଡା	মদুচন্ডা
ମଦୁନିକା	মদুনিকা
ମଦୁମଯ୍	মদুময্
ମଦୁମିତା	মদুমিতা
ମଦୁରି	মদুরি
ମନସ୍ବି	মনস্বি
ମନସ୍ବୁଇନି	মনস্বুইনি
ମନିଟ୍	মনিট্
ମନିତା	মনিতা
ମନିନ୍ଡ୍ରା	মনিন্ড্রা
ମନିମୋଝି	মনিমোঝি
ମନିରାମ୍	মনিরাম্
ମନୀଟ୍	মনীট্
ମନୋଜ୍ନା	মনোজ্না
ମନ୍ଜିରି	মন্জিরি
ମନ୍ଜୁଲ୍	মন্জুল্
ମନ୍ଡରା	মন্ডরা
ମନ୍ଡର୍ମଲିକା	মন্ডর্মলিকা
ମନ୍ଡାବି	মন্ডাবি
ମନ୍ତିକା	মন্তিকা
ମମତି	মমতি
ମମ୍ତା	মম্তা
ମଲିନି	মলিনি
ମଲ୍ଲି	মল্লি
ମଲ୍ଲୁ	মল্লু
ମଲ୍ଲେଶମ୍	মল্লেশম্
ମଲ୍ଲେଶ୍	মল্লেশ্
ମହାକାଲ୍	মহাকাল্
ମହାକ୍ରମ୍	মহাক্রম্
ମହାଗୌରି	মহাগৌরি
ମହାଜୀଟ୍	মহাজীট্
ମହାଞା	মহাঞা
ମହାଟେଜସ୍	মহাটেজস্
ମହାଡେବ୍	মহাডেব্
ମହାତି	মহাতি
ମହାନନ୍ଡ୍	মহানন্ড্
ମହାନ୍ଟ୍	মহান্ট্
ମହାନ୍ତି	মহান্তি
ମହାବାଲା	মহাবালা
ମହାଭଡ୍ରା	মহাভড্রা
ମହାମନି	মহামনি
ମହାରନ୍ତ୍	মহারন্ত্
ମହାଲ୍ଯା	মহাল্যা
ମହାଶ୍ରି	মহাশ্রি
ମହିରା	মহিরা
ମହିର୍	মহির্
ମହେନ୍ଡ୍ରା	মহেন্ড্রা
ମହେଶ୍ବୁଅର୍	মহেশ্বুঅর্
ମହେସ୍ବୁଅରି	মহেস্বুঅরি
ମହ୍ନବ୍	মহ্নব্
ମାକାଲି	মাকালি
ମାଞଟା	মাঞটা
ମାନବ୍	মানব্
ମାନିକାନ୍ଟ୍	মানিকান্ট্
ମାଲ୍ବିକା	মাল্বিকা
ମୈଟ୍ରଯୀ	মৈট্রযী
ଯକ୍ଶିଟା	যক্শিটা
ଯକ୍ଶିତ୍	যক্শিত্
ଯଗ୍ନକଯା	যগ্নকযা
ଯଟିଶ୍	যটিশ্
ଯତି	যতি
ଯତିଶ୍	যতিশ্
ଯଯିନ୍	যযিন্
ଯଶବୁଇନି	যশবুইনি
ଯଶାଶ୍ରୀ	যশাশ্রী
ଯଶାସ୍ବି	যশাস্বি
ଯଶି	যশি
ଯଶ୍ ରାଜ୍	যশ্ রাজ্
ଯଶ୍ବନ୍ତ୍	যশ্বন্ত্
ଯଶ୍ରୀ	যশ্রী
ଯସ୍ବୁଅନ୍ତ୍	যস্বুঅন্ত্
ଯାଗ୍ଯାସେନ୍	যাগ্যাসেন্
ଯାଜଟ୍	যাজট্
ଯାଟୁଦନି	যাটুদনি
ଯାଡାବେନ୍ଡ୍ରା	যাডাবেন্ড্রা
ଯାମାହିଲ୍	যামাহিল্
ଯାମୁନା	যামুনা
ଯାମ୍ଯା	যাম্যা
ଯାହ୍ବି	যাহ্বি
ଯୁକସ୍ରି	যুকস্রি
ଯୁଗନ୍ଶ୍	যুগন্শ্
ଯୁଗେନ୍ଡେର୍	যুগেন্ডের্
ଯୁବନ୍ ସୁର୍ଯା	যুবন্ সুর্যা
ଯୁବରାନି	যুবরানি
ଯୁବାରାମ୍	যুবারাম্
ଯୁବିନ୍	যুবিন্
ଯୁବ୍ରାନି	যুব্রানি
ଯେଇଗବନ୍	যেইগবন্
ଯେଘରାଜ୍	যেঘরাজ্
ଯେତର୍ତ୍	যেতর্ত্
ଯେମା	যেমা
ଯେସ୍ବୁଅନ୍ତ୍	যেস্বুঅন্ত্
ଯେସ୍ବୁଇନ୍	যেস্বুইন্
ଯୋଗାଜି	যোগাজি
ଯୋଗୀଟା	যোগীটা
ଯୋହନ୍	যোহন্
ରକଶ୍ନ୍ଡା	রকশ্ন্ডা
ରକ୍ଶଟି	রক্শটি
ରକ୍ଶିନା	রক্শিনা
ରଘୁନନ୍ଡନ୍	রঘুনন্ডন্
ରଘୁନାତ୍	রঘুনাত্
ରଙିତ୍	রঙিত্
ରଜନିକାନ୍ଟା	রজনিকান্টা
ରଜନ୍ଞା	রজন্ঞা
ରଟନା	রটনা
ରଟ୍ନା ପ୍ରିଯା	রট্না প্রিযা
ରଟ୍ନାଜ୍ଯୋଟି	রট্নাজ্যোটি
ରଟ୍ନାବଲି	রট্নাবলি
ରତ୍ନା	রত্না
ରନିଶ୍	রনিশ্
ରନ୍ଜନି	রন্জনি
ରନ୍ଜଯ୍	রন্জয্
ରନ୍ଜୁ	রন্জু
ରନ୍ବିତା	রন্বিতা
ରବିପ୍ରଭା	রবিপ্রভা
ରବିଯାନ୍କି	রবিযান্কি
ରବେକ୍	রবেক্
ରମନୁଜମ୍	রমনুজম্
ରମାକାନ୍ଟ୍	রমাকান্ট্
ରମାଦେବି	রমাদেবি
ରମୈଅହ୍	রমৈঅহ্
ରମ୍ଯଦେବି	রম্যদেবি
ରଶିକା	রশিকা
ରଶିଲା	রশিলা
ରଶ୍ବୁଇନା	রশ্বুইনা
ରଶ୍ମିନ୍	রশ্মিন্
ରସୁଲ୍	রসুল্
ରହାମ୍	রহাম্
ରହ୍ନି	রহ্নি
ରାଓସହେବ୍	রাওসহেব্
ରାକା	রাকা
ରାଗେଶ୍	রাগেশ্
ରାଘବା	রাঘবা
ରାଘବ୍	রাঘব্
ରାଜଲକ୍ଶ୍ମି	রাজলক্শ্মি
ରାଜାରମନ୍	রাজারমন্
ରାଜାରମେଶ୍	রাজারমেশ্
ରାଜେଶ୍ରମ୍	রাজেশ্রম্
ରାଜ୍	রাজ্
ରାଜ୍ କିରନ୍	রাজ্ কিরন্
ରାଜ୍କଲା	রাজ্কলা
ରାଝନ୍ସ୍	রাঝন্স্
ରାଧା କ୍ରିଶ୍ନା	রাধা ক্রিশ্না
ରାମୋଜି	রামোজি
ରାମ୍	রাম্
ରାମ୍ଗୋପାଲ୍	রাম্গোপাল্
ରାମ୍ସାଗର୍	রাম্সাগর্
ରାହୁଲ୍ରାଜ୍	রাহুল্রাজ্
ରୀଟ୍	রীট্
ରୀତନା	রীতনা
ରୀନା	রীনা
ରୀମା	রীমা
ରେବନ୍ତି	রেবন্তি
ରେବନ୍ତିକା	রেবন্তিকা
ରେମିତା	রেমিতা
ରେଶିତା	রেশিতা
ରେହେଇଲା	রেহেইলা
ରୈନା	রৈনা
ଲକ୍ଶନା	লক্শনা
ଲକ୍ଶା	লক্শা
ଲକ୍ଶିଟା	লক্শিটা
ଲକ୍ଶ୍ମି	লক্শ্মি
ଲକ୍ଶ୍ମି ପ୍ରିଯା	লক্শ্মি প্রিযা
ଲଜ୍ଜବୁଅଟି	লজ্জবুঅটি
ଲଜ୍ବଟି	লজ্বটি
ଲଜ୍ବନ୍ଟି	লজ্বন্টি
ଲତା	লতা
ଲନିବନ୍	লনিবন্
ଲବନା	লবনা
ଲବିନ୍	লবিন্
ଲବ୍ଯ୍	লব্য্
ଲମ୍ବକର୍ନା	লম্বকর্না
ଲରଞା	লরঞা
ଲରିନା	লরিনা
ଲଲମ୍	ললম্
ଲଲିଟ୍ମୋହନ୍	ললিট্মোহন্
ଲଲିଟ୍ରାଜ୍	ললিট্রাজ্
ଲସିକ୍	লসিক্
ଲହାରି	লহারি
ଲାଲିଟ୍ଯା	লালিট্যা
ଲାଲିମା	লালিমা
ଲାସ୍ଯା	লাস্যা
ଲିଙେଶ୍	লিঙেশ্
ଲିନିଶା	লিনিশা
ଲିମିଶା	লিমিশা
ଲିଯାନା	লিযানা
ଲିଲା	লিলা
ଲିଲାଦର୍	লিলাদর্
ଲିଶନ୍ତ୍	লিশন্ত্
ଲୀଲବୁଅଟି	লীলবুঅটি
ଲୁନି	লুনি
ଲୁମ୍ବିକା	লুম্বিকা
ଲୁମ୍ବିନି	লুম্বিনি
ଲୁହିଟ୍	লুহিট্
ଲୂକେଶ୍ବୁଅରି	লূকেশ্বুঅরি
ଲେଖିଶା	লেখিশা
ଲେଖ୍ଯା	লেখ্যা
ଲେନିଶା	লেনিশা
ଲେପକ୍ଶ୍	লেপক্শ্
ଲେମା	লেমা
ଲୋଉକ୍ଯା	লোউক্যা
ଲୋକକ୍ରିଟି	লোকক্রিটি
ଲୋକିନି	লোকিনি
ଲୋକେଶ୍ବୁଅରନ୍	লোকেশ্বুঅরন্
ଲୋକ୍ପ୍ରକାଶ୍	লোক্প্রকাশ্
ଲୋଗିଟା	লোগিটা
ଲୋବେଶ୍	লোবেশ্
ଲୋମଶ୍	লোমশ্
ଲୋହିଟା	লোহিটা
ସକଲେଶ୍ବୁଅର୍	সকলেশ্বুঅর্
ସଙିଟା	সঙিটা
ସଙିନି	সঙিনি
ସଚନ୍ଡ୍ରା	সচন্ড্রা
ସଚି	সচি
ସଚିଡାନନ୍ଡ୍	সচিডানন্ড্
ସଚିନ୍	সচিন্
ସଚିନ୍ଡେଓ	সচিন্ডেও
ସଚେଟନ୍	সচেটন্
ସଡାର୍	সডার্
ସଡାଶିବା	সডাশিবা
ସଡିଶ୍	সডিশ্
ସଡ୍ଗଟି	সড্গটি
ସଡ୍ଗୁରୁ	সড্গুরু
ସଦନା	সদনা
ସନ୍କରି	সন্করি
ସନ୍ଜନ	সন্জন
ସନ୍ଜିଟା	সন্জিটা
ସବରୀଶ୍	সবরীশ্
ସବିତା	সবিতা
ସବୁରି	সবুরি
ସବ୍ରଙ୍	সব্রঙ্
ସଭ୍ଯା	সভ্যা
ସଭ୍ରନ୍ଟ୍	সভ্রন্ট্
ସମଞା	সমঞা
ସମତା	সমতা
ସମିକା	সমিকা
ସମେନ୍	সমেন্
ସମେଶ୍	সমেশ্
ସମ୍ବିତି	সম্বিতি
ସମ୍ବିତ୍	সম্বিত্
ସମ୍ବୁଡ୍ଦା	সম্বুড্দা
ସମ୍ବୋଦ୍	সম্বোদ্
ସମ୍ଯତା	সম্যতা
ସମ୍ରିଡ୍ଦା	সম্রিড্দা
ସଲେନା	সলেনা
ସଲୋଖ୍	সলোখ্
ସଲୋହି	সলোহি
ସହଡେବ୍	সহডেব্
ସହ୍ଡେବ୍	সহ্ডেব্
ସାଇ ଆନନ୍ଡ୍	সাই আনন্ড্
ସାଇ କୁମାରି	সাই কুমারি
ସାଇ କୁମାର୍	সাই কুমার্
ସାଇ ବାନି	সাই বানি
ସାଇ ସର୍ବେଶ୍	সাই সর্বেশ্
ସାଇଯ୍ଯାନ୍	সাইয্যান্
ସାଜିତ୍	সাজিত্
ସାଜିଲି	সাজিলি
ସାଟ୍ବିକ୍	সাট্বিক্
ସାନିଦ୍ଯା	সানিদ্যা
ସାନିଯା	সানিযা
ସାରାନ୍ଶ୍	সারান্শ্
ସାହସ୍ଟ୍ରାଜିଟ୍	সাহস্ট্রাজিট্
ସାହିଟ୍ଯା	সাহিট্যা
ସାହିରାମ୍	সাহিরাম্
ସାହିଲ୍	সাহিল্
ସାହୁଲ୍	সাহুল্
ସୈଜଯାନି	সৈজযানি
ସୈଜାସି	সৈজাসি
ସୈଜିଲ୍	সৈজিল্
ସୈନାତ୍	সৈনাত্
ସୈନିଟ୍	সৈনিট্
ସୈହିଶ୍	সৈহিশ্
ହନିମା	হনিমা
ହନିଶା	হনিশা
ହନିଶ୍	হনিশ্
ହନୀଶା	হনীশা
ହନୁମନ୍ଟା	হনুমন্টা
ହବିହ୍	হবিহ্
ହମ୍ସାନନ୍ଡି	হম্সানন্ডি
ହମ୍ସିକା	হম্সিকা
ହରିକିଶନ୍	হরিকিশন্
ହରିଟେଜା	হরিটেজা
ହରିତା	হরিতা
ହରିତ୍	হরিত্
ହରିଦ	হরিদ
ହରିନା	হরিনা
ହରିନାରାଯନ୍	হরিনারাযন্
ହରିପେଅସାଡ୍	হরিপেঅসাড্
ହରିମନ୍ଟି	হরিমন্টি
ହରେଶ୍	হরেশ্
ହର୍କେଶ୍	হর্কেশ্
ହର୍ଟେଇଜ୍	হর্টেইজ্
ହର୍ବି	হর্বি
ହର୍ଶଲା	হর্শলা
ହର୍ଶିତା	হর্শিতা
ହର୍ଶିତ୍	হর্শিত্
ହର୍ଶ୍ ବୀର୍	হর্শ্ বীর্
ହର୍ଶ୍ନିଲ୍	হর্শ্নিল্
ହର୍ସିକା	হর্সিকা
ହଶ୍ମିତା	হশ্মিতা
ହଶ୍ରୀ	হশ্রী
ହସିଟା	হসিটা
ହସିନା	হসিনা
ହସ୍ତା	হস্তা
ହସ୍ବିତା	হস্বিতা
ହସ୍ମିତା	হস্মিতা
ହାରିତ୍	হারিত্
ହିଟେନ୍ଡ୍ରା	হিটেন্ড্রা
ହିତେଶ୍	হিতেশ্
ହିମା	হিমা
ହିମାଗୋଉରି	হিমাগোউরি
ହିମାଘ୍ନା	হিমাঘ্না
ହିମାନ୍ସୁ	হিমান্সু
ହିମାବନ୍ତ୍	হিমাবন্ত্
ହିରଞଦା	হিরঞদা
ହିରନ୍ମଯି	হিরন্মযি
ହିରନ୍ମଯ୍	হিরন্ময্
ହିରିଶା	হিরিশা
ହିର୍ବୁଅ	হির্বুঅ
ହିଲ୍ଲା	হিল্লা
ହୀଟ୍ରାଜ୍	হীট্রাজ্
ହୀନା	হীনা
ହୀର୍ବ	হীর্ব
ହେଇଡି	হেইডি
ହେଟବ୍	হেটব্
ହେଟୁ	হেটু
ହେଟ୍ବୀକ୍	হেট্বীক্
ହେଟ୍ସ୍ଯା	হেট্স্যা
ହେତନ୍ଶି	হেতন্শি
ହେନଲ୍	হেনল্
ହେମଙିନି	হেমঙিনি
ହେମନ୍ଟ୍	হেমন্ট্
ହେମନ୍ତ୍	হেমন্ত্
ହେମନ୍ତ୍ସ୍ରୀ	হেমন্ত্স্রী
ହେମପ୍ରସାଡ୍	হেমপ্রসাড্
ହେମବଟିନନ୍ଡନ୍	হেমবটিনন্ডন্
ହେମସ୍ରି	হেমস্রি
ହେମିଶା	হেমিশা
ହେମ୍କେଶ୍	হেম্কেশ্
ହେମ୍କ୍ରିଶ୍	হেম্ক্রিশ্
ହେମ୍ରାଜ୍	হেম্রাজ্
ହେରକ୍	হেরক্
ହୋନ୍ହାର୍	হোন্হার্
ହ୍ରିଦ୍ଯା	হ্রিদ্যা
#
#
# Territory names from CLDR
ଆଣ୍ଡୋରା	আণ্ডোরা
ସଂଯୁକ୍ତ ଆରବ ଏମିରେଟସ୍	সংযুক্ত আরব এমিরেটস্
ଆଫାଗାନିସ୍ତାନ୍	আফাগানিস্তান্
ଆଣ୍ଟିଗୁଆ ଏବଂ ବାରବୁଦା	আণ্টিগুআ এবং বারবুদা
ଆଙ୍ଗୁଇଲ୍ଲା	আঙ্গুইল্লা
ଆଲବାନିଆ	আলবানিআ
ଆର୍ମେନିଆ	আর্মেনিআ
ଆଙ୍ଗୋଲା	আঙ্গোলা
ଆର୍ଣ୍ଟକଟିକା	আর্ণ্টকটিকা
ଆର୍ଜେଣ୍ଟିନା	আর্জেণ্টিনা
ଆମେରିକାନ୍ ସାମୋଆ	আমেরিকান্ সামোআ
ଅଷ୍ଟ୍ରିଆ	অষ্ট্রিআ
ଅଷ୍ଟ୍ରେଲିଆ	অষ্ট্রেলিআ
ଆରୁବା	আরুবা
ଆଲାଣ୍ଡ ଆଇସଲ୍ୟାଣ୍ଡ	আলাণ্ড আইসল্য়াণ্ড
ଆଜେରବାଇଜାନ୍	আজেরবাইজান্
ବୋସନିଆ ଏବଂ ହର୍ଜଗୋଭିନା	বোসনিআ এবং হর্জগোভিনা
ବାରବାଡୋସ୍	বারবাডোস্
ବାଙ୍ଗଲାଦେଶ୍	বাঙ্গলাদেশ্
ବେଲଜିୟମ୍	বেলজিয়ম্
ବୁର୍କିନୋ ଫାସୋ	বুর্কিনো ফাসো
ବୁଲଗେରିଆ	বুলগেরিআ
ବାହାରିନ୍	বাহারিন্
ବୁରୁନ୍ଦି	বুরুন্দি
ବେନିନ୍	বেনিন্
ସେଣ୍ଟ ବାର୍ଥେଲେମି	সেণ্ট বার্থেলেমি
ବରମୁଡା	বরমুডা
ବ୍ରୁନେଇ	ব্রুনেই
ବୋଲଭିଆ	বোলভিআ
ବ୍ରାଜିଲ୍	ব্রাজিল্
ବାହାମାସ୍	বাহামাস্
ଭୁଟାନ୍	ভুটান্
ବୌଭେଟ୍ ଆଇସଲ୍ୟାଣ୍ଡ	বৌভেট্ আইসল্য়াণ্ড
ବୋଟସ୍ବାନ୍	বোটস্বান্
ବେଲାରୁଷ୍	বেলারুষ্
ବେଲିଜ୍	বেলিজ্
କାନାଡା	কানাডা
କୋକୋସ୍ ଆଇସଲ୍ୟାଣ୍ଡ	কোকোস্ আইসল্য়াণ্ড
କଙ୍ଗୋ-କିନସାସା	কঙ্গো-কিনসাসা
ମଧ୍ୟ ଆଫ୍ରିକୀୟ ଗଣତନ୍ତ୍ର	মধ্য় আফ্রিকীয় গণতন্ত্র
କଙ୍ଗୋ-ବ୍ରାଜିଭିଲ୍ଲେ	কঙ্গো-ব্রাজিভিল্লে
ସ୍ବିଜରଲ୍ୟାଣ୍ଡ	স্বিজরল্য়াণ্ড
ଆଇବରୀ କୋଷ୍ଟ	আইবরী কোষ্ট
କୁକ୍ ଆଇସଲ୍ୟାଣ୍ଡ	কুক্ আইসল্য়াণ্ড
ଚିଲ୍ଲୀ	চিল্লী
କାମେରୁନ୍	কামেরুন্
ଚିନ୍	চিন্
କୋଲମ୍ବିଆ	কোলম্বিআ
କୋଷ୍ଟା ରିକା	কোষ্টা রিকা
କ୍ୱିବା	ক্বিবা
କେପ୍ ଭର୍ଦେ	কেপ্ ভর্দে
ଖ୍ରୀଷ୍ଟମାସ ଆଇଲ୍ୟାଣ୍ଡ	খ্রীষ্টমাস আইল্য়াণ্ড
ସାଇପ୍ରସ୍	সাইপ্রস্
ଚେକ୍ ସାଧାରଣତନ୍ତ୍ର	চেক্ সাধারণতন্ত্র
ଜର୍ମାନୀ	জর্মানী
ଡିବୌଟି	ডিবৌটি
ଡେନମାର୍କ	ডেনমার্ক
ଡୋମିନାକା	ডোমিনাকা
ଡୋମିନକାନ୍ ପ୍ରଜାତନ୍ତ୍ର	ডোমিনকান্ প্রজাতন্ত্র
ଆଲଜେରିଆ	আলজেরিআ
ଇକ୍ୱାଡୋର୍	ইক্বাডোর্
ଏସ୍ତୋନିଆ	এস্তোনিআ
ଇଜିପ୍ଟ	ইজিপ্ট
ପଶ୍ଚିମ ସାହାରା	পশ্চিম সাহারা
ଇରିଟ୍ରିୟା	ইরিট্রিয়া
ସ୍ପେନ୍	স্পেন্
ଇଥିଓପିଆ	ইথিওপিআ
ୟୁରୋପିଆନ୍ ୟୁନିଅନ୍	য়ুরোপিআন্ য়ুনিঅন্
ଫିନଲ୍ୟାଣ୍ଡ	ফিনল্য়াণ্ড
ଫିଜି	ফিজি
ଫଲ୍କଲ୍ୟାଣ୍ଡ ଦ୍ବୀପପୁଞ୍ଜ	ফল্কল্য়াণ্ড দ্বীপপুঞ্জ
ମାଇକ୍ରୋନେସିଆ	মাইক্রোনেসিআ
ଫାରୋଇ ଦ୍ବୀପପୁଞ୍ଜ	ফারোই দ্বীপপুঞ্জ
ଫ୍ରାନ୍ସ	ফ্রান্স
ଗାବୋନ୍	গাবোন্
ବ୍ରିଟେନ୍	ব্রিটেন্
ଗ୍ରେନାଡା	গ্রেনাডা
ଜର୍ଜିଆ	জর্জিআ
ଫ୍ରେଞ୍ଚ ଗୁଇନା	ফ্রেঞ্চ গুইনা
ଗୁଏରନେସି	গুএরনেসি
ଘାନା	ঘানা
ଜିବ୍ରାଲ୍ଟର୍	জিব্রাল্টর্
ଗ୍ରୀନଲ୍ୟାଣ୍ଡ	গ্রীনল্য়াণ্ড
ଗାମ୍ବିଆ	গাম্বিআ
ଗୁଏନେଆ	গুএনেআ
ଗୌଡେଲୌପେ	গৌডেলৌপে
ଇକ୍ବାଟେରିଆଲ୍ ଗୁଇନିଆ	ইক্বাটেরিআল্ গুইনিআ
ଗ୍ରୀସ୍	গ্রীস্
ଦକ୍ଷିଣ ଜର୍ଜିଆ ଏବଂ ଦକ୍ଷିଣ ସାଣ୍ଡୱିଚ୍ ଦ୍ବୀପପୁଞ୍ଜ	দক্ষিণ জর্জিআ এবং দক্ষিণ সাণ্ডবিচ্ দ্বীপপুঞ্জ
ଗୁଏତମାଲା	গুএতমালা
ଗୁଆମ୍	গুআম্
ଗୁଇନିଆ-ବିସାଉ	গুইনিআ-বিসাউ
ଗୁଇନା	গুইনা
ହଂକଂ ବିଶେଷ ପ୍ରଶାସନିକ କ୍ଷେତ୍ର ଚୀନ୍	হংকং বিশেষ প্রশাসনিক ক্ষেত্র চীন্
ହାର୍ଡ ଦ୍ବୀପପୁଞ୍ଜ ଏବଂ ମ୍ୟାକଡୋନାଲ୍ ଦ୍ବୀପପୁଞ୍ଜ	হার্ড দ্বীপপুঞ্জ এবং ম্য়াকডোনাল্ দ্বীপপুঞ্জ
ହୋଣ୍ଡାରୁସ୍	হোণ্ডারুস্
କ୍ରୋଆଟିଆ	ক্রোআটিআ
ହାଇତି	হাইতি
ହଙ୍ଗେରୀ	হঙ্গেরী
ଇଣ୍ଡୋନେସିଆ	ইণ্ডোনেসিআ
ଆୟରଲ୍ୟାଣ୍ଡ	আয়রল্য়াণ্ড
ଇସ୍ରାଏଲ୍	ইস্রাএল্
ଆଇଲ୍ ଅଫ୍ ମୈନ୍	আইল্ অফ্ মৈন্
ଭାରତ	ভারত
ବ୍ରିଟିଶ୍ ଭାରତୀୟ ସାମୁଦ୍ରିକ କ୍ଷେତ୍ର	ব্রিটিশ্ ভারতীয় সামুদ্রিক ক্ষেত্র
ଇରାକ୍	ইরাক্
ଇରାନ୍	ইরান্
ଆଇସଲ୍ୟାଣ୍ଡ	আইসল্য়াণ্ড
ଇଟାଲୀ	ইটালী
ଜର୍ସି	জর্সি
ଜାମାଇକା	জামাইকা
ଜୋର୍ଡାନ୍	জোর্ডান্
ଜାପାନ୍	জাপান্
କେନିୟା	কেনিয়া
କିର୍ଗିଜିସ୍ଥାନ	কির্গিজিস্থান
କାମ୍ବୋଡିଆ	কাম্বোডিআ
କିରିବାଟୀ	কিরিবাটী
କାମୋରସ୍	কামোরস্
ସେଣ୍ଟ କିଟସ୍ ଏଣ୍ଡ ନେଭିସ୍	সেণ্ট কিটস্ এণ্ড নেভিস্
ଉତ୍ତର କୋରିଆ	উত্তর কোরিআ
ଦକ୍ଷିଣ କୋରିଆ	দক্ষিণ কোরিআ
କୁଏତ୍	কুএত্
କେମ୍ୟାନ୍ ଦ୍ବୀପପୁଞ୍ଜ	কেম্য়ান্ দ্বীপপুঞ্জ
କାଜାକାସ୍ଥାନ୍	কাজাকাস্থান্
ଲାଓସ୍	লাওস্
ଲେବାନନ୍	লেবানন্
ସେଣ୍ଟ ଲୁସିଆ	সেণ্ট লুসিআ
ଲିଚେସ୍ତିଆନାନ୍	লিচেস্তিআনান্
ଶ୍ରୀଲଙ୍କା	শ্রীলঙ্কা
ଲିବେରିଆ	লিবেরিআ
ଲେସୋଥୋ	লেসোথো
ଲିଥାଆନିଆ	লিথাআনিআ
ଲକ୍ସେମବର୍ଗ	লক্সেমবর্গ
ଲାଟଭିଆ	লাটভিআ
ଲିବିଆ	লিবিআ
ମୋରୋକ୍କୋ	মোরোক্কো
ମୋନାକୋ	মোনাকো
ମାଲଡୋଭା	মালডোভা
ମଣ୍ଟେଗ୍ରୋ	মণ্টেগ্রো
ସେଣ୍ଟ ମାର୍ଟିନ୍	সেণ্ট মার্টিন্
ମାଡାଗାସ୍କର୍	মাডাগাস্কর্
ମାର୍ଶଲ୍ ଦ୍ବୀପପୁଞ୍ଜ	মার্শল্ দ্বীপপুঞ্জ
ମାସେଡୋନିଆ	মাসেডোনিআ
ମାଳୀ	মালী
ମିୟାମାର୍	মিয়ামার্
ମଙ୍ଗୋଲିଆ	মঙ্গোলিআ
ମାକାଉ SAR ଚିନ୍	মাকাউ SAR চিন্
ଉତ୍ତର ମାରିଆନା ଦ୍ବୀପପୁଞ୍ଜ	উত্তর মারিআনা দ্বীপপুঞ্জ
ମାର୍ଟିନିକ୍ୟୁ	মার্টিনিক্য়ু
ମାଉରିଟାନିଆ	মাউরিটানিআ
ମଣ୍ଟେସେରାଟ୍	মণ্টেসেরাট্
ମାଲ୍ଟା	মাল্টা
ମୌରିସସ୍	মৌরিসস্
ମାଳଦ୍ବୀପ	মালদ্বীপ
ମାଲୱି	মালবি
ମେକ୍ସିକୋ	মেক্সিকো
ମାଲେସିଆ	মালেসিআ
ମୋଜାମ୍ବିକ୍ୟୁ	মোজাম্বিক্য়ু
ନାମ୍ବିଆ	নাম্বিআ
ନୂତନ କାଲେଡୋନିଆ	নূতন কালেডোনিআ
ନାଇଜର୍	নাইজর্
ନରଫ୍ଲକ୍ ଦ୍ବୀପ	নরফ্লক্ দ্বীপ
ନାଇଜେରିଆ	নাইজেরিআ
ନିକାରାଗୁଆ	নিকারাগুআ
ନେଦରଲ୍ୟାଣ୍ଡ	নেদরল্য়াণ্ড
ନରୱେ	নরবে
ନେପାଳ	নেপাল
ନାଉରୁ	নাউরু
ନିଉ	নিউ
ନ୍ୟୁଜିଲାଣ୍ଡ	ন্য়ুজিলাণ্ড
ଓମାନ୍	ওমান্
ପାନାମା	পানামা
ପେରୁ	পেরু
ଫ୍ରେଞ୍ଚ ପଲିନେସିଆ	ফ্রেঞ্চ পলিনেসিআ
ପପୁଆ ନ୍ୟୁ ଗୁଏନିଆ	পপুআ ন্য়ু গুএনিআ
ଫିଲିପାଇନସ୍	ফিলিপাইনস্
ପାକିସ୍ତାନ	পাকিস্তান
ପୋଲାଣ୍ଡ	পোলাণ্ড
ସେଣ୍ଟ ପିଏରେ ଏବଂ ମିକ୍ବାଲୋନ୍	সেণ্ট পিএরে এবং মিক্বালোন্
ପିଟକାଇରିନ୍	পিটকাইরিন্
ପୁଏର୍ତ୍ତୋ ରିକୋ	পুএর্ত্তো রিকো
ପାଲେସ୍ତେନିଆ	পালেস্তেনিআ
ପର୍ତ୍ତୁଗାଲ୍	পর্ত্তুগাল্
ପାଲାଉ	পালাউ
ପାରାଗୁଏ	পারাগুএ
କତାର୍	কতার্
ଆଉଟଲେଇଂ ଓସେନିଆ	আউটলেইং ওসেনিআ
ରିୟୁନିଅନ୍	রিয়ুনিঅন্
ରୋମାନିଆ	রোমানিআ
ସର୍ବିଆ	সর্বিআ
ରୁଷିଆ	রুষিআ
ରାୱାଣ୍ଡା	রাবাণ্ডা
ସାଉଦି ଆରବିଆ	সাউদি আরবিআ
ସୋଲୋମନ୍ ଦ୍ବୀପପୁଞ୍ଜ	সোলোমন্ দ্বীপপুঞ্জ
ସେଚେଲସ୍	সেচেলস্
ସୁଦାନ୍	সুদান্
ସ୍ୱେଡେନ୍	স্বেডেন্
ସିଙ୍ଗାପୁର୍	সিঙ্গাপুর্
ସେଣ୍ଟ ହେଲେନା	সেণ্ট হেলেনা
ସ୍ଲୋଭେନିଆ	স্লোভেনিআ
ସାଲ୍ଭାର୍ଡ ଏବଂ ଜାନ୍ ମାୟୋନ୍	সাল্ভার্ড এবং জান্ মায়োন্
ସ୍ଲୋଭାକିଆ	স্লোভাকিআ
ସିଓରା ଲିଓନ୍	সিওরা লিওন্
ସାନ୍ ମାରିନୋ	সান্ মারিনো
ସେନେଗାଲ୍	সেনেগাল্
ସୋମାଲିଆ	সোমালিআ
ସୁରିନାମ	সুরিনাম
ଦକ୍ଷିନ ସୁଦାନ	দক্ষিন সুদান
ସାଓ ଟୋମେ ଏବଂ ପ୍ରିନସିପି	সাও টোমে এবং প্রিনসিপি
ଏଲ୍ ସାଲଭାଡୋର୍	এল্ সালভাডোর্
ସିରିଆ	সিরিআ
ସ୍ବାଜିଲାଣ୍ଡ	স্বাজিলাণ্ড
ତୁର୍କସ୍ ଏବଂ ସାଇକସ୍ ଦ୍ବୀପପୁଞ୍ଜ	তুর্কস্ এবং সাইকস্ দ্বীপপুঞ্জ
ଚାଦ୍	চাদ্
ଫରାସୀ ଦକ୍ଷିଣ କ୍ଷେତ୍ର	ফরাসী দক্ষিণ ক্ষেত্র
ଟୋଗୋ	টোগো
ଥାଇଲାଣ୍ଡ	থাইলাণ্ড
ତାଜିକିସ୍ଥାନ୍	তাজিকিস্থান্
ଟୋକେଲାଉ	টোকেলাউ
ପୁର୍ବ ତିମୋର୍	পুর্ব তিমোর্
ତୁର୍କମେନିସ୍ତାନ୍	তুর্কমেনিস্তান্
ତୁନିସିଆ	তুনিসিআ
ଟୋଙ୍ଗା	টোঙ্গা
ତୁର୍କୀ	তুর্কী
ତ୍ରିନିଦାଦ୍ ଏବଂ ଟୋବାଗୋ	ত্রিনিদাদ্ এবং টোবাগো
ଟୁଭାଲୁ	টুভালু
ତାଇୱାନ୍	তাইবান্
ତାଞ୍ଜାନିଆ	তাঞ্জানিআ
ୟୁକ୍ରାଇନ୍	য়ুক্রাইন্
ଉଗାଣ୍ଡା	উগাণ্ডা
ୟୁନାଇଟେଡ୍ ଷ୍ଟେଟସ୍ ମାଇନର୍ ଆଉଟଲେଇଂ ଦ୍ବୀପପୁଞ୍ଜ	য়ুনাইটেড্ ষ্টেটস্ মাইনর্ আউটলেইং দ্বীপপুঞ্জ
ଯୁକ୍ତ ରାଷ୍ଟ୍ର ଆମେରିକା	যুক্ত রাষ্ট্র আমেরিকা
ଉରୁଗୁଏ	উরুগুএ
ଉଜବେକିସ୍ଥାନ୍	উজবেকিস্থান্
ଭାଟିକାନ୍	ভাটিকান্
ସେଣ୍ଟ ଭିନସେଣ୍ଟ ଏବଂ ଦି ଗ୍ରେନାଡିସ୍	সেণ্ট ভিনসেণ্ট এবং দি গ্রেনাডিস্
ଭେନଜୁଏଲା	ভেনজুএলা
ବ୍ରିଟିଶ୍ ଭର୍ଜିନ୍ ଦ୍ବୀପପୁଞ୍ଜ	ব্রিটিশ্ ভর্জিন্ দ্বীপপুঞ্জ
ୟୁଏସ୍ ଭର୍ଜିନ୍ ଦ୍ବୀପପୁଞ୍ଜ	য়ুএস্ ভর্জিন্ দ্বীপপুঞ্জ
ଭିଏତନାମ୍	ভিএতনাম্
ଭାନୁଆତୁ	ভানুআতু
ୱାଲିସ୍ ଏବଂ ଫୁତୁନା	বালিস্ এবং ফুতুনা
ସାମୋଆ	সামোআ
ୟେମେନ୍	য়েমেন্
ମାୟୋଟେ	মায়োটে
ଦକ୍ଷିଣ ଆଫ୍ରିକା	দক্ষিণ আফ্রিকা
ଜାମ୍ବିଆ	জাম্বিআ
ଜିମ୍ବାୱେ	জিম্বাবে
ଅଜଣା କିମ୍ବା ଅବୈଧ ପ୍ରଦେଶ	অজণা কিম্বা অবৈধ প্রদেশ
