# Baby names
అకుతీ	अकुती
అక్సిథీ	अक्सिथी
అచలరాజ	अचलराज
అచలా	अचला
అజగంధా	अजगंधा
అజాణీ	अजाणी
అజియా	अजिया
అడ్యాత్రయీ	अड्यात्रयी
అదీక్యా	अदीक्या
అదృశ	अदृश
అదేన్య	अदेन्य
అద్రిక	अद्रिक
అద్రీపతి	अद्रीपति
అధిక్శీఠా	अधिक्शीठा
అబిభవా	अबिभवा
అబీశాఈ	अबीशाई
అబేల	अबेल
అబోఇల	अबोइल
అబ్జా	अब्जा
అబ్ధీ	अब्धी
అబ్బ్య్నాయ్హా	अब्ब्य्नाय्हा
అభయ	अभय
అభయాన	अभयान
అభిథా	अभिथा
అభిథి	अभिथि
అభినయ	अभिनय
అభినిత	अभिनित
అభినీత	अभिनीत
అభిమంద	अभिमंद
అభిమానీ	अभिमानी
అభిసోకా	अभिसोका
అభిహీతా	अभिहीता
అభీచంద్ర	अभीचंद्र
అభీనాతా	अभीनाता
అభీశీక్తా	अभीशीक्ता
అభీసుమత	अभीसुमत
అభ్జిత	अभ्जित
అభ్యప్సీత	अभ्यप्सीत
అలకనందా	अलकनंदा
అశవ	अशव
అశునత	अशुनत
అశ్నేఇల	अश्नेइल
అహేలీ	अहेली
ఆకర్షక	आकर्षक
ఆచమన	आचमन
ఆతమన	आतमन
ఆత్మజ	आत्मज
ఆత్రయీ	आत्रयी
ఆదరవ	आदरव
ఆదర్శా	आदर्शा
ఆదర్శీనీ	आदर्शीनी
ఆదీప్తా	आदीप्ता
ఆధరిత	आधरित
ఆధార	आधार
ఆధిరా	आधिरा
ఆధిరాఇ	आधिराइ
ఆధ్యా	आध्या
ఆనందీ	आनंदी
ఆనుష	आनुष
ఆబీర	आबीर
ఆభాస	आभास
ఆయనా	आयना
ఆరమాన	आरमान
ఆరాడ్యా	आराड्या
ఆరీవ	आरीव
ఆర్కశ	आर्कश
ఆర్థీ	आर्थी
ఆలాప	आलाप
ఆల్యా	आल्या
ఆవీ	आवी
ఆశిమ	आशिम
ఆస్రీతా	आस्रीता
ఆస్లుంనన	आस्लुंनन
ఇందుభూషణ	इंदुभूषण
ఇందుమతీ	इंदुमती
ఇందుముఖీ	इंदुमुखी
ఇందుశేఖర	इंदुशेखर
ఇతిశ్రీ	इतिश्री
ఇధా	इधा
ఇధికా	इधिका
ఇన్గనామ	इन्गनाम
ఇన్దారేశ	इन्दारेश
ఇన్దుదార	इन्दुदार
ఇన్దుబాలా	इन्दुबाला
ఇన్ద్రాణీ	इन्द्राणी
ఇన్ద్రేశ	इन्द्रेश
ఇయురేశ	इयुरेश
ఇలా	इला
ఇలావేనిల	इलावेनिल
ఇలాశ్పస్తీ	इलाश्पस्ती
ఇశానికా	इशानिका
ఇశాన్వీ	इशान्वी
ఇష్య	इष्य
ఇస్లేత	इस्लेत
ఈచ్ఛా	ईच्छा
ఈన్దుస	ईन्दुस
ఈశాంత	ईशांत
ఈశానపుత్ర	ईशानपुत्र
ఉగ్రేశ	उग्रेश
ఉజవణీ	उजवणी
ఉజీత్ర	उजीत्र
ఉజేశ	उजेश
ఉజ్జమ	उज्जम
ఉజ్జవాలా	उज्जवाला
ఉత్తల	उत्तल
ఉత్పర	उत्पर
ఉత్విక	उत्विक
ఉత్సర్గ	उत्सर्ग
ఉత్సుక	उत्सुक
ఉదయన	उदयन
ఉదయసూరియాఁ	उदयसूरियाँ
ఉదేయ	उदेय
ఉద్వాహనీ	उद्वाहनी
ఉధ్గీతా	उध्गीता
ఉపనయ	उपनय
ఉపాసనా	उपासना
ఉమాంపుత్ర	उमांपुत्र
ఉమికా	उमिका
ఉలగన	उलगन
ఉల్ముక	उल्मुक
ఉషాకిరణ	उषाकिरण
ఋచా	ऋचा
ఏకంశీ	एकंशी
ఏకలవ్య	एकलव्य
ఏకాంత	एकांत
ఏకాంతా	एकांता
ఏకాంతికా	एकांतिका
ఏకాత్మా	एकात्मा
ఏకావలీ	एकावली
ఏత్తన	एत्तन
ఏనక్షీ	एनक्षी
ఏరీన	एरीन
ఏలామరణ	एलामरण
ఏలావేన్ధన	एलावेन्धन
ఏలుమలాఈ	एलुमलाई
ఏవాంశీ	एवांशी
ఏశానికా	एशानिका
ఓఇశని	ओइशनि
ఓఈశీ	ओईशी
ఓజస్వీ	ओजस्वी
ఓజస్వీతా	ओजस्वीता
ఓజ్జస్వీన	ओज्जस्वीन
ఓప్పిలమణి	ओप्पिलमणि
ఓమలా	ओमला
ఓమాజా	ओमाजा
ఓమేసా	ओमेसा
ఓమ్దుత్త	ओम्दुत्त
ఓవీఏ	ओवीए
ఓశమాం	ओशमां
ఓహస	ओहस
కంగనా	कंगना
కంజ	कंज
కంధన	कंधन
కంశ	कंश
కజరీ	कजरी
కతకీ	कतकी
కథీర	कथीर
కథ్యనీ	कथ्यनी
కదంబన	कदंबन
కదంబీ	कदंबी
కనక	कनक
కనాహియా	कनाहिया
కనిక	कनिक
కనిశ్టా	कनिश्टा
కనీషా	कनीषा
కనుష	कनुष
కనైయా	कनैया
కన్కేయా	कन्केया
కన్తారవ	कन्तारव
కన్నన	कन्नन
కన్హైయా	कन्हैया
కపిల	कपिल
కమసంతక	कमसंतक
కమాన	कमान
కమాలబంధూ	कमालबंधू
కయాల్వీఝ్హీ	कयाल्वीझ्ही
కరబీ	करबी
కరమజీత	करमजीत
కరూణా	करूणा
కర్ణన	कर्णन
కర్తవయా	कर्तवया
కలాఈ	कलाई
కలానీతీ	कलानीती
కలోల	कलोल
కల్యాణీ	कल्याणी
కవి	कवि
కవీన్ద్ర	कवीन्द्र
కవీప్రనీతా	कवीप्रनीता
కవీయాసరీ	कवीयासरी
కవీరాసన	कवीरासन
కవీషా	कवीषा
కశీక	कशीक
కశ్నీ	कश्नी
కశ్మాంలమ	कश्मांलम
కస్లుంనీరా	कस्लुंनीरा
కహన	कहन
కహ్లీమాం	कह्लीमां
కాంచీ	कांची
కాంతవ	कांतव
కాంతా	कांता
కాంతామనీ	कांतामनी
కాంతి	कांति
కాకలీ	काकली
కాక్షీ	काक्षी
కాన్జీరా	कान्जीरा
కామేరీనా	कामेरीना
కారుం	कारुं
కార్తికేయన	कार्तिकेयन
కార్నిక	कार्निक
కాలిందీ	कालिंदी
కాలిత	कालित
కాలిదాస	कालिदास
కాలీ	काली
కాలీదాస	कालीदास
కావ్యరజ్సింహ	काव्यरज्सिंह
కావ్యా	काव्या
కాసనీ	कासनी
కిరాత	किरात
కేంగా	केंगा
కేఈశా	केईशा
కేతక	केतक
కేతవ	केतव
కేతాఘనీ	केताघनी
కేనాలీ	केनाली
కేనీత	केनीत
కేనీల	केनील
కేల్వీన	केल्वीन
కేవ్లీనా	केव्लीना
కేసరీనందన	केसरीनंदन
కేసవ	केसव
కేసవారాజ	केसवाराज
కైతవ	कैतव
కైశిక	कैशिक
కౌర్వాకీ	कौर्वाकी
ఖగేశ	खगेश
ఖాజిత	खाजित
ఖానామ	खानाम
ఖామారీ	खामारी
ఖాశ్వీ	खाश्वी
ఖుశీకా	खुशीका
ఖుశ్మీతా	खुश्मीता
ఖైలాశ	खैलाश
గంగవార	गंगवार
గంగోల	गंगोल
గందిరా	गंदिरा
గంధారా	गंधारा
గగనాసరీ	गगनासरी
గగ్నేశ	गग्नेश
గజగామినీ	गजगामिनी
గజరా	गजरा
గజలక్ష్మీ	गजलक्ष्मी
గజానన	गजानन
గతితా	गतिता
గత్రికా	गत्रिका
గదీన	गदीन
గధాధర	गधाधर
గన్గసీరువన	गन्गसीरुवन
గరిష్ట	गरिष्ट
గరుల	गरुल
గర్గ	गर्ग
గాథా	गाथा
గాయక	गायक
గిరీ	गिरी
గీతా సుహానీ	गीता सुहानी
గీరీచంద్ర	गीरीचंद्र
గీరీనాథ	गीरीनाथ
గీర్వేన	गीर्वेन
గీశుం	गीशुं
గుదాకేశ	गुदाकेश
గునవంత	गुनवंत
గునాలన	गुनालन
గునితా	गुनिता
గురశరణ	गुरशरण
గురురాజా	गुरुराजा
గృహ్యా	गृह्या
గేహనా	गेहना
గోఉరబ	गोउरब
గోకుల	गोकुल
గోదావరీ	गोदावरी
గోపాల	गोपाल
గోపీ	गोपी
గోబీకా	गोबीका
గోమాంథీ	गोमांथी
గోరల	गोरल
గోవీనేశ	गोवीनेश
గోవీన్దారాజ	गोवीन्दाराज
గోశీతా	गोशीता
గౌరీ	गौरी
గ్నాపీకా	ग्नापीका
గ్రంథిక	ग्रंथिक
గ్రహిత	ग्रहित
గ్రీతిక	ग्रीतिक
ఘటా	घटा
ఘనావీ	घनावी
ఘోరరుపా	घोररुपा
ఘోశీనీ	घोशीनी
ఘోషా	घोषा
ఘ్యాన	घ्यान
చందక	चंदक
చందనా లక్ష్మీ	चंदना लक्ष्मी
చంద్రకలా	चंद्रकला
చంద్రకాంత	चंद्रकांत
చంద్రకిశోర	चंद्रकिशोर
చంద్రమాం	चंद्रमां
చంద్రమౌలీ	चंद्रमौली
చంద్రలేక్షా	चंद्रलेक्षा
చంద్రహాస	चंद्रहास
చంద్రాయణ	चंद्रायण
చక్రిక	चक्रिक
చక్రికా	चक्रिका
చక్రియా	चक्रिया
చక్షస	चक्षस
చన్ద్రకేతు	चन्द्रकेतु
చన్ద్రజ్యోతీ	चन्द्रज्योती
చన్నాప్పా	चन्नाप्पा
చరణ  రాజ	चरण  राज
చరణరజ	चरणरज
చరీథా	चरीथा
చరులా	चरुला
చరుశీల	चरुशील
చాతీమాం	चातीमां
చాతుర్య	चातुर्य
చామీనీ	चामीनी
చారుతా	चारुता
చారుహస	चारुहस
చారుహాస	चारुहास
చాశ్ముమ	चाश्मुम
చాహనా	चाहना
చింతక	चिंतक
చింతా	चिंता
చిత్తప్రసాద	चित्तप्रसाद
చిత్రంశీ	चित्रंशी
చిత్రఅక్షాం	चित्रअक्षां
చిత్రకూట సమాంశ్రాయా	चित्रकूट समांश्राया
చిత్రబానా	चित्रबाना
చిత్రలేఖా	चित्रलेखा
చిత్రాంగీ	चित्रांगी
చిత్రాదీప	चित्रादीप
చిత్రాదేవీ	चित्रादेवी
చిత్రీనీ	चित्रीनी
చిన్మయానందా	चिन्मयानंदा
చిమాయీ	चिमायी
చీథాన్యలాథా	चीथान्यलाथा
చీనీత్య	चीनीत्य
చీన్నీః	चीन्नीः
చీరాన్తానా	चीरान्ताना
చేతన	चेतन
చేతన్దీప	चेतन्दीप
చేతన్సాఈ	चेतन्साई
చేథనా	चेथना
చేననా	चेनना
చేరన్రాజ	चेरन्राज
చేరాస్య	चेरास्य
చేష్టా	चेष्टा
చైతాలీ	चैताली
చైన	चैन
చైసరణ	चैसरण
జగజీత	जगजीत
జగతపాల	जगतपाल
జగనమోహన	जगनमोहन
జగనమోహినీ	जगनमोहिनी
జగ్రవీ	जग्रवी
జతన	जतन
జతాస్యా	जतास्या
జత్యా	जत्या
జనకనందినీ	जनकनंदिनी
జనావ	जनाव
జన్మయా	जन्मया
జప్తేశ	जप्तेश
జమునా	जमुना
జయకిరన	जयकिरन
జయప్రభా	जयप्रभा
జయలేన	जयलेन
జయాద్రాతా	जयाद्राता
జయాన్థ్య	जयान्थ्य
జరాసంధా	जरासंधा
జలధర	जलधर
జలస	जलस
జలార్క	जलार्क
జలీతా	जलीता
జవాస	जवास
జవాహరీ	जवाहरी
జశంక	जशंक
జసల	जसल
జసు	जसु
జసోదా	जसोदा
జస్మీథా	जस्मीथा
జస్మీథ్యా	जस्मीथ्या
జస్వందీ	जस्वंदी
జహానవీ	जहानवी
జహితా	जहिता
జహేన్కార	जहेन्कार
జాంసీ	जांसी
జాగృతి	जागृति
జాగేశ	जागेश
జాగ్రతి	जाग्रति
జాఝీమ	जाझीम
జానవీ	जानवी
జిఅనా	जिअना
జిగీషా	जिगीषा
జితేన్ద్రియ	जितेन्द्रिय
జిల్పా	जिल्पा
జీగాయాంశ	जीगायांश
జీజీద	जीजीद
జీజేశ	जीजेश
జీతాకమ	जीताकम
జీతేశ	जीतेश
జీనయ	जीनय
జీరల	जीरल
జీల	जील
జీవజ	जीवज
జీవానాన్ధామ	जीवानान्धाम
జీవిథా	जीविथा
జుఈ	जुई
జూహీ	जूही
జేఈనన	जेईनन
జేగన	जेगन
జేత్వీక	जेत्वीक
జేయాన్ద్రణ	जेयान्द्रण
జేలక్ష్మీ	जेलक्ष्मी
జేశన	जेशन
జేహాన్నాఝ	जेहान्नाझ
జైచంద	जैचंद
జైదిశ	जैदिश
జైదీశ	जैदीश
జైదేవ	जैदेव
జైలేణ	जैलेण
జ్ఞానవ	ज्ञानव
జ్ఞానా	ज्ञाना
జ్య భగవాన	ज्य भगवान
జ్యోతిబాలా	ज्योतिबाला
జ్యోత్సనీ	ज्योत्सनी
జ్హోశీల	ज्होशील
ఝంకృత	झंकृत
ఝరల	झरल
ఝినూక	झिनूक
ఝియాన	झियान
ఝేన్శీ	झेन्शी
ఝ్యాననీ	झ्याननी
టీనా	टीना
ఠాకరశీ	ठाकरशी
ఠుమకీ	ठुमकी
తంగసామీ	तंगसामी
తంగామనీ	तंगामनी
తక్షక	तक्षक
తనిష	तनिष
తనీశా	तनीशा
తనుం ప్రియా	तनुं प्रिया
తనుంజాశ్రీ	तनुंजाश्री
తనుపా	तनुपा
తనుశ్రీ	तनुश्री
తన్మయ	तन्मय
తమిరా	तमिरा
తమోఘ్నా	तमोघ्ना
తరాశా	तराशा
తరిత	तरित
తరుణ	तरुण
తరునా	तरुना
తరులతా	तरुलता
తరుశ్రీ	तरुश्री
తర్పనా	तर्पना
తర్లికా	तर्लिका
తస్మయ	तस्मय
తహేలీ	तहेली
తాక్ష్యా	ताक्ष्या
తానాయ్మీ	तानाय्मी
తానికా	तानिका
తానీగాఈ	तानीगाई
తానీసకా	तानीसका
తానులీప	तानुलीप
తానుసియా	तानुसिया
తాన్శ్రాయ	तान्श्राय
తాప్తీ	ताप्ती
తామాస్వినీ	तामास्विनी
తారకేశ	तारकेश
తారాక్ష	ताराक्ष
తారానీసేన	तारानीसेन
తారూశ	तारूश
తిమిన	तिमिन
తిరు	तिरु
తిరుపథీ	तिरुपथी
తీననీ	तीननी
తీరుమరణ	तीरुमरण
తుంష్యతీ	तुंष्यती
తుక్సా	तुक्सा
తునావా	तुनावा
తుపమ	तुपम
తుర్వీ	तुर्वी
తులసీలతా	तुलसीलता
తులికా	तुलिका
తులీ	तुली
తులీనదార	तुलीनदार
తుశారా	तुशारा
తుసరికా	तुसरिका
తేగవిర	तेगविर
తేజీ	तेजी
తేజేన్ద్ర	तेजेन्द्र
తేనుం	तेनुं
తేవాన	तेवान
తోయేశ	तोयेश
తోరుం	तोरुं
తౌతిక	तौतिक
తౌలీక	तौलीक
త్రిజగతి	त्रिजगति
త్రినాథ	त्रिनाथ
త్రిలోకేశ	त्रिलोकेश
త్రిలోచనా	त्रिलोचना
త్రిశల	त्रिशल
త్రిశులినీ	त्रिशुलिनी
త్రిషర	त्रिषर
త్రీజోయా	त्रीजोया
త్రీపుర్తి	त्रीपुर्ति
త్రీయోగ	त्रीयोग
త్రీవిదా	त्रीविदा
త్వరితా	त्वरिता
థంసీ	थंसी
థయా	थया
థార్సీన	थार्सीन
థీక్శీకా	थीक्शीका
థీనీథా	थीनीथा
థేజల	थेजल
థ్రీశంఠ	थ्रीशंठ
దందాపానీ	दंदापानी
దక్శీన్య	दक्शीन्य
దక్షిత	दक्षित
దక్షీణ	दक्षीण
దనీలా	दनीला
దన్యతా	दन्यता
దయానిధి	दयानिधि
దరరేన	दररेन
దరిద్రా ధావ్సీనీ	दरिद्रा धाव्सीनी
దరిద్రీయానాశీనీ	दरिद्रीयानाशीनी
దర్పిత	दर्पित
దర్మీనీ	दर्मीनी
దర్మేన్దర	दर्मेन्दर
దర్శనా	दर्शना
దర్శ్వానా	दर्श्वाना
దలపతి	दलपति
దలాపథీ	दलापथी
దల్శేర	दल्शेर
దహా	दहा
దానాస్వీ	दानास्वी
దానీశ	दानीश
దామినీ	दामिनी
దారుకా	दारुका
దిబసరీ	दिबसरी
దిబ్యా	दिब्या
దివీథా	दिवीथा
దిశీతా	दिशीता
దీక్శీకా	दीक्शीका
దీక్షానా	दीक्षाना
దీపక	दीपक
దీపథీ	दीपथी
దీపా లక్ష్మీ	दीपा लक्ष्मी
దీపాంశ	दीपांश
దీపేందు	दीपेंदु
దీప్తిమాన	दीप्तिमान
దేజ	देज
దేబజ్యోతీ	देबज्योती
దేబన్శీ	देबन्शी
దేబ్ప్రతిమ	देब्प्रतिम
దేబ్ప్రసాద	देब्प्रसाद
దేయాశీనీ	देयाशीनी
దేవకలీ	देवकली
దేవదత్తా	देवदत्ता
దేవదర్శన	देवदर्शन
దేవనారాయణ	देवनारायण
దేవమతి	देवमति
దేవాదార్స	देवादार्स
దేవాన్శీ	देवान्शी
దేవారహాల్లీ	देवारहाल्ली
దేవారీశీ	देवारीशी
దేవార్యా	देवार्या
దేవాశ్రీ	देवाश्री
దేవాస్మిథా	देवास्मिथा
దేవినా	देविना
దేవేశీ	देवेशी
దేవేసీ	देवेसी
దేవ్యశీ	देव्यशी
దేశనీ	देशनी
దేశిక	देशिक
దైపాయన	दैपायन
ధనాశ్రీ	धनाश्री
ధనాస్వీ	धनास्वी
ధనుస	धनुस
ధరనీ	धरनी
ధరమనిష్ఠ	धरमनिष्ठ
ధరానిశ	धरानिश
ధర్మజా	धर्मजा
ధర్మదాస	धर्मदास
ధర్మదేవ	धर्मदेव
ధర్శానీ	धर्शानी
ధర్శీనీ	धर्शीनी
ధర్శీనీకా	धर्शीनीका
ధవల	धवल
ధాన	धान
ధానశ్రీ	धानश्री
ధానీశ్కా	धानीश्का
ధామ	धाम
ధామన	धामन
ధారణా	धारणा
ధారనా	धारना
ధావక	धावक
ధీక్శీథా	धीक्शीथा
ధీయాన	धीयान
ధీవాశీనీ	धीवाशीनी
ధుమావతీ	धुमावती
ధూన	धून
ధృతి	धृति
ధేయాంశీ	धेयांशी
ధైర్యశీల	धैर्यशील
ధోశీనీ	धोशीनी
ధ్రాస్తీ	ध्रास्ती
నంద	नंद
నందలాల	नंदलाल
నందినీ	नंदिनी
నందీఘోష	नंदीघोष
నక్షాత్ర	नक्षात्र
నగరజన	नगरजन
నగా మాంల్లేస్వారీ	नगा मांल्लेस्वारी
నచికేతాస	नचिकेतास
నటరాజన	नटराजन
నభా	नभा
నభాన్యు	नभान्यु
నభోజ	नभोज
నమ్రతా	नम्रता
నరేన	नरेन
నరేన్దేర	नरेन्देर
నర్తానా	नर्ताना
నర్మద	नर्मद
నర్మదా	नर्मदा
నలినా	नलिना
నలేశ	नलेश
నవకార	नवकार
నవరాజ	नवराज
నవితా	नविता
నాగదాతా	नागदाता
నాగనాథ	नागनाथ
నాగరాజు	नागराजु
నాగేశ్వర	नागेश्वर
నాతాభైరవీ	नाताभैरवी
నాతేసన	नातेसन
నాధీనీ	नाधीनी
నాన్నాన	नान्नान
నామదేవ	नामदेव
నామాంనారాయనీ	नामांनारायनी
నామాంశీ	नामांशी
నామీశా	नामीशा
నారన	नारन
నారాయన	नारायन
నారీనే	नारीने
నావేతా	नावेता
నాహర	नाहर
నికేతా	निकेता
నిఖార	निखार
నిఖాల	निखाल
నితల	नितल
నిదాన	निदान
నిధ్యానా	निध्याना
నినాద	निनाद
నిమల	निमल
నిమేశ	निमेश
నిరంజనీ	निरंजनी
నిరాంత	निरांत
నిరాధార	निराधार
నిర్మళా	निर्मळा
నిలారూనా	निलारूना
నిలావోలీ	निलावोली
నిలీన	निलीन
నిశ్కా	निश्का
నిష్ణాం	निष्णां
నీకశ	नीकश
నీకాన్దర్య	नीकान्दर्य
నీకాశా	नीकाशा
నీకుంజా	नीकुंजा
నీక్కుం	नीक्कुं
నీఖేల	नीखेल
నీగీ	नीगी
నీచికా	नीचिका
నీధాన	नीधान
నీనీశా	नीनीशा
నీపునా	नीपुना
నీబోధీతా	नीबोधीता
నీభా	नीभा
నీమ్రిత	नीम्रित
నీరాలీ	नीराली
నీల కాంతా	नील कांता
నీలనీ	नीलनी
నీలమణి	नीलमणि
నీలాంజనా	नीलांजना
నీలాబ్జా	नीलाब्जा
నీలామ్బరీ	नीलाम्बरी
నీలేశ	नीलेश
నీవ	नीव
నీశ్రుతా	नीश्रुता
నీసమాం	नीसमां
నీహన	नीहन
నేదుమాన	नेदुमान
నేమీ	नेमी
నేమీశా	नेमीशा
నైంశీ	नैंशी
నైజా	नैजा
నైమాథ	नैमाथ
నైషా	नैषा
పంచావక్త్ర	पंचावक्त्र
పంధారీ	पंधारी
పద్మనాభ	पद्मनाभ
పద్మనాభా	पद्मनाभा
పద్మరేఖా	पद्मरेखा
పద్మల	पद्मल
పద్మలోచన	पद्मलोचन
పద్మాంనాభాన	पद्मांनाभान
పద్మాంనేత్ర	पद्मांनेत्र
పద్మాకలీ	पद्माकली
పద్మాక్షీ	पद्माक्षी
పద్మామ	पद्माम
పద్మారాజ	पद्माराज
పనితా	पनिता
పన్కీల	पन्कील
పన్కోజ	पन्कोज
పన్యశ్రీ	पन्यश्री
పమ్బా	पम्बा
పరణావీ	परणावी
పరబ్రహ్మనా	परब्रह्मना
పరమ-హంస	परम-हंस
పరమేశ్వరీ	परमेश्वरी
పరసమే	परसमे
పరాగ	पराग
పరాన్జయ	परान्जय
పరామితా	परामिता
పరిణీతా	परिणीता
పరీశుధ	परीशुध
పరు	परु
పరుశీ	परुशी
పర్తిక	पर्तिक
పర్వతీప్రిత	पर्वतीप्रित
పలానీచామ్య	पलानीचाम्य
పలాశకుసూమ	पलाशकुसूम
పల్లవిత	पल्लवित
పళవా	पळवा
పవనసుత	पवनसुत
పవీథా	पवीथा
పవీన	पवीन
పవీశ	पवीश
పవీశీకా	पवीशीका
పాండురంగ	पांडुरंग
పాగలావన	पागलावन
పాటవ	पाटव
పాణినీ	पाणिनी
పానీక	पानीक
పాయోధర	पायोधर
పారమితా	पारमिता
పారవాథీ	पारवाथी
పారిజాత	पारिजात
పార్థే	पार्थे
పావకీ	पावकी
పావలీన	पावलीन
పావానా	पावाना
పింగా	पिंगा
పినాకిన	पिनाकिन
పీఅల్లీ	पीअल्ली
పీయుశా	पीयुशा
పీరనీథా	पीरनीथा
పీహూ	पीहू
పూజా	पूजा
పూజిత	पूजित
పూనిశ	पूनिश
పూర్వికా	पूर्विका
పూర్వీ	पूर्वी
పేమల	पेमल
పోంనన	पोंनन
పోగులా	पोगुला
పోన్మాంలా	पोन्मांला
పోరోమాం	पोरोमां
పౌలోమీ	पौलोमी
ప్రకారనా	प्रकारना
ప్రగ్నీకా	प्रग्नीका
ప్రచీతా	प्रचीता
ప్రనాయా	प्रनाया
ప్రనావ్యా	प्रनाव्या
ప్రబంజన	प्रबंजन
ప్రబకరణ	प्रबकरण
ప్రభావ	प्रभाव
ప్రమ్లాతా	प्रम्लाता
ప్రహాసా	प्रहासा
ప్రాగీ	प्रागी
ప్రాచికా	प्राचिका
ప్రాణ	प्राण
ప్రానక	प्रानक
ప్రానల	प्रानल
ప్రాశా	प्राशा
ఫనిన్ద్రనాథ	फनिन्द्रनाथ
ఫాల్గున	फाल्गुन
ఫాల్గునీ	फाल्गुनी
ఫాల్యా	फाल्या
ఫుతికా	फुतिका
ఫూలమాలా	फूलमाला
ఫూలేందు	फूलेंदु
ఫేనిల	फेनिल
బటుక	बटुक
బద్రీ	बद्री
బద్రీనాథ	बद्रीनाथ
బనవారీ	बनवारी
బన్శిక	बन्शिक
బన్హీ	बन्ही
బబితా	बबिता
బరన	बरन
బరసాత	बरसात
బరిద	बरिद
బరున	बरुन
బలదేవ	बलदेव
బలప్రదా	बलप्रदा
బలరామ	बलराम
బలవీర	बलवीर
బల్మానీ	बल्मानी
బవిశ్యా	बविश्या
బాంకేబిహారీ	बांकेबिहारी
బాంసురీ	बांसुरी
బాల కృష్ణ	बाल कृष्ण
బాలక్రిష్నా	बालक्रिष्ना
బాలా	बाला
బాలారాజ	बालाराज
బాలారామ	बालाराम
బాలాశంకర	बालाशंकर
బాళ గణపతి	बाळ गणपति
బావరీ	बावरी
బావీన	बावीन
బిందియా	बिंदिया
బినీతా	बिनीता
బిమల	बिमल
బిమలా	बिमला
బిల్వా	बिल्वा
బీనాతా	बीनाता
బీన్కాల	बीन्काल
బీన్దేశ్వర	बीन्देश्वर
బీన్నీకేర	बीन्नीकेर
బీప్రా	बीप्रा
బీసలతా	बीसलता
బుధీప్రియా	बुधीप्रिया
బేకురీ	बेकुरी
బేథినా	बेथिना
బేలావార్ధానా	बेलावार्धाना
బ్రహ్మావతీ	ब्रह्मावती
బ్రీన్ధా	ब्रीन्धा
భక్తావాత్సలా	भक्तावात्सला
భక్తి	भक्ति
భగదిత్య	भगदित्य
భద్రీశా	भद्रीशा
భవాద	भवाद
భవ్య శ్రీ	भव्य श्री
భాగవాథ్య	भागवाथ्य
భాగేశ	भागेश
భాగ్యా	भाग्या
భానీశ	भानीश
భాన్ధవీ	भान्धवी
భాలేంద్ర	भालेंद्र
భావ	भाव
భావిన	भाविन
భావేశ్వారీ	भावेश्वारी
భావ్నీశ	भाव्नीश
భావ్యశ్రీ	भाव्यश्री
భాశ్వీనీ	भाश्वीनी
భాస్వన	भास्वन
భాస్వాథ	भास्वाथ
భిమేశ	भिमेश
భీఖీ	भीखी
భీమా	भीमा
భీలానగనా	भीलानगना
భీష్మ	भीष्म
భువనేశ్వరీ	भुवनेश्वरी
భువన్పతీ	भुवन्पती
భువేశ	भुवेश
భూతేశ్వర	भूतेश्वर
భూపేన్ద్ర	भूपेन्द्र
భూమత	भूमत
భూమిక	भूमिक
భూమీజా	भूमीजा
భోజరాజా	भोजराजा
భ్రమర	भ्रमर
భ్రిథీ	भ्रिथी
మంగలమూర్తి	मंगलमूर्ति
మంజుల	मंजुल
మంజులా	मंजुला
మందాకినీ	मंदाकिनी
మందాక్రాంతా	मंदाक्रांता
మణిశంకర	मणिशंकर
మదిర	मदिर
మదేశ	मदेश
మద్వాన	मद्वान
మధుప	मधुप
మధుపాల	मधुपाल
మధురానీ	मधुरानी
మధులా	मधुला
మధుశా	मधुशा
మధుసూదన	मधुसूदन
మనన	मनन
మనప	मनप
మనమోహన	मनमोहन
మనస్విన	मनस्विन
మనాగోబీనదా	मनागोबीनदा
మనీమ	मनीम
మనోమయ	मनोमय
మనోహర	मनोहर
మనోహరణ	मनोहरण
మన్మాయీ	मन्मायी
మన్విత	मन्वित
మన్వీర	मन्वीर
మల్లేశ	मल्लेश
మశీనీ	मशीनी
మహాయోగీన	महायोगीन
మహారావణమర్దానా	महारावणमर्दाना
మహాలీన్గమ	महालीन्गम
మహింద్రా	महिंद्रा
మహీథా	महीथा
మహేర	महेर
మహేశీ	महेशी
మహేశ్వర	महेश्वर
మాంగలీ	मांगली
మాంగేశ్వారీ	मांगेश्वारी
మాందవ	मांदव
మాంన్గ్గౌర్దీ	मांन्ग्गौर्दी
మాంన్జీరీ	मांन्जीरी
మాంన్దారికా	मांन्दारिका
మాంన్వితా	मांन्विता
మాంరుతాత్మాజా	मांरुतात्माजा
మాతంగీ	मातंगी
మాతన	मातन
మాధవిలతా	माधविलता
మాధుకేశ	माधुकेश
మాధుర్య	माधुर्य
మానధన	मानधन
మానీక్యా	मानीक्या
మాన్యసరీ	मान्यसरी
మాయుఖీ	मायुखी
మారూత	मारूत
మార్గీన	मार्गीन
మార్తండ	मार्तंड
మాలారవిలీ	मालारविली
మాసమాం	मासमां
మీనల	मीनल
మైత్రా	मैत्रा
మైనాలీ	मैनाली
మైనావీ	मैनावी
మైరవా	मैरवा
మౌలీశా	मौलीशा
యక్ష	यक्ष
యజత	यजत
యజుర్వ	यजुर्व
యతావన	यतावन
యత్నేశ	यत्नेश
యదు	यदु
యదుక్రిష్నా	यदुक्रिष्ना
యదునందన	यदुनंदन
యవనా	यवना
యశవర్ధన	यशवर्धन
యశికా	यशिका
యశ్వీ	यश्वी
యశ్శ్రీ	यश्श्री
యాజ్నా	याज्ना
యాతన	यातन
యాతనా	यातना
యాత్నీక	यात्नीक
యాత్వికా	यात्विका
యాదమమాం	यादममां
యాదీతా	यादीता
యాద్నేశ	याद्नेश
యామికా	यामिका
యాశీకా	याशीका
యాసస్వీ	यासस्वी
యుంగేన్దర	युंगेन्दर
యుగన్తీకా	युगन्तीका
యుగా	युगा
యుగీన	युगीन
యుధావ	युधाव
యుధీష్ఠీర	युधीष्ठीर
యుధ్ధ	युध्ध
యుయుత్సు	युयुत्सु
యువతీ	युवती
యువాసరీ	युवासरी
యుసు	युसु
యూరా	यूरा
యేక్షిత	येक्षित
యేఘరాజ	येघराज
యేశాస్వీనీ	येशास्वीनी
యేశ్మిత	येश्मित
యేస్వంఠ	येस्वंठ
యోగధీపా	योगधीपा
యోగలక్ష్మీ	योगलक्ष्मी
యోగా	योगा
యోగాజా	योगाजा
యోగానంద	योगानंद
యోగీ	योगी
యోగేశ్వర	योगेश्वर
యోగ్నవీ	योग्नवी
యోజనా	योजना
యోనితా	योनिता
యోనేన్ద్ర	योनेन्द्र
యోషిత	योषित
యోసనా	योसना
యోహ్శీనీ	योह्शीनी
రంగప్రసాత	रंगप्रसात
రంగరాజన	रंगराजन
రంగీత	रंगीत
రంజన	रंजन
రంజినీ	रंजिनी
రంహ	रंह
రక్త	रक्त
రక్తకమళ	रक्तकमळ
రక్తీమాం	रक्तीमां
రక్షాద	रक्षाद
రక్షావనరసంగథీనే	रक्षावनरसंगथीने
రగవార్శీనీ	रगवार्शीनी
రగిశ	रगिश
రగునాన్తన	रगुनान्तन
రజనీ	रजनी
రజిత	रजित
రజినిపతి	रजिनिपति
రజీనీ	रजीनी
రజీబ	रजीब
రజోఅబా	रजोअबा
రణబీర	रणबीर
రతనమ	रतनम
రత్నాలీ	रत्नाली
రత్నావలీ	रत्नावली
రత్న్ప్రీయా	रत्न्प्रीया
రథనా	रथना
రదీతే	रदीते
రబేక	रबेक
రమాంలీన్గమ	रमांलीन्गम
రమాంవితా	रमांविता
రమేశ్వరీ	रमेश्वरी
రర్నా	रर्ना
రవి కాన్త	रवि कान्त
రవిజ	रविज
రవిన్శు	रविन्शु
రవిశంకర	रविशंकर
రవిశరణ	रविशरण
రవీకిరణ	रवीकिरण
రవీచక్ర	रवीचक्र
రవీతేజా	रवीतेजा
రవీయంకీ	रवीयंकी
రవేన	रवेन
రశీల	रशील
రశేష	रशेष
రశ్వంత	रश्वंत
రసికా	रसिका
రాగ్వీనదార	राग्वीनदार
రాజ  కిరణ	राज  किरण
రాజతిలక	राजतिलक
రాజనాథ	राजनाथ
రాజన్య	राजन्य
రాజమ	राजम
రాజవంత	राजवंत
రాజసేకరణ	राजसेकरण
రాజహంసా	राजहंसा
రాజాథీ	राजाथी
రాజూ	राजू
రాజేంద్రమోహన	राजेंद्रमोहन
రాజేశ	राजेश
రాజ్వార్దన	राज्वार्दन
రాధనా	राधना
రాధేయ	राधेय
రాధ్యా	राध्या
రాబేన	राबेन
రామ  సేవక	राम  सेवक
రామచంద్ర	रामचंद्र
రామదాస	रामदास
రామనాథ	रामनाथ
రామనారాయణ	रामनारायण
రామమోహన	राममोहन
రావణ	रावण
రావలీ	रावली
రాశిమ	राशिम
రాష్పల	राष्पल
రాహనీ	राहनी
రాహుల	राहुल
రినీ	रिनी
రియా	रिया
రీఅనా	रीअना
రీతోమాం	रीतोमां
రీథానా	रीथाना
రీథీశా	रीथीशा
రీథేకా	रीथेका
రీథ్వీ	रीथ्वी
రీధుశనీ	रीधुशनी
రీపాంశీ	रीपांशी
రీశీప్రియా	रीशीप्रिया
రీశుం	रीशुं
రేఖా	रेखा
రేచల	रेचल
రేణు	रेणु
రేశమ	रेशम
రేశ్వింద	रेश्विंद
రౌశన	रौशन
ర్హియా	र्हिया
ల వేశ	ल वेश
లక్షన్య	लक्षन्य
లక్ష్మణ	लक्ष्मण
లక్ష్మీదేవీ	लक्ष्मीदेवी
లగాన	लगान
లజ్జా	लज्जा
లజ్జాన	लज्जान
లతికా	लतिका
లశీతా	लशीता
లాడలీ	लाडली
లాథీకా	लाथीका
లాభా	लाभा
లామ్బోధార	लाम्बोधार
లాయక	लायक
లారా	लारा
లాలాతక్షా	लालातक्षा
లావణ్య	लावण्य
లావానయ	लावानय
లావీత్ర	लावीत्र
లావీశ	लावीश
లాస్రీథా	लास्रीथा
లిబ్నీ	लिब्नी
లియన	लियन
లీకీలేశ	लीकीलेश
లీక్సీథా	लीक्सीथा
లీగ	लीग
లీన్సీ	लीन्सी
లీపికా	लीपिका
లీషణ	लीषण
లుకేశ	लुकेश
లేఈవీనా	लेईवीना
లేఖ	लेख
లేఖిత	लेखित
లేథీకా	लेथीका
లేమార	लेमार
లోఉకిక	लोउकिक
లోఉక్యీనీ	लोउक्यीनी
లోకరంజన	लोकरंजन
లోకాపుజ్య	लोकापुज्य
లోక్యా	लोक्या
లోమశ	लोमश
లోలా	लोला
లోవ్యమ	लोव्यम
లోశానా	लोशाना
లోహీతాక్ష	लोहीताक्ष
వంచిత	वंचित
వంచితా	वंचिता
వంశజా	वंशजा
వక్తి	वक्ति
వచన	वचन
వజ్రబాహూ	वज्रबाहू
వజ్రాకాయా	वज्राकाया
వజ్రాజిత	वज्राजित
వనజా	वनजा
వనినీ	वनिनी
వనియా	वनिया
వనీత	वनीत
వన్ధానా	वन्धाना
వయుజత	वयुजत
వయ్శీనీ	वय्शीनी
వరదావీనాయకా	वरदावीनायका
వరహీ	वरही
వరిన	वरिन
వరియాస	वरियास
వరునాగురుం	वरुनागुरुं
వరునాప్రియా	वरुनाप्रिया
వరునేశ	वरुनेश
వరేణ్య	वरेण्य
వరేన్ద్ర	वरेन्द्र
వరేసీఖ	वरेसीख
వర్చస	वर्चस
వర్ణికా	वर्णिका
వర్ధమాన	वर्धमान
వర్ధానీ	वर्धानी
వర్నీశా	वर्नीशा
వర్శనేయా	वर्शनेया
వర్శాల	वर्शाल
వర్శీద	वर्शीद
వర్ష	वर्ष
వర్షీత	वर्षीत
వర్షేనీ	वर्षेनी
వలాక	वलाक
వశీకరణ	वशीकरण
వశీతా	वशीता
వసవీ	वसवी
వసుదేవన	वसुदेवन
వాకుల	वाकुल
వాచాస్య	वाचास्य
వాత్సల్య	वात्सल्य
వాత్సల్రాజ	वात्सल्राज
వాదిశ	वादिश
వానాజక్ష	वानाजक्ष
వానిఏ	वानिए
వానుం	वानुं
వాన్శుల	वान्शुल
వాన్సీకా	वान्सीका
వామిల	वामिल
వామీకా	वामीका
వామ్నాయీ	वाम्नायी
వామ్శీథా	वाम्शीथा
వామ్సిధార	वाम्सिधार
వాయున	वायुन
వాయునా	वायुना
వారుణీ	वारुणी
వారునీ	वारुनी
వాల్లాకీ	वाल्लाकी
వాసన్తీ	वासन्ती
వాసుశ్రీ	वासुश्री
వాహీలా	वाहीला
వికీశా	विकीशा
విక్నేస్వారీ	विक्नेस्वारी
విజైతా	विजैता
విదీకా	विदीका
విదుషీ	विदुषी
విద్యాలక్ష్మీ	विद्यालक्ष्मी
వినతి	विनति
వినాపానీ	विनापानी
వినావాదీనీ	विनावादीनी
విన్ధుజా	विन्धुजा
విభాంశు	विभांशु
విభాత్సుం	विभात्सुं
విభావ	विभाव
విభావాసు	विभावासु
విభిశానా ప్రతీశ్త్తాత్రే	विभिशाना प्रतीश्त्तात्रे
విరాజు	विराजु
విరాస్వామ్య	विरास्वाम्य
విలాసితా	विलासिता
విహారికా	विहारिका
వీక్షా	वीक्षा
వీణాధారీ	वीणाधारी
వీహా	वीहा
వేక్శనా	वेक्शना
వేద ఆర్యన	वेद आर्यन
వేదవల్లీ	वेदवल्ली
వేదవ్రతా	वेदव्रता
వేదీష	वेदीष
వేనీధర	वेनीधर
వేనుం గోపాల	वेनुं गोपाल
వేనుమాధవ	वेनुमाधव
వేన్కాత్రమణ	वेन्कात्रमण
వేన్కాత్శీవా	वेन्कात्शीवा
వేర్నీకా	वेर्नीका
వైకుంఠ నాథ	वैकुंठ नाथ
వైజయీ	वैजयी
వైదిక	वैदिक
వైద్యుంత	वैद्युंत
వైధవీక	वैधवीक
వైధాఈ	वैधाई
వైనావీ	वैनावी
శక్తిధార్య	शक्तिधार्य
సంకీతా	संकीता
సంగత	संगत
సంగ్రామ	संग्राम
సంచాయా	संचाया
సంచాలీ	संचाली
సంజన	संजन
సంజయా	संजया
సంజితా	संजिता
సంజీతీ	संजीती
సంజీథా	संजीथा
సంతయానీ	संतयानी
సందతా	संदता
సందీప	संदीप
సందీపన	संदीपन
సందీపేన	संदीपेन
సంబిత	संबित
సంయోగితా	संयोगिता
సంవిధా	संविधा
సంహిత	संहित
సంహితా	संहिता
సఈ దిపక	सई दिपक
సకలేశ్వర	सकलेश्वर
సకుంజ	सकुंज
సకేశ	सकेश
సగుణ	सगुण
సగునా	सगुना
సచంద్ర	सचंद्र
సచ్చిత	सच्चित
సచ్చిదానందా	सच्चिदानंदा
సదా	सदा
సదా శివమ	सदा शिवम
సదానంద	सदानंद
సదాశివ	सदाशिव
సద్గుణ	सद्गुण
సనత	सनत
సనల	सनल
సనాతనా	सनातना
సనావ్య	सनाव्य
సనీత	सनीत
సన్థీమాంథీ	सन्थीमांथी
సన్నిధి	सन्निधि
సపనా దేవీ	सपना देवी
సప్తోమీ	सप्तोमी
సబ్రేశ	सब्रेश
సమరేందు	समरेंदु
సమర్థ	समर्थ
సమవర్త	समवर्त
సమాంర్ధ	समांर्ध
సమితా	समिता
సమీన	समीन
సమీరన	समीरन
సమీసా	समीसा
సముదాయ	समुदाय
సమృద్ధి	समृद्धि
సమ్ప్రీతీ	सम्प्रीती
సమ్ప్రీయా	सम्प्रीया
సమ్ముద	सम्मुद
సమ్రీధా	सम्रीधा
సమ్వీథ	सम्वीथ
సరసతీ	सरसती
సరస్వతీ	सरस्वती
సరీగా	सरीगा
సర్బానీ	सर्बानी
సహస్త్రజిత	सहस्त्रजित
సహ్తోష	सह्तोष
సాఈ కార్తిక	साई कार्तिक
సాఈ కుమారీ	साई कुमारी
సాఈ జీవధరా	साई जीवधरा
సాఈ వాణీ	साई वाणी
సాఈ శ్రీ	साई श्री
సాకేథా	साकेथा
సాక్షీన	साक्षीन
సాత్విక	सात्विक
సాధవ	साधव
సానందనా	सानंदना
సాబరీఏశ	साबरीएश
సామిల	सामिल
సాయన	सायन
సారణీ	सारणी
సాలేనా	सालेना
సాహస్రాంజలి	साहस्रांजलि
సైచారణ	सैचारण
సైనా	सैना
సైలేశ్వర	सैलेश्वर
సైశా	सैशा
హంశల	हंशल
హక్ష	हक्ष
హటీశ	हटीश
హనసీకా	हनसीका
హనార్వీన	हनार्वीन
హనిశ	हनिश
హన్శీతా	हन्शीता
హమసాదీపికా	हमसादीपिका
హమీర	हमीर
హమ్సలేఖా	हम्सलेखा
హయాగ్రివ	हयाग्रिव
హయాతీ	हयाती
హరమ్యా	हरम्या
హరిఅక్సా	हरिअक्सा
హరికా	हरिका
హరిగోపాల	हरिगोपाल
హరిత	हरित
హరిదాస	हरिदास
హరిన	हरिन
హరినా	हरिना
హరినాక్షీ	हरिनाक्षी
హరియాన	हरियान
హరిశంకర	हरिशंकर
హరిహర పుత్ర	हरिहर पुत्र
హరీ నారాయణ	हरी नारायण
హర్యక్ష	हर्यक्ष
హర్యాక్షా	हर्याक्षा
హర్ష	हर्ष
హర్షవర్దన	हर्षवर्दन
హర్షిత	हर्षित
హర్స్వీతా	हर्स्वीता
హవన	हवन
హవీసా	हवीसा
హసీనా	हसीना
హసుం	हसुं
హార్శీనీ	हार्शीनी
హావీషా	हावीषा
హితాంశీ	हितांशी
హితాంశు	हितांशु
హిన్దవీ	हिन्दवी
హిన్ధావీ	हिन्धावी
హిమంత రాజ	हिमंत राज
హిమాంవార్శీకా	हिमांवार्शीका
హిమాంసేఖర	हिमांसेखर
హిమాన	हिमान
హిమావత	हिमावत
హిమీశా	हिमीशा
హిరణ	हिरण
హిరుధాయా	हिरुधाया
హిశేతా	हिशेता
హీతా	हीता
హీమాంవాథీ	हीमांवाथी
హీరకనీ	हीरकनी
హృషీకేశ	हृषीकेश
హేఇఅన	हेइअन
హేనీల	हेनील
హేమ	हेम
హేమ లథా	हेम लथा
హేమకాంతా	हेमकांता
హేమచంద్రా	हेमचंद्रा
హేమన	हेमन
హేమా	हेमा
హేమాంతి	हेमांति
హేమీతా	हेमीता
హేమ్నందన	हेम्नंदन
హైమాం	हैमां
హోనేయ్షా	होनेय्षा
హ్రదయ	ह्रदय
హ్రిదయఆంశు	ह्रिदयआंशु
హ్రీథీకా	ह्रीथीका
హ్రీయాన	ह्रीयान
హ్రీశా	ह्रीशा
హ్రీషిత	ह्रीषित
#
#
# Territory names from CLDR
ఎసెషన్ దీవి	ऎसॆषन् दीवि
అండొర్రా	अंडॊर्रा
యునైటెడ్ అరబ్ ఎమిరేట్స్	युनैटॆड् अरब् ऎमिरेट्स्
ఆఫ్ఘనిస్తాన్	आफ्घनिस्तान्
ఆంటిగ్వా మరియు బార్బుడా	आंटिग्वा मरियु बार्बुडा
ఆంగవిల్లా	आंगविल्ला
అల్బేనియా	अल्बेनिया
ఆర్మేనియా	आर्मेनिया
అంగోలా	अंगोला
అంటార్కటికా	अंटार्कटिका
అర్జెంటీనా	अर्जॆंटीना
అమెరికన్ సమోవా	अमॆरिकन् समोवा
ఆస్ట్రియా	आस्ट्रिया
ఆస్ట్రేలియా	आस्ट्रेलिया
అరుబా	अरुबा
ఆలేండ్ దీవులు	आलेंड् दीवुलु
అజర్బైజాన్	अजर्बैजान्
బోస్నియా మరియు హెర్జెగొవీనా	बोस्निया मरियु हॆर्जॆगॊवीना
బార్బడోస్	बार्बडोस्
బంగ్లాదేశ్	बंग्लादेश्
బెల్జియం	बॆल्जियं
బుర్కినా ఫాసో	बुर्किना फासो
బల్గేరియా	बल्गेरिया
బహ్రెయిన్	बह्रॆयिन्
బురుండి	बुरुंडि
బెనిన్	बॆनिन्
సెంట్ బర్తేలెమీ	सॆंट् बर्तेलॆमी
బెర్ముడా	बॆर्मुडा
బ్రూనై	ब्रूनै
బొలీవియా	बॊलीविया
కరీబియన్ నెదర్లాండ్స్	करीबियन् नॆदर्लांड्स्
బ్రెజిల్	ब्रॆजिल्
బహామాస్	बहामास्
భూటాన్	भूटान्
బొవెట్ దీవి	बॊवॆट् दीवि
బోట్స్వానా	बोट्स्वाना
బెలారస్	बॆलारस्
బెలిజ్	बॆलिज्
కెనడా	कॆनडा
కోకోస్ (కీలింగ్) దీవులు	कोकोस् (कीलिंग्) दीवुलु
కాంగో- కిన్షాసా	कांगो- किन्षासा
కాంగో (DRC)	कांगो (DRC)
సెంట్రల్ ఆఫ్రికన్ రిపబ్లిక్	सॆंट्रल् आफ्रिकन् रिपब्लिक्
కాంగో- బ్రాజావిల్లి	कांगो- ब्राजाविल्लि
కాంగో (రిపబ్లిక్)	कांगो (रिपब्लिक्)
స్విట్జర్లాండ్	स्विट्जर्लांड्
ఐవరీ కోస్ట్	ऐवरी कोस्ट्
కుక్ దీవులు	कुक् दीवुलु
చిలీ	चिली
కామెరూన్	कामॆरून्
చైనా	चैना
కొలంబియా	कॊलंबिया
క్లిప్పర్టన్ దీవి	क्लिप्पर्टन् दीवि
కోస్టా రికా	कोस्टा रिका
క్యూబా	क्यूबा
కేప్ వెర్డే	केप् वॆर्डे
కురాకవో	कुराकवो
క్రిస్మస్ దీవి	क्रिस्मस् दीवि
సైప్రస్	सैप्रस्
చెక్ రిపబ్లిక్	चॆक् रिपब्लिक्
జర్మనీ	जर्मनी
డియాగో గార్సియా	डियागो गार्सिया
జిబౌటి	जिबौटि
డెన్మార్క్	डॆन्मार्क्
డోమెనిక	डोमॆनिक
డొమెనికన్ రిపబ్లిక్	डॊमॆनिकन् रिपब्लिक्
అల్జీరియా	अल्जीरिया
స్యూటా మరియు మెలిల్లా	स्यूटा मरियु मॆलिल्ला
ఈక్వడార్	ईक्वडार्
ఎస్టోనియా	ऎस्टोनिया
ఈజిప్ట్	ईजिप्ट्
పడమటి సహారా	पडमटि सहारा
ఎరిట్రియా	ऎरिट्रिया
స్పెయిన్	स्पॆयिन्
ఇథియోపియా	इथियोपिया
యురోపియన్ యునియన్	युरोपियन् युनियन्
ఫిన్లాండ్	फिन्लांड्
ఫిజీ	फिजी
ఫాక్‌ల్యాండ్ దీవులు	फाक्‌ल्यांड् दीवुलु
ఫాక్‌ల్యాండ్ దీవులు (ఇస్లాస్ మాల్వినాస్)	फाक्‌ल्यांड् दीवुलु (इस्लास् माल्विनास्)
మైక్రోనేశియ	मैक्रोनेशिय
ఫారో దీవులు	फारो दीवुलु
ఫ్రాన్స్‌	फ्रान्स्‌
గాబన్	गाबन्
యునైటెడ్ కింగ్‌డమ్	युनैटॆड् किंग्‌डम्
గ్రెనెడా	ग्रॆनॆडा
జార్జియా	जार्जिया
ఫ్రెంచ్ గియానా	फ्रॆंच् गियाना
గ్వేర్నసే	ग्वेर्नसे
ఘనా	घना
జిబ్రాల్టార్	जिब्राल्टार्
గ్రీన్‌లాండ్	ग्रीन्‌लांड्
గాంబియా	गांबिया
గినియా	गिनिया
గ్వాడేలోప్	ग्वाडेलोप्
ఈక్వటోరియల్ గినియా	ईक्वटोरियल् गिनिया
గ్రీస్	ग्रीस्
దక్షిణ జార్జియా &amp; దక్షిణ శాండ్విచ్ దీవులు	दक्षिण जार्जिया &amp; दक्षिण शांड्विच् दीवुलु
గ్వాటిమాల	ग्वाटिमाल
గ్వామ్	ग्वाम्
గినియా-బిస్సావ్	गिनिया-बिस्साव्
గయానా	गयाना
హాంకాంగ్ ఎస్ఏఆర్ చైనా	हांकांग् ऎस्एआर् चैना
హాంకాంగ్	हांकांग्
హెర్డ్ &amp; మెక్ డొనాల్డ్ దీవులు	हॆर्ड् &amp; मॆक् डॊनाल्ड् दीवुलु
హోండురాస్	होंडुरास्
క్రోయేషియా	क्रोयेषिया
హైటి	हैटि
హంగేరీ	हंगेरी
కేనరీ దీవులు	केनरी दीवुलु
ఇండోనేషియా	इंडोनेषिया
ఐర్లాండ్	ऐर्लांड्
ఇజ్రాయిల్	इज्रायिल्
ఐల్ ఆఫ్ మాన్	ऐल् आफ् मान्
భారత దేశం	भारत देशं
బ్రిటీష్ భారతీయ సముద్రపు ప్రాంతం	ब्रिटीष् भारतीय समुद्रपु प्रांतं
ఇరాక్	इराक्
ఇరాన్	इरान्
ఐస్లాండ్	ऐस्लांड्
ఇటలీ	इटली
జెర్సీ	जॆर्सी
జమైకా	जमैका
జోర్డాన్	जोर्डान्
జపాన్	जपान्
కెన్యా	कॆन्या
కిర్గిజిస్తాన్	किर्गिजिस्तान्
కంబోడియా	कंबोडिया
కిరిబాటి	किरिबाटि
కొమొరోస్	कॊमॊरोस्
సెంట్ కిట్ట్స్ మరియు నెవిస్	सॆंट् किट्ट्स् मरियु नॆविस्
ఉత్తర కొరియా	उत्तर कॊरिया
దక్షిణ కొరియా	दक्षिण कॊरिया
కువైట్	कुवैट्
కేమాన్ దీవులు	केमान् दीवुलु
కజకస్తాన్	कजकस्तान्
లావోస్	लावोस्
లెబనాన్	लॆबनान्
సెంట్ లూసియా	सॆंट् लूसिया
లిక్టెస్టేన్	लिक्टॆस्टेन्
శ్రీలంక	श्रीलंक
లైబీరియా	लैबीरिया
లెసోతో	लॆसोतो
లిథువేనియా	लिथुवेनिया
లక్సంబర్గ్	लक्संबर्ग्
లాత్వియా	लात्विया
లిబియా	लिबिया
మొరాక్కో	मॊराक्को
మొనాకో	मॊनाको
మోల్డోవా	मोल्डोवा
మోంటేనేగ్రో	मोंटेनेग्रो
సెంట్ మార్టిన్	सॆंट् मार्टिन्
మడగాస్కర్	मडगास्कर्
మార్షల్ దీవులు	मार्षल् दीवुलु
మేసిడోనియా	मेसिडोनिया
మేసిడోనియా (FYROM)	मेसिडोनिया (FYROM)
మాలి	मालि
మయన్మార్ (బర్మా)	मयन्मार् (बर्मा)
మంగోలియా	मंगोलिया
మాకావ్ ఎస్ఏఆర్ చైనా	माकाव् ऎस्एआर् चैना
మకావు	मकावु
ఉత్తర మరియానా దీవులు	उत्तर मरियाना दीवुलु
మార్టినిక్	मार्टिनिक्
మౌరిటేనియా	मौरिटेनिया
మోంట్సేర్రాట్	मोंट्सेर्राट्
మాల్టా	माल्टा
మారిషస్	मारिषस्
మాల్దీవులు	माल्दीवुलु
మాలావి	मालावि
మెక్సికో	मॆक्सिको
మలేషియా	मलेषिया
మొజాంబిక్	मॊजांबिक्
నమీబియా	नमीबिया
క్రొత్త కాలెడోనియా	क्रॊत्त कालॆडोनिया
నైజర్	नैजर्
నార్ఫాక్ దీవి	नार्फाक् दीवि
నైజీరియా	नैजीरिया
నికరాగువా	निकरागुवा
నెదర్లాండ్స్	नॆदर्लांड्स्
నార్వే	नार्वे
నేపాల్	नेपाल्
నౌరు	नौरु
నియు	नियु
న్యూజిలాండ్	न्यूजिलांड्
ఒమన్	ऒमन्
పనామా	पनामा
పెరూ	पॆरू
ఫ్రెంచ్ పోలినిషియా	फ्रॆंच् पोलिनिषिया
పాపువా న్యు గినియా	पापुवा न्यु गिनिया
ఫిలిప్పీన్స్	फिलिप्पीन्स्
పాకిస్తాన్	पाकिस्तान्
పోలాండ్	पोलांड्
సెంట్ పియెర్ మరియు మికెలాన్	सॆंट् पियॆर् मरियु मिकॆलान्
పిట్‌కెయిర్న్ దీవులు	पिट्‌कॆयिर्न् दीवुलु
ఫ్యూర్టో రికో	फ्यूर्टो रिको
పాలస్తీనియన్ ప్రాంతాలు	पालस्तीनियन् प्रांतालु
పాలస్తీనా	पालस्तीना
పోర్చుగల్	पोर्चुगल्
పలావు	पलावु
పరాగ్వే	पराग्वे
కతర్	कतर्
ఒషీనియా బయటున్నవి	ऒषीनिया बयटुन्नवि
రియూనియన్	रियूनियन्
రోమానియా	रोमानिया
సెర్బియా	सॆर्बिया
రష్యా	रष्या
రువాండా	रुवांडा
సౌదీ అరేబియా	सौदी अरेबिया
సోలమన్ దీవులు	सोलमन् दीवुलु
సీషెల్స్	सीषॆल्स्
సూడాన్	सूडान्
స్వీడన్	स्वीडन्
సింగపూర్	सिंगपूर्
సెంట్ హెలినా	सॆंट् हॆलिना
స్లోవేనియా	स्लोवेनिया
స్వాల్బార్డ్ మరియు యాన్ మాయేన్	स्वाल्बार्ड् मरियु यान् मायेन्
స్లోవేకియా	स्लोवेकिया
సియెర్రా లియాన్	सियॆर्रा लियान्
సాన్ మారినో	सान् मारिनो
సెనెగల్	सॆनॆगल्
సోమాలియా	सोमालिया
సురినామ్	सुरिनाम्
దక్షిణ సూడాన్	दक्षिण सूडान्
సావోటోమ్ మరియు ప్రిన్సిపే	सावोटोम् मरियु प्रिन्सिपे
ఎల్ సాల్వడోర్	ऎल् साल्वडोर्
సింట్ మార్టెన్	सिंट् मार्टॆन्
సిరియా	सिरिया
స్వాజిల్యాండ్	स्वाजिल्यांड्
ట్రిస్టన్ డ కన్హా	ट्रिस्टन् ड कन्हा
తుర్క్ మరియు కాలికోస్ దీవులు	तुर्क् मरियु कालिकोस् दीवुलु
చాద్	चाद्
ఫ్రెంచ్ దక్షిణ ప్రాంతాలు	फ्रॆंच् दक्षिण प्रांतालु
టోగో	टोगो
థాయిలాండ్	थायिलांड्
తజికిస్తాన్	तजिकिस्तान्
టోకేలావ్	टोकेलाव्
టిమోర్-లెస్టె	टिमोर्-लॆस्टॆ
తూర్పు తైమూర్	तूर्पु तैमूर्
తుర్కమేనిస్తాన్	तुर्कमेनिस्तान्
ట్యునీషియా	ट्युनीषिया
టోంగా	टोंगा
టర్కీ	टर्की
ట్రినిడాడ్ మరియు టొబాగో	ट्रिनिडाड् मरियु टॊबागो
టువాలు	टुवालु
తైవాన్	तैवान्
టాంజానియా	टांजानिया
ఉక్రెయిన్	उक्रॆयिन्
ఉగాండా	उगांडा
సంయుక్త రాజ్య అమెరికా బయట ఉన్న దీవులు	संयुक्त राज्य अमॆरिका बयट उन्न दीवुलु
అమెరికా సంయుక్త రాష్ట్రాలు	अमॆरिका संयुक्त राष्ट्रालु
ఉరుగువే	उरुगुवे
ఉజ్బెకిస్తాన్	उज्बॆकिस्तान्
వాటికన్ నగరం	वाटिकन् नगरं
సెంట్ విన్సెంట్ మరియు గ్రెనడీన్స్	सॆंट् विन्सॆंट् मरियु ग्रॆनडीन्स्
వెనుజువేలా	वॆनुजुवेला
బ్రిటిష్ వర్జిన్ దీవులు	ब्रिटिष् वर्जिन् दीवुलु
వియత్నాం	वियत्नां
వనాటు	वनाटु
వాలిస్ మరియు ఫ్యుత్యునా	वालिस् मरियु फ्युत्युना
సమోవా	समोवा
కొసోవో	कॊसोवो
యెమెన్	यॆमॆन्
మాయొట్టి	मायॊट्टि
దక్షిణ ఆఫ్రికా	दक्षिण आफ्रिका
జాంబియా	जांबिया
జింబాబ్వే	जिंबाब्वे
తెలియని ప్రాంతం	तॆलियनि प्रांतं
