# Baby names
ಅಕಾರ್ಯಸುತಾ	ਅਕਾਰ੍ਯਸੁਤਾ
ಅಕ್ಶಿತೀ	ਅਕ੍ਸ਼ਿਤੀ
ಅಕ್ಷಥಾ	ਅਕ੍ਸ਼ਥਾ
ಅಕ್ಷೀ	ਅਕ੍ਸ਼ੀ
ಅಗ್ನಿಜ್ವಾಳಾ	ਅਗ੍ਨਿਜ੍ਵਾਲਾ
ಅಗ್ರತಾ	ਅਗ੍ਰਤਾ
ಅಘನ್ಯ	ਅਘਨ੍ਯ
ಅಚ್ಯುತಾನ	ਅਚ੍ਯੁਤਾਨ
ಅಜಸ್ಥಾ	ਅਜਸ੍ਥਾ
ಅದವೈಕಾ	ਅਦਵੈਕਾ
ಅದಾಮ	ਅਦਾਮ
ಅದಿಥಾ	ਅਦਿਥਾ
ಅದೀಕ್ಯಾ	ਅਦੀਕ੍ਯਾ
ಅದೀತೀಯ	ਅਦੀਤੀਯ
ಅದ್ರಿತಾ	ਅਦ੍ਰਿਤਾ
ಅದ್ರಿಯನ	ਅਦ੍ਰਿਯਨ
ಅದ್ರೀಶ	ਅਦ੍ਰੀਸ਼
ಅದ್ಶಯಾ	ਅਦ੍ਸ਼ਯਾ
ಅಧರ್ಷ	ਅਧਰ੍ਸ਼
ಅಧಾವನ	ਅਧਾਵਨ
ಅಧಿನೀ	ਅਧਿਨੀ
ಅಧ್ಯುತ	ਅਧ੍ਯੁਤ
ಅಧ್ರೀತಾ	ਅਧ੍ਰੀਤਾ
ಅನಿಯಾ	ਅਨਿਯਾ
ಅಬೀನಂದಾ	ਅਬੀਨੰਦਾ
ಅಬೀರಾಮ	ਅਬੀਰਾਮ
ಅಬೀಶ	ਅਬੀਸ਼
ಅಬೀಸೇಶನ	ਅਬੀਸੇਸ਼ਨ
ಅಬ್ಜಾಯೋನೀ	ਅਬ੍ਜਾਯੋਨੀ
ಅಬ್ಬೀರ	ਅਬ੍ਬੀਰ
ಅಭರಾಮ	ਅਭਰਾਮ
ಅಭಿಜನ	ਅਭਿਜਨ
ಅಭಿಜ್ಞಾ	ਅਭਿਜ੍ਞਾ
ಅಭಿಜ್ಞಾನ	ਅਭਿਜ੍ਞਾਨ
ಅಭಿನಾ	ਅਭਿਨਾ
ಅಭಿನಿವೇಶ	ਅਭਿਨਿਵੇਸ਼
ಅಭಿನುಂ	ਅਭਿਨੁਂ
ಅಭಿಮ	ਅਭਿਮ
ಅಭಿರಾತ	ਅਭਿਰਾਤ
ಅಭಿರುಚಿ	ਅਭਿਰੁਚਿ
ಅಭಿರುಪಾ	ਅਭਿਰੁਪਾ
ಅಭಿಷೇಕ	ਅਭਿਸ਼ੇਕ
ಅಭಿಹೀತಾ	ਅਭਿਹੀਤਾ
ಅಭೀಕರ್ಷ	ਅਭੀਕਰ੍ਸ਼
ಅಭೀಜೀಥ	ਅਭੀਜੀਥ
ಅಭೀದೀ	ਅਭੀਦੀ
ಅಭೀಧಾ	ਅਭੀਧਾ
ಅಭೀಪುಜ	ਅਭੀਪੁਜ
ಅಭೀಶ್ರೇಯ	ਅਭੀਸ਼੍ਰੇਯ
ಅಭೀಸಿರಾತ	ਅਭੀਸਿਰਾਤ
ಅಭ್ಯುದಯ	ਅਭ੍ਯੁਦਯ
ಅಭ್ರಕಾಸಿನ	ਅਭ੍ਰਕਾਸਿਨ
ಅಸಿರಾ	ਅਸਿਰਾ
ಅಹಂಕಾರಾ	ਅਹੰਕਾਰਾ
ಅಹ್ರ್ಮ್ಶುಲ್ಲಾ	ਅਹ੍ਰ੍ਮ੍ਸ਼ੁਲ੍ਲਾ
ಅಹ್ಲಾದಾಜನನೀ	ਅਹ੍ਲਾਦਾਜਨਨੀ
ಆಕರ್ಷಕ	ਆਕਰ੍ਸ਼ਕ
ಆತಿಶ	ਆਤਿਸ਼
ಆದರ್ಶಾ	ਆਦਰ੍ਸ਼ਾ
ಆದಿನಾಥ	ਆਦਿਨਾਥ
ಆದಿಪುರುಷ	ਆਦਿਪੁਰੁਸ਼
ಆದ್ಯಾ	ਆਦ੍ਯਾ
ಆಧಿರಾ	ਆਧਿਰਾ
ಆಧಿರಾಇ	ਆਧਿਰਾਇ
ಆಧೀರೇನ	ਆਧੀਰੇਨ
ಆನಂದತಾ	ਆਨੰਦਤਾ
ಆನಂದಿತ	ਆਨੰਦਿਤ
ಆನೀಕ	ਆਨੀਕ
ಆನೀಕಾ	ਆਨੀਕਾ
ಆಪೇಕ್ಷಾ	ਆਪੇਕ੍ਸ਼ਾ
ಆಭಾತ	ਆਭਾਤ
ಆಯಾಂಶ	ਆਯਾਂਸ਼
ಆಯುಷ	ਆਯੁਸ਼
ಆಯುಸ	ਆਯੁਸ
ಆರಾತ್ರಿಕಾ	ਆਰਾਤ੍ਰਿਕਾ
ಆರಾಥನಾ	ਆਰਾਥਨਾ
ಆರಾಧಕ	ਆਰਾਧਕ
ಆರೀವ	ਆਰੀਵ
ಆರುನ್ಯ	ਆਰੁਨ੍ਯ
ಆರೋಹೀ	ਆਰੋਹੀ
ಆರ್ಜವ	ਆਰ੍ਜਵ
ಆರ್ನವ	ਆਰ੍ਨਵ
ಆರ್ಪಿತ	ਆਰ੍ਪਿਤ
ಆರ್ಯಮನ	ਆਰ੍ਯਮਨ
ಆರ್ಯವೀರ	ਆਰ੍ਯਵੀਰ
ಆಲೋಕಾ	ਆਲੋਕਾ
ಆವೀಶ	ਆਵੀਸ਼
ಆಸರಾ	ਆਸਰਾ
ಆಸ್ಯಾ	ਆਸ੍ਯਾ
ಆಹಾನ	ਆਹਾਨ
ಆಹ್ನೀಕ	ਆਹ੍ਨੀਕ
ಇಂದುಕಲಾ	ਇਂਦੁਕਲਾ
ಇಂದುಲಾಲಾ	ਇਂਦੁਲਾਲਾ
ಇತಿಶ್ರೀ	ਇਤਿਸ਼੍ਰੀ
ಇನೀಯನ	ਇਨੀਯਨ
ಇನ್ದೀವರ	ਇਨ੍ਦੀਵਰ
ಇನ್ದುಕಾಂತಾ	ਇਨ੍ਦੁਕਾਂਤਾ
ಇನ್ದುಜ	ਇਨ੍ਦੁਜ
ಇನ್ದುದಾರ	ਇਨ੍ਦੁਦਾਰ
ಇನ್ದುಶ್ರೀ	ਇਨ੍ਦੁਸ਼੍ਰੀ
ಇನ್ದ್ರಕಾಂತಾ	ਇਨ੍ਦ੍ਰਕਾਂਤਾ
ಇನ್ದ್ರಜಿತ	ਇਨ੍ਦ੍ਰਜਿਤ
ಇನ್ದ್ರದತ್ತ	ਇਨ੍ਦ੍ਰਦਤ੍ਤ
ಇನ್ದ್ರವದನ	ਇਨ੍ਦ੍ਰਵਦਨ
ಇನ್ಧು	ਇਨ੍ਧੁ
ಇಯಲೀಸಾಈ	ਇਯਲੀਸਾਈ
ಇಯ್ಯಾಪ್ಪನ	ਇਯ੍ਯਾਪ੍ਪਨ
ಇರಾವತೀ	ਇਰਾਵਤੀ
ಇರೇಶ	ਇਰੇਸ਼
ಇಶೀ	ਇਸ਼ੀ
ಇಸಕೀ	ਇਸਕੀ
ಇಸೀತಾ	ਇਸੀਤਾ
ಈನ್ದುಸ	ਈਨ੍ਦੁਸ
ಈರಾವಾಜ	ਈਰਾਵਾਜ
ಈಲಾಕ್ಕೀಯಾ	ਈਲਾਕ੍ਕੀਯਾ
ಈಶಾನಾ	ਈਸ਼ਾਨਾ
ಈಶುಕ	ਈਸ਼ੁਕ
ಈಶ್ತರ	ਈਸ਼੍ਤਰ
ಈಶ್ವರದತ್ತ	ਈਸ਼੍ਵਰਦਤ੍ਤ
ಈಹಮ	ਈਹਮ
ಉಜೇಶ	ਉਜੇਸ਼
ಉಜ್ಜಾನಿನೀ	ਉਜ੍ਜਾਨਿਨੀ
ಉಜ್ವಳ	ਉਜ੍ਵਲ
ಉಜ್ಹಾಲಾ	ਉਜ੍ਹਾਲਾ
ಉತ್ಕರ್ಷ	ਉਤ੍ਕਰ੍ਸ਼
ಉತ್ಕರ್ಷಾ	ਉਤ੍ਕਰ੍ਸ਼ਾ
ಉತ್ತಮ	ਉਤ੍ਤਮ
ಉತ್ತಿಯಾ	ਉਤ੍ਤਿਯਾ
ಉತ್ಪಲ	ਉਤ੍ਪਲ
ಉತ್ಪಲಾಕ್ಷ	ਉਤ੍ਪਲਾਕ੍ਸ਼
ಉತ್ಪಲಾಭಾ	ਉਤ੍ਪਲਾਭਾ
ಉದಯಾ	ਉਦਯਾ
ಉದಾರ್ಚೀಸ	ਉਦਾਰ੍ਚੀਸ
ಉದಾರ್ಶ	ਉਦਾਰ੍ਸ਼
ಉದೇಯ	ਉਦੇਯ
ಉದ್ದೀಪ	ਉਦ੍ਦੀਪ
ಉಧವ	ਉਧਵ
ಉಧ್ಗೀತಾ	ਉਧ੍ਗੀਤਾ
ಉನ್ಮಾ	ਉਨ੍ਮਾ
ಉಪಂಗ	ਉਪੰਗ
ಉಪನಂದಾ	ਉਪਨੰਦਾ
ಉಪನಾಯಿಕ	ਉਪਨਾਯਿਕ
ಉಪಮನ್ಯು	ਉਪਮਨ੍ਯੁ
ಉಪಮಾ	ਉਪਮਾ
ಉಪಲ	ਉਪਲ
ಉಪಾಂಶು	ਉਪਾਂਸ਼ੁ
ಉಫ್ತಮ	ਉਫ੍ਤਮ
ಉಮೇದ	ਉਮੇਦ
ಉರವಶೀ	ਉਰਵਸ਼ੀ
ಉರುಗಾಯ	ਉਰੁਗਾਯ
ಉರ್ಜೀತಾ	ਉਰ੍ਜੀਤਾ
ಉರ್ಮಿಲ	ਉਰ੍ਮਿਲ
ಉರ್ಮಿಲಾ	ਉਰ੍ਮਿਲਾ
ಉಲಗಾಪ್ಪನ	ਉਲਗਾਪ੍ਪਨ
ಉಲ್ಕಾ	ਉਲ੍ਕਾ
ಉಲ್ಕೇಶ	ਉਲ੍ਕੇਸ਼
ಉಲ್ಲಾಸಿತ	ਉਲ੍ਲਾਸਿਤ
ಉಲ್ಲಾಸೀಥಾ	ਉਲ੍ਲਾਸੀਥਾ
ಉಷಾ	ਉਸ਼ਾ
ಉಷ್ಮಾ	ਉਸ਼੍ਮਾ
ಉಸ್ಲುಂನನ	ਉਸ੍ਲੁਂਨਨ
ಋತಿಕಾ	ਰਿਤਿਕਾ
ಏಈರಮ	ਏਈਰਮ
ಏಕತಾ	ਏਕਤਾ
ಏಕನ್ಷಾ	ਏਕਨ੍ਸ਼ਾ
ಏಕೇಸ್ವಾರ	ਏਕੇਸ੍ਵਾਰ
ಏಕ್ವಿರಾ	ਏਕ੍ਵਿਰਾ
ಏಲಾವೇನ್ಧನ	ਏਲਾਵੇਨ੍ਧਨ
ಏಲೀಲೀ	ਏਲੀਲੀ
ಏಲೇಥಿಯಾ	ਏਲੇਥਿਯਾ
ಏವರಜ	ਏਵਰਜ
ಏಶಾನಿಕಾ	ਏਸ਼ਾਨਿਕਾ
ಏಸ್ವರದೀತ್ಯ	ਏਸ੍ਵਰਦੀਤ੍ਯ
ಏಹೀತ	ਏਹੀਤ
ಐನ್ಗೀನೀ	ਐਨ੍ਗੀਨੀ
ಐಷಾ	ਐਸ਼ਾ
ಓಜಸ್ವಿನೀ	ਓਜਸ੍ਵਿਨੀ
ಓಜಸ್ವೀ	ਓਜਸ੍ਵੀ
ಓಜಸ್ವೀತಾ	ਓਜਸ੍ਵੀਤਾ
ಓನೀರ	ਓਨੀਰ
ಓಮಕಾರ	ਓਮਕਾਰ
ಓಮಕಾರೀ	ਓਮਕਾਰੀ
ಓಮನಾ	ਓਮਨਾ
ಓರಿಓನ	ਓਰਿਓਨ
ಓವೀನ	ਓਵੀਨ
ಓಶೀನ	ਓਸ਼ੀਨ
ಔಶಿಗ	ਔਸ਼ਿਗ
ಕಂಠ	ਕੰਠ
ಕಂಠನ	ਕੰਠਨ
ಕಟರೀನಾ	ਕਟਰੀਨਾ
ಕತಾನ	ਕਤਾਨ
ಕತಾವ್ಯಾ	ਕਤਾਵ੍ਯਾ
ಕಥ್ಯನೀ	ਕਥ੍ਯਨੀ
ಕನಕ	ਕਨਕ
ಕನಕಾಬತೀ	ਕਨਕਾਬਤੀ
ಕನೀಜಾ	ਕਨੀਜਾ
ಕನ್ವಕ	ਕਨ੍ਵਕ
ಕಪಾಲಿನೀ	ਕਪਾਲਿਨੀ
ಕಪೀಲೇಶ	ਕਪੀਲੇਸ਼
ಕಮಲಕಾಂತ	ਕਮਲਕਾਂਤ
ಕಮಲನಾಥ	ਕਮਲਨਾਥ
ಕಮಲಾ ಸಮಭಾವ	ਕਮਲਾ ਸਮਭਾਵ
ಕಮಲಾಕ್ಷೀ	ਕਮਲਾਕ੍ਸ਼ੀ
ಕಯಾಲ್ವೀಝ್ಹೀ	ਕਯਾਲ੍ਵੀਝ੍ਹੀ
ಕಯೋಶ	ਕਯੋਸ਼
ಕರನ	ਕਰਨ
ಕರಾಲಾ	ਕਰਾਲਾ
ಕರುನಾಕರ	ਕਰੁਨਾਕਰ
ಕರ್ತೀಗಾ	ਕਰ੍ਤੀਗਾ
ಕರ್ತೀಶಾ	ਕਰ੍ਤੀਸ਼ਾ
ಕಲರನೀ	ਕਲਰਨੀ
ಕಲಹನ	ਕਲਹਨ
ಕಲಾಧರ	ਕਲਾਧਰ
ಕಲಾಪಕ	ਕਲਾਪਕ
ಕಲಾಪಿನೀ	ਕਲਾਪਿਨੀ
ಕಲಾಸಾವೇರೀ	ਕਲਾਸਾਵੇਰੀ
ಕಲ್ಪಕ	ਕਲ੍ਪਕ
ಕಲ್ಪಿತಾ	ਕਲ੍ਪਿਤਾ
ಕಲ್ಪೇಶ	ਕਲ੍ਪੇਸ਼
ಕವನೀ	ਕਵਨੀ
ಕವಿತ	ਕਵਿਤ
ಕಶ್ವೀ	ਕਸ਼੍ਵੀ
ಕಸ್ತುರ	ਕਸ੍ਤੁਰ
ಕಾಂಚನಾ	ਕਾਂਚਨਾ
ಕಾಂವ	ਕਾਂਵ
ಕಾದಮ್ಬಿನೀ	ਕਾਦਮ੍ਬਿਨੀ
ಕಾನನಬಾಲಾ	ਕਾਨਨਬਾਲਾ
ಕಾನಾಕಾದರೀ	ਕਾਨਾਕਾਦਰੀ
ಕಾನೀತಾ	ਕਾਨੀਤਾ
ಕಾನೀನ	ਕਾਨੀਨ
ಕಾನೀಶ್ಕಾರ	ਕਾਨੀਸ਼੍ਕਾਰ
ಕಾನುಶೀ	ਕਾਨੁਸ਼ੀ
ಕಾನ್ಚಾನಾಧ್ವಾಜಾ	ਕਾਨ੍ਚਾਨਾਧ੍ਵਾਜਾ
ಕಾಮಮಾಂ	ਕਾਮਮਾਂ
ಕಾಮಾ	ਕਾਮਾ
ಕಾಮೇರೀನಾ	ਕਾਮੇਰੀਨਾ
ಕಾಮೇಶ್ವರೀ	ਕਾਮੇਸ਼੍ਵਰੀ
ಕಾಯಲವಿಲೀ	ਕਾਯਲਵਿਲੀ
ಕಾರುಣ್ಯ	ਕਾਰੁਣ੍ਯ
ಕಾರುಣ್ಯ ಪ್ರಕಾಶ	ਕਾਰੁਣ੍ਯ ਪ੍ਰਕਾਸ਼
ಕಾರೂಕಾ	ਕਾਰੂਕਾ
ಕಾರ್ತಿಕೇಯನ	ਕਾਰ੍ਤਿਕੇਯਨ
ಕಾರ್ತೇಕೇಯಾ	ਕਾਰ੍ਤੇਕੇਯਾ
ಕಾಲಿದಾಸ	ਕਾਲਿਦਾਸ
ಕಾಲಿಮೋಹನ	ਕਾਲਿਮੋਹਨ
ಕಾವ್ಯನ	ਕਾਵ੍ਯਨ
ಕಾವ್ಯಶ್ರೀ	ਕਾਵ੍ਯਸ਼੍ਰੀ
ಕಾವ್ಯಸ್ರೀ	ਕਾਵ੍ਯਸ੍ਰੀ
ಕಾಷ್ಠ	ਕਾਸ਼੍ਠ
ಕಿಂಜಲ	ਕਿਂਜਲ
ಕೀಅರಾ	ਕੀਅਰਾ
ಕೇತನ	ਕੇਤਨ
ಕೇಯಾ	ਕੇਯਾ
ಕೇಲಾಕಾ	ਕੇਲਾਕਾ
ಕೇವಲ	ਕੇਵਲ
ಕೇಶೀ	ਕੇਸ਼ੀ
ಕೇಸರೀಸುತ	ਕੇਸਰੀਸੁਤ
ಕೇಸವಾ	ਕੇਸਵਾ
ಕೇಸವಾರಾಜ	ਕੇਸਵਾਰਾਜ
ಕೈರವ	ਕੈਰਵ
ಕೈಲಾಶಅಧಿಪತಿ	ਕੈਲਾਸ਼ਅਧਿਪਤਿ
ಕೌಶಿಕಾ	ਕੌਸ਼ਿਕਾ
ಕೌಸುಧೀ	ਕੌਸੁਧੀ
ಕೌಸ್ತುಭೀ	ਕੌਸ੍ਤੁਭੀ
ಖಗೇನ್ದ್ರ	ਖਗੇਨ੍ਦ੍ਰ
ಖನಕ	ਖਨਕ
ಖನಿಕಾ	ਖਨਿਕਾ
ಖಾಜಿತ	ਖਾਜਿਤ
ಖುಜಾರಾ	ਖੁਜਾਰਾ
ಖುಶ್ಬೂ	ਖੁਸ਼੍ਬੂ
ಗಂಗಜ	ਗੰਗਜ
ಗಂಧರ್ವವಿದ್ಯಾ	ਗੰਧਰ੍ਵਵਿਦ੍ਯਾ
ಗಜಗಾಮಿನೀ	ਗਜਗਾਮਿਨੀ
ಗಜಪತಿ	ਗਜਪਤਿ
ಗಜರಾಜ	ਗਜਰਾਜ
ಗಜಾಧರ	ਗਜਾਧਰ
ಗಣಕ	ਗਣਕ
ಗಣಪತ	ਗਣਪਤ
ಗಣಿತಾ	ਗਣਿਤਾ
ಗಣ್ಯಾ	ਗਣ੍ਯਾ
ಗತಿತಾ	ਗਤਿਤਾ
ಗನಾಕ್ಷೀ	ਗਨਾਕ੍ਸ਼ੀ
ಗನೇಂದ್ರ	ਗਨੇਂਦ੍ਰ
ಗನ್ಗವಾಥೀ	ਗਨ੍ਗਵਾਥੀ
ಗರವೀ	ਗਰਵੀ
ಗರಿಮಾ	ਗਰਿਮਾ
ಗರ್ಜನ	ਗਰ੍ਜਨ
ಗರ್ವಿತ	ਗਰ੍ਵਿਤ
ಗರ್ವಿತಾ	ਗਰ੍ਵਿਤਾ
ಗಹನಾ	ਗਹਨਾ
ಗಾಥಾ	ਗਾਥਾ
ಗಾವ್ಯಾ	ਗਾਵ੍ਯਾ
ಗಿರಾ	ਗਿਰਾ
ಗಿರಿಕ	ਗਿਰਿਕ
ಗಿರಿಜಾನಂದನ	ਗਿਰਿਜਾਨੰਦਨ
ಗಿರ್ವಾನ	ਗਿਰ੍ਵਾਨ
ಗೀರೀಚಂದ್ರ	ਗੀਰੀਚੰਦ੍ਰ
ಗೀರ್ವೇನ	ਗੀਰ੍ਵੇਨ
ಗೀಸೇಲೇ	ਗੀਸੇਲੇ
ಗುನವಂತೀ	ਗੁਨਵੰਤੀ
ಗುನಾರತ್ನಾ	ਗੁਨਾਰਤ੍ਨਾ
ಗುನಾವತೀ	ਗੁਨਾਵਤੀ
ಗುನಾಸೇಕರಣ	ਗੁਨਾਸੇਕਰਣ
ಗುನೀತ	ਗੁਨੀਤ
ಗುನ್ಜೀತಾ	ਗੁਨ੍ਜੀਤਾ
ಗುನ್ದಾಪಾ	ਗੁਨ੍ਦਾਪਾ
ಗುನ್ರೇಖಾ	ਗੁਨ੍ਰੇਖਾ
ಗುರುದೂತ್ತ	ਗੁਰੁਦੂਤ੍ਤ
ಗುರುಬಚನ	ਗੁਰੁਬਚਨ
ಗುರುರಾಜ	ਗੁਰੁਰਾਜ
ಗುಲಜಾರೀಲಾಲ	ਗੁਲਜਾਰੀਲਾਲ
ಗುಲಮೋಹರ	ਗੁਲਮੋਹਰ
ಗುಲ್ಜನ	ਗੁਲ੍ਜਨ
ಗುಹಾನ	ਗੁਹਾਨ
ಗೇಶನಾ	ਗੇਸ਼ਨਾ
ಗೋಕೀಲಾ	ਗੋਕੀਲਾ
ಗೋತಮ	ਗੋਤਮ
ಗೋಮಾಂಥೀ	ਗੋਮਾਂਥੀ
ಗೋಮ್ಯಾಸರೀ	ਗੋਮ੍ਯਾਸਰੀ
ಗೋವಿಂದಾ	ਗੋਵਿਂਦਾ
ಗೋವಿನ್ದೀ	ਗੋਵਿਨ੍ਦੀ
ಗೋವೀನೇಶ	ਗੋਵੀਨੇਸ਼
ಘನಾವೀ	ਘਨਾਵੀ
ಚಂಚಾರೀಕ	ਚੰਚਾਰੀਕ
ಚಂಡಮುಂಡವಿನಾಶಿನೀ	ਚੰਡਮੁਂਡਵਿਨਾਸ਼ਿਨੀ
ಚಂದನಾ	ਚੰਦਨਾ
ಚಂದಸರೀ	ਚੰਦਸਰੀ
ಚಂದ್ರಕಂತೀ	ਚੰਦ੍ਰਕੰਤੀ
ಚಂದ್ರಕಾಂತ	ਚੰਦ੍ਰਕਾਂਤ
ಚಂದ್ರಕೀ	ਚੰਦ੍ਰਕੀ
ಚಂದ್ರಕೀರ್ತೀ	ਚੰਦ੍ਰਕੀਰ੍ਤੀ
ಚಂದ್ರಚುರ	ਚੰਦ੍ਰਚੁਰ
ಚಂದ್ರಥಾ	ਚੰਦ੍ਰਥਾ
ಚಂದ್ರನ್ಶುಂ	ਚੰਦ੍ਰਨ੍ਸ਼ੁਂ
ಚಂದ್ರಮುಖೀ	ਚੰਦ੍ਰਮੁਖੀ
ಚಂದ್ರರಾಜ	ਚੰਦ੍ਰਰਾਜ
ಚಂದ್ರಲೇಕ್ಷಾ	ਚੰਦ੍ਰਲੇਕ੍ਸ਼ਾ
ಚಂದ್ರಿಮಾ	ਚੰਦ੍ਰਿਮਾ
ಚಂದ್ರು	ਚੰਦ੍ਰੁ
ಚಂಧು	ਚੰਧੁ
ಚಕೋರೀ	ਚਕੋਰੀ
ಚಕ್ರಾಹೀಂ	ਚਕ੍ਰਾਹੀਂ
ಚಕ್ಷಸ	ਚਕ੍ਸ਼ਸ
ಚತುರ್ಬಹಾವೇ	ਚਤੁਰ੍ਬਹਾਵੇ
ಚನ್ದ್ರಜ್ಯೋತಿ	ਚਨ੍ਦ੍ਰਜ੍ਯੋਤਿ
ಚನ್ದ್ರವದನ	ਚਨ੍ਦ੍ਰਵਦਨ
ಚನ್ದ್ರಸಹೋದಾರೀ	ਚਨ੍ਦ੍ਰਸਹੋਦਾਰੀ
ಚರುಲಾ	ਚਰੁਲਾ
ಚಾತುರ್ಯ	ਚਾਤੁਰ੍ਯ
ಚಾನಾಸ್ಯಾ	ਚਾਨਾਸ੍ਯਾ
ಚಾನ್ದಿನೀ	ਚਾਨ੍ਦਿਨੀ
ಚಾನ್ನಕ್ಕಾ	ਚਾਨ੍ਨਕ੍ਕਾ
ಚಾಯನಾ	ਚਾਯਨਾ
ಚಾರುದತ್ತ	ਚਾਰੁਦਤ੍ਤ
ಚಾರುಪ್ರಭಾ	ਚਾਰੁਪ੍ਰਭਾ
ಚಾರ್ವೀ	ਚਾਰ੍ਵੀ
ಚಿಂತ್ಯಾ	ਚਿਂਤ੍ਯਾ
ಚಿತಾಯು	ਚਿਤਾਯੁ
ಚಿತ್ತರಂಜನೀ	ਚਿਤ੍ਤਰੰਜਨੀ
ಚಿತ್ತಸ್ವರೂಪ	ਚਿਤ੍ਤਸ੍ਵਰੂਪ
ಚಿತ್ತೇಶ	ਚਿਤ੍ਤੇਸ਼
ಚಿತ್ರಂಶ	ਚਿਤ੍ਰੰਸ਼
ಚಿತ್ರಕುನ್ಧಾಲಾ	ਚਿਤ੍ਰਕੁਨ੍ਧਾਲਾ
ಚಿತ್ರಬಾನಾ	ਚਿਤ੍ਰਬਾਨਾ
ಚಿತ್ರಾದೇವೀ	ਚਿਤ੍ਰਾਦੇਵੀ
ಚಿತ್ರಾನೀ	ਚਿਤ੍ਰਾਨੀ
ಚಿತ್ರೀನೀ	ਚਿਤ੍ਰੀਨੀ
ಚಿದಂಬರಮ	ਚਿਦੰਬਰਮ
ಚಿದಾನಂದಾ	ਚਿਦਾਨੰਦਾ
ಚಿನಾರ	ਚਿਨਾਰ
ಚೀನ್ಕಲ	ਚੀਨ੍ਕਲ
ಚೀನ್ನಾಮಾಂಸ್ತೀಕಾ	ਚੀਨ੍ਨਾਮਾਂਸ੍ਤੀਕਾ
ಚೀನ್ನೀಃ	ਚੀਨ੍ਨੀ
ಚೇತಕ	ਚੇਤਕ
ಚೇತನ್ದೀಪ	ਚੇਤਨ੍ਦੀਪ
ಚೈತ್ರಯೇಶ	ਚੈਤ੍ਰਯੇਸ਼
ಚೋಲನ	ਚੋਲਨ
ಛೋಟು	ਛੋਟੁ
ಜಗತವೀರ	ਜਗਤਵੀਰ
ಜಗದಬಂದು	ਜਗਦਬੰਦੁ
ಜಗ್ವೀರ	ਜਗ੍ਵੀਰ
ಜನತಾ	ਜਨਤਾ
ಜನೀಶಾ	ਜਨੀਸ਼ਾ
ಜನ್ಮೇಶ	ਜਨ੍ਮੇਸ਼
ಜಪೇಶ	ਜਪੇਸ਼
ಜಪ್ತೇಶ	ਜਪ੍ਤੇਸ਼
ಜಬಿನೇ	ਜਬਿਨੇ
ಜಮಾಂದಾಗ್ನ್ಯ ಮಹಾದಾರ್ಪಾ	ਜਮਾਂਦਾਗ੍ਨ੍ਯ ਮਹਾਦਾਰ੍ਪਾ
ಜಯ ಪ್ರಕಾಶ	ਜਯ ਪ੍ਰਕਾਸ਼
ಜಯಂತಾ	ਜਯੰਤਾ
ಜಯಚಂದ	ਜਯਚੰਦ
ಜಯಪ್ರಭಾ	ਜਯਪ੍ਰਭਾ
ಜಯಾ ಕುಮಾರೀ	ਜਯਾ ਕੁਮਾਰੀ
ಜಯಾಕೀರ್ಥೀ	ਜਯਾਕੀਰ੍ਥੀ
ಜಯಾಸಂಕರ	ਜਯਾਸੰਕਰ
ಜಯೀನ	ਜਯੀਨ
ಜಯೇನ್ದ್ರ	ਜਯੇਨ੍ਦ੍ਰ
ಜಯ್ಮೀನೀ	ਜਯ੍ਮੀਨੀ
ಜಲಜ	ਜਲਜ
ಜಲದ	ਜਲਦ
ಜಲಧೀಜಾ	ਜਲਧੀਜਾ
ಜಲಾರ್ಕ	ਜਲਾਰ੍ਕ
ಜಲ್ಪೂರ್ನಾ	ਜਲ੍ਪੂਰ੍ਨਾ
ಜವಾಹರೀ	ਜਵਾਹਰੀ
ಜಶವಂತ	ਜਸ਼ਵੰਤ
ಜಶೋದಾ	ਜਸ਼ੋਦਾ
ಜಶ್ಮೀನಾ	ਜਸ਼੍ਮੀਨਾ
ಜಸಜೀತ	ਜਸਜੀਤ
ಜಸಬೀರ	ਜਸਬੀਰ
ಜಸಮಿತ	ਜਸਮਿਤ
ಜಸರಾಜ	ਜਸਰਾਜ
ಜಸವೀರ	ਜਸਵੀਰ
ಜಸೀಮಾ	ਜਸੀਮਾ
ಜಸ್ಕೀರಿತ	ਜਸ੍ਕੀਰਿਤ
ಜಸ್ಮಿಕಾ	ਜਸ੍ਮਿਕਾ
ಜಸ್ಮೀಥ್ಯಾ	ਜਸ੍ਮੀਥ੍ਯਾ
ಜಹನಕ	ਜਹਨਕ
ಜಾಂಸೀ	ਜਾਂਸੀ
ಜಾಗ	ਜਾਗ
ಜಾಗವೀ	ਜਾਗਵੀ
ಜಾಗೃತಿ	ਜਾਗਤਿ
ಜಾನಕೀಭೂಷಣ	ਜਾਨਕੀਭੂਸ਼ਣ
ಜಾನಕೀರಮನ	ਜਾਨਕੀਰਮਨ
ಜಾನಾ	ਜਾਨਾ
ಜಾನ್ವೀ	ਜਾਨ੍ਵੀ
ಜಾಪಕ	ਜਾਪਕ
ಜಾಹೀ	ਜਾਹੀ
ಜಿಜ್ಞಾಸಾ	ਜਿਜ੍ਞਾਸਾ
ಜಿತೇನ್ದ್ರಿಯ	ਜਿਤੇਨ੍ਦ੍ਰਿਯ
ಜಿಶ್ನು	ਜਿਸ਼੍ਨੁ
ಜೀಗೇನ	ਜੀਗੇਨ
ಜೀಜ್ಞಾಶಾ	ਜੀਜ੍ਞਾਸ਼ਾ
ಜೀತನ	ਜੀਤਨ
ಜೀತಾಕಮ	ਜੀਤਾਕਮ
ಜೀತಾವಾರಆಶಯೇ	ਜੀਤਾਵਾਰਆਸ਼ਯੇ
ಜೀನ್ದಾಲ	ਜੀਨ੍ਦਾਲ
ಜೀಯಾಂಶೀ	ਜੀਯਾਂਸ਼ੀ
ಜೀವೀ	ਜੀਵੀ
ಜೀಶನಾ	ਜੀਸ਼ਨਾ
ಜೇನ್ನಯ	ਜੇਨ੍ਨਯ
ಜೇಯಾನ್ದ್ರಣ	ਜੇਯਾਨ੍ਦ੍ਰਣ
ಜೇರ್ರೀಷ	ਜੇਰ੍ਰੀਸ਼
ಜೇರ್ಶೀಕಾ	ਜੇਰ੍ਸ਼ੀਕਾ
ಜೈಚಾನ್ದ್ರಣ	ਜੈਚਾਨ੍ਦ੍ਰਣ
ಜೈನ	ਜੈਨ
ಜೈಸಲ	ਜੈਸਲ
ಜೈಹಾಸೀನೀ	ਜੈਹਾਸੀਨੀ
ಜೋಸ್ಯಾ	ਜੋਸ੍ਯਾ
ಜ್ಞಾನದೇವ	ਜ੍ਞਾਨਦੇਵ
ಜ್ಞಾನಾ	ਜ੍ਞਾਨਾ
ಜ್ಞಾನಾಲ	ਜ੍ਞਾਨਾਲ
ಜ್ಞಾನೇಶ್ವರೀ	ਜ੍ਞਾਨੇਸ਼੍ਵਰੀ
ಜ್ಯೋತಿರ್ಮೋಯೀ	ਜ੍ਯੋਤਿਰ੍ਮੋਯੀ
ಜ್ಯೋತಿಷಮತಿ	ਜ੍ਯੋਤਿਸ਼ਮਤਿ
ಜ್ಯೋಥೀರ್ಮಾಈ	ਜ੍ਯੋਥੀਰ੍ਮਾਈ
ಜ್ಹಂಕರ	ਜ੍ਹੰਕਰ
ಜ್ಹಿಲ	ਜ੍ਹਿਲ
ಝರಲ	ਝਰਲ
ಝವಿಯನ	ਝਵਿਯਨ
ಝಾರಾ	ਝਾਰਾ
ಝೀಣೀ	ਝੀਣੀ
ಝೇನೀತ	ਝੇਨੀਤ
ಝೇನೀಶಾ	ਝੇਨੀਸ਼ਾ
ಝ್ಯನಾ	ਝ੍ਯਨਾ
ಟಿಮ್ಮೀ	ਟਿਮ੍ਮੀ
ಠುಮಕೀ	ਠੁਮਕੀ
ಠುಮರೀ	ਠੁਮਰੀ
ಡಿಮ್ಪೀ	ਡਿਮ੍ਪੀ
ತಂಗವೇಲ	ਤੰਗਵੇਲ
ತಂತ್ರ	ਤੰਤ੍ਰ
ತಂಸೀ	ਤੰਸੀ
ತಕ್ಶೀಲ	ਤਕ੍ਸ਼ੀਲ
ತಜಜ್ಞ	ਤਜਜ੍ਞ
ತಜಸರೀ	ਤਜਸਰੀ
ತತ್ವಗ್ಯಾನಾಪ್ರದ	ਤਤ੍ਵਗ੍ਯਾਨਾਪ੍ਰਦ
ತನವೀರ	ਤਨਵੀਰ
ತನಾವ	ਤਨਾਵ
ತನೇಶ	ਤਨੇਸ਼
ತನ್ವಿಕಾ	ਤਨ੍ਵਿਕਾ
ತನ್ವೀಶ್ರೀ	ਤਨ੍ਵੀਸ਼੍ਰੀ
ತಪಸ	ਤਪਸ
ತಪಸ್ವೀ	ਤਪਸ੍ਵੀ
ತಮಸ	ਤਮਸ
ತಮಾಯಾನ್ಥ್ಯ	ਤਮਾਯਾਨ੍ਥ੍ਯ
ತಮಾಸ್ವೀ	ਤਮਾਸ੍ਵੀ
ತಮಿಲಾ	ਤਮਿਲਾ
ತಮೇಶ	ਤਮੇਸ਼
ತರಂಗಿನೀ	ਤਰੰਗਿਨੀ
ತರಲ	ਤਰਲ
ತರಸ್ವೀನ	ਤਰਸ੍ਵੀਨ
ತರಿತ	ਤਰਿਤ
ತರುಶೀ	ਤਰੁਸ਼ੀ
ತಲ್ಲೀ	ਤਲ੍ਲੀ
ತಶಾ	ਤਸ਼ਾ
ತಾಕ್ಸ್ವೀಹ	ਤਾਕ੍ਸ੍ਵੀਹ
ತಾನಾಸೀ	ਤਾਨਾਸੀ
ತಾನ್ಹಿತಾ	ਤਾਨ੍ਹਿਤਾ
ತಾಮಾಂಶ್ರೀ	ਤਾਮਾਂਸ਼੍ਰੀ
ತಾಮಾಸ್ವಿನೀ	ਤਾਮਾਸ੍ਵਿਨੀ
ತಾಮಿಲಸೇಲ್ವೀ	ਤਾਮਿਲਸੇਲ੍ਵੀ
ತಾಯೀನ	ਤਾਯੀਨ
ತಾರಾಕ್ಷ	ਤਾਰਾਕ੍ਸ਼
ತಾರಾಚಂದ	ਤਾਰਾਚੰਦ
ತಾರಾನೀಸೇನ	ਤਾਰਾਨੀਸੇਨ
ತಾರೀಶೀ	ਤਾਰੀਸ਼ੀ
ತಾಲಿನ	ਤਾਲਿਨ
ತಾವಾಸ್ಯ	ਤਾਵਾਸ੍ਯ
ತಿತಲೀ	ਤਿਤਲੀ
ತಿಲಕ	ਤਿਲਕ
ತಿಸ್ಯಾ	ਤਿਸ੍ਯਾ
ತೀಅನಾ	ਤੀਅਨਾ
ತೀಯಶಾ	ਤੀਯਸ਼ਾ
ತೀಯಸ	ਤੀਯਸ
ತುನಾವಾ	ਤੁਨਾਵਾ
ತುರಾನ್ಯು	ਤੁਰਾਨ੍ਯੁ
ತುಲಜಾ	ਤੁਲਜਾ
ತುಲಸಾ	ਤੁਲਸਾ
ತುಲೀ	ਤੁਲੀ
ತುಲೀಪ	ਤੁਲੀਪ
ತುಷಾರ	ਤੁਸ਼ਾਰ
ತುಷಿತ	ਤੁਸ਼ਿਤ
ತುಷ್ಟಿ	ਤੁਸ਼੍ਟਿ
ತೇಗವಿರ	ਤੇਗਵਿਰ
ತೇಜಸೀ	ਤੇਜਸੀ
ತೇಜಸ್ವೀ	ਤੇਜਸ੍ਵੀ
ತೇಜಸ್ವೀನ	ਤੇਜਸ੍ਵੀਨ
ತೇಜೀ	ਤੇਜੀ
ತೇಜುಲ	ਤੇਜੁਲ
ತೇಜೇನದರ	ਤੇਜੇਨਦਰ
ತೇಜೇಶ	ਤੇਜੇਸ਼
ತೇವಾನ	ਤੇਵਾਨ
ತೇಸಶ	ਤੇਸਸ਼
ತೋಮಾಂಲೀ	ਤੋਮਾਂਲੀ
ತೋಯಾಜ	ਤੋਯਾਜ
ತೋಶೀ	ਤੋਸ਼ੀ
ತೋಶೀನ	ਤੋਸ਼ੀਨ
ತೌಲೀಕ	ਤੌਲੀਕ
ತ್ರಂಬಕ	ਤ੍ਰੰਬਕ
ತ್ರಿಂಬಿಕಾ	ਤ੍ਰਿਂਬਿਕਾ
ತ್ರಿಕಾಯಾ	ਤ੍ਰਿਕਾਯਾ
ತ್ರಿಜಲ	ਤ੍ਰਿਜਲ
ತ್ರಿಪುತಾ	ਤ੍ਰਿਪੁਤਾ
ತ್ರಿಪುರಸುಂದರೀ	ਤ੍ਰਿਪੁਰਸੁਂਦਰੀ
ತ್ರಿಪುರಾರೀ	ਤ੍ਰਿਪੁਰਾਰੀ
ತ್ರಿಪ್ತಾ	ਤ੍ਰਿਪ੍ਤਾ
ತ್ರಿಲೋಕೇಶ	ਤ੍ਰਿਲੋਕੇਸ਼
ತ್ರಿವಿಕ್ರಮ	ਤ੍ਰਿਵਿਕ੍ਰਮ
ತ್ರಿವೇಣೀ	ਤ੍ਰਿਵੇਣੀ
ತ್ರಿಶಲಾನಾ	ਤ੍ਰਿਸ਼ਲਾਨਾ
ತ್ರಿಶಾಲಾ	ਤ੍ਰਿਸ਼ਾਲਾ
ತ್ರಿಶುಲಿನೀ	ਤ੍ਰਿਸ਼ੁਲਿਨੀ
ತ್ರೀನೇಶ	ਤ੍ਰੀਨੇਸ਼
ತ್ರೀಮ್ಬೀಕಾ	ਤ੍ਰੀਮ੍ਬੀਕਾ
ತ್ರೀಲೋಚನನ	ਤ੍ਰੀਲੋਚਨਨ
ತ್ರೀವೀದ	ਤ੍ਰੀਵੀਦ
ತ್ರೀಸವಾ	ਤ੍ਰੀਸਵਾ
ಥಂಗಾ	ਥੰਗਾ
ಥಾನೀಶ್ಕಾ	ਥਾਨੀਸ਼੍ਕਾ
ಥಾನುಂಶಾ	ਥਾਨੁਂਸ਼ਾ
ಥಾರ್ಶೀನೀ	ਥਾਰ੍ਸ਼ੀਨੀ
ಥಾರ್ಸೀನ	ਥਾਰ੍ਸੀਨ
ದಂದಾಪಾನೀ	ਦੰਦਾਪਾਨੀ
ದಕ್ಶಾಜಾ	ਦਕ੍ਸ਼ਾਜਾ
ದಕ್ಷೀ	ਦਕ੍ਸ਼ੀ
ದಯಾಕರ	ਦਯਾਕਰ
ದಯಾನಿತಾ	ਦਯਾਨਿਤਾ
ದಯಾಲನ	ਦਯਾਲਨ
ದರಹಾಸ	ਦਰਹਾਸ
ದರಿದ್ರಾ ಧಾವ್ಸೀನೀ	ਦਰਿਦ੍ਰਾ ਧਾਵ੍ਸੀਨੀ
ದರೀತ್ರೀ	ਦਰੀਤ੍ਰੀ
ದರ್ಮೀನೀ	ਦਰ੍ਮੀਨੀ
ದರ್ಸೀಕಾ	ਦਰ੍ਸੀਕਾ
ದವೇ	ਦਵੇ
ದಶಾ	ਦਸ਼ਾ
ದಶಾಗ್ರೀವಾ ಶೀರೋಹರಾ	ਦਸ਼ਾਗ੍ਰੀਵਾ ਸ਼ੀਰੋਹਰਾ
ದಾನ್ಸೀಕಾ	ਦਾਨ੍ਸੀਕਾ
ದಾಮಾ	ਦਾਮਾ
ದಾರುಕಾ	ਦਾਰੁਕਾ
ದಾಶಾರತೀ	ਦਾਸ਼ਾਰਤੀ
ದಿಕ್ಶಾನ್ಯ	ਦਿਕ੍ਸ਼ਾਨ੍ਯ
ದಿಕ್ಶೀಕಾ	ਦਿਕ੍ਸ਼ੀਕਾ
ದಿನ ದಯಾಲ	ਦਿਨ ਦਯਾਲ
ದಿಪಂಶೀ	ਦਿਪੰਸ਼ੀ
ದಿಪೇಂದರ	ਦਿਪੇਂਦਰ
ದಿಪೇನ	ਦਿਪੇਨ
ದೀಪ್ತಿಕಾನಾ	ਦੀਪ੍ਤਿਕਾਨਾ
ದೀಪ್ತಿಮೋಯ	ਦੀਪ੍ਤਿਮੋਯ
ದೇನೀಷ	ਦੇਨੀਸ਼
ದೇಬಸ್ಮಿತಾ	ਦੇਬਸ੍ਮਿਤਾ
ದೇಬೋಪ್ರಿಯಾ	ਦੇਬੋਪ੍ਰਿਯਾ
ದೇಬೋಸ್ಮಿತಾ	ਦੇਬੋਸ੍ਮਿਤਾ
ದೇಬ್ಜಾನೀ	ਦੇਬ੍ਜਾਨੀ
ದೇಮ್ಧೇನ್ದ್ರ	ਦੇਮ੍ਧੇਨ੍ਦ੍ਰ
ದೇಯ್ದಿಪ್ಯಾ	ਦੇਯ੍ਦਿਪ੍ਯਾ
ದೇಲೀನಾ	ਦੇਲੀਨਾ
ದೇವ ನರೇನ	ਦੇਵ ਨਰੇਨ
ದೇವದೀಪ	ਦੇਵਦੀਪ
ದೇವನಾಥನ	ਦੇਵਨਾਥਨ
ದೇವಪದ	ਦੇਵਪਦ
ದೇವರತ	ਦੇਵਰਤ
ದೇವರಾಜ	ਦੇਵਰਾਜ
ದೇವರಾಜನ	ਦੇਵਰਾਜਨ
ದೇವಲ	ਦੇਵਲ
ದೇವಾಂಶು	ਦੇਵਾਂਸ਼ੁ
ದೇವಾರಹಾಲ್ಲೀ	ਦੇਵਾਰਹਾਲ੍ਲੀ
ದೇವಾಶ್ರೀ	ਦੇਵਾਸ਼੍ਰੀ
ದೇವೀ	ਦੇਵੀ
ದೇವ್ಬ್ರತಾ	ਦੇਵ੍ਬ੍ਰਤਾ
ದೇವ್ಮುಕೀಲ	ਦੇਵ੍ਮੁਕੀਲ
ದೇವ್ಯೋಶಾ	ਦੇਵ੍ਯੋਸ਼ਾ
ದೇಶಿಕ	ਦੇਸ਼ਿਕ
ದೈತ್ಯ ಸಾಈ	ਦੈਤ੍ਯ ਸਾਈ
ದೈನಾ	ਦੈਨਾ
ದೈವಂಶ	ਦੈਵੰਸ਼
ದ್ಯುತಿ	ਦ੍ਯੁਤਿ
ಧನಶಿಕಾ	ਧਨਸ਼ਿਕਾ
ಧನ್ವಿಕಾ	ਧਨ੍ਵਿਕਾ
ಧರಿಯಾ	ਧਰਿਯਾ
ಧರ್ಮ	ਧਰ੍ਮ
ಧರ್ಮಜಾ	ਧਰ੍ਮਜਾ
ಧರ್ಮದಿತ್ಯ	ਧਰ੍ਮਦਿਤ੍ਯ
ಧಾತ್ರೀ	ਧਾਤ੍ਰੀ
ಧಾನ	ਧਾਨ
ಧಾನೀತ	ਧਾਨੀਤ
ಧಾನೀಶಾ	ਧਾਨੀਸ਼ਾ
ಧಾಮೀನೀ	ਧਾਮੀਨੀ
ಧಾಮೋಧಾರ	ਧਾਮੋਧਾਰ
ಧಾವಿತ	ਧਾਵਿਤ
ಧಿತಿ	ਧਿਤਿ
ಧೀಯಾನ	ਧੀਯਾਨ
ಧುಹಿತಾ	ਧੁਹਿਤਾ
ಧೃತಿ	ਧਤਿ
ಧೈರ್ಯ್ಯಾ	ਧੈਰ੍ਯ੍ਯਾ
ಧ್ರೀಶೀಕಾ	ਧ੍ਰੀਸ਼ੀਕਾ
ಧ್ರೀಶ್ತೀಕಾ	ਧ੍ਰੀਸ਼੍ਤੀਕਾ
ಧ್ರುವಿಕಾ	ਧ੍ਰੁਵਿਕਾ
ಧ್ವೀಜಾ	ਧ੍ਵੀਜਾ
ನಂದಕುಮಾರ	ਨੰਦਕੁਮਾਰ
ನಕುಲ	ਨਕੁਲ
ನಕ್ಷತ್ರಾ	ਨਕ੍ਸ਼ਤ੍ਰਾ
ನಚಿಕೇತಾ	ਨਚਿਕੇਤਾ
ನತಾಲೀ	ਨਤਾਲੀ
ನಬರೂಣ	ਨਬਰੂਣ
ನಭೋಜ	ਨਭੋਜ
ನಮ್ರಹ	ਨਮ੍ਰਹ
ನಲಿನ	ਨਲਿਨ
ನವಮ	ਨਵਮ
ನವರಾತನಾ	ਨਵਰਾਤਨਾ
ನವಾಲನ	ਨਵਾਲਨ
ನವೇಂದು	ਨਵੇਂਦੁ
ನಾಕುಶ	ਨਾਕੁਸ਼
ನಾಗಧವಾನೀ	ਨਾਗਧਵਾਨੀ
ನಾಗರತನಾ	ਨਾਗਰਤਨਾ
ನಾಗಿನೀ	ਨਾਗਿਨੀ
ನಾಗೇನ್ದ್ರ	ਨਾਗੇਨ੍ਦ੍ਰ
ನಾದಿಯಾ	ਨਾਦਿਯਾ
ನಾಧಾ	ਨਾਧਾ
ನಾಧೀನೀ	ਨਾਧੀਨੀ
ನಾನ್ತೀನೀ	ਨਾਨ੍ਤੀਨੀ
ನಾಬಹ	ਨਾਬਹ
ನಾಭೀನತ	ਨਾਭੀਨਤ
ನಾಮೀಶಾ	ਨਾਮੀਸ਼ਾ
ನಾಯತ	ਨਾਯਤ
ನಾರಾಯಾಣಾ	ਨਾਰਾਯਾਣਾ
ನಾರ್ಮಾಂಥಾ	ਨਾਰ੍ਮਾਂਥਾ
ನಾರ್ಸೀಮುಲುಂ	ਨਾਰ੍ਸੀਮੁਲੁਂ
ನಾಲಾನೀಲ	ਨਾਲਾਨੀਲ
ನಾಲಾವೇನ್ಭಾ	ਨਾਲਾਵੇਨ੍ਭਾ
ನಾವಾಪ್ರಿಯನ	ਨਾਵਾਪ੍ਰਿਯਨ
ನಾವಾಮಾಂಲ್ಲೀ	ਨਾਵਾਮਾਂਲ੍ਲੀ
ನಾವೀಶಾ	ਨਾਵੀਸ਼ਾ
ನಾವ್ಯಶ್ರೀ	ਨਾਵ੍ਯਸ਼੍ਰੀ
ನಾವ್ಯಸರೀ	ਨਾਵ੍ਯਸਰੀ
ನಾವ್ಯಾ	ਨਾਵ੍ਯਾ
ನಾಹುಲ	ਨਾਹੁਲ
ನಿಕೀನ	ਨਿਕੀਨ
ನಿಖಾರ	ਨਿਖਾਰ
ನಿಖಿಲೇಶ	ਨਿਖਿਲੇਸ਼
ನಿದೇಶ	ਨਿਦੇਸ਼
ನಿಧ್ಯಾಥೀ	ਨਿਧ੍ਯਾਥੀ
ನಿಭಯ	ਨਿਭਯ
ನಿರಜಾ	ਨਿਰਜਾ
ನಿರ್ಜಲಾ	ਨਿਰ੍ਜਲਾ
ನಿಶಾ	ਨਿਸ਼ਾ
ನಿಶಿಥಿನೀ	ਨਿਸ਼ਿਥਿਨੀ
ನಿಹಾರಿಕಾ	ਨਿਹਾਰਿਕਾ
ನೀಕಮ	ਨੀਕਮ
ನೀಕಾನ್ದರ್ಯ	ਨੀਕਾਨ੍ਦਰ੍ਯ
ನೀಕೀಲ	ਨੀਕੀਲ
ನೀಕುಂಜ	ਨੀਕੁਂਜ
ನೀಕುಲ	ਨੀਕੁਲ
ನೀಚೀತಾ	ਨੀਚੀਤਾ
ನೀಜಾ	ਨੀਜਾ
ನೀಡೀ	ਨੀਡੀ
ನೀತಾ	ਨੀਤਾ
ನೀದೀಶ	ਨੀਦੀਸ਼
ನೀನಾ	ਨੀਨਾ
ನೀನ್ನ್ಯ	ਨੀਨ੍ਨ੍ਯ
ನೀಭೀಶ	ਨੀਭੀਸ਼
ನೀರುಧೀ	ਨੀਰੁਧੀ
ನೀರೇಕ್ಷಾ	ਨੀਰੇਕ੍ਸ਼ਾ
ನೀಲ	ਨੀਲ
ನೀಲ ಕಾಂತಾ	ਨੀਲ ਕਾਂਤਾ
ನೀಲ ಮಾಧವ	ਨੀਲ ਮਾਧਵ
ನೀಲಂಜನಾ	ਨੀਲੰਜਨਾ
ನೀಲಕಮಾಲಾ	ਨੀਲਕਮਾਲਾ
ನೀಲದೇವೀ	ਨੀਲਦੇਵੀ
ನೀಲಯ	ਨੀਲਯ
ನೀಲಾಂಜನ	ਨੀਲਾਂਜਨ
ನೀಲಾಮ್ಬೇರ	ਨੀਲਾਮ੍ਬੇਰ
ನೀಲೋರ್ಮ್ಯ	ਨੀਲੋਰ੍ਮ੍ਯ
ನೀಲ್ಸಾ	ਨੀਲ੍ਸਾ
ನೀಶಾಲೀ	ਨੀਸ਼ਾਲੀ
ನೀಷ್ಟಾ	ਨੀਸ਼੍ਟਾ
ನೀಸಿತೀನೀ	ਨੀਸਿਤੀਨੀ
ನೀಸ್ಚೀಥಾ	ਨੀਸ੍ਚੀਥਾ
ನೀಹಮ	ਨੀਹਮ
ನೀಹಾರಿಕಾ	ਨੀਹਾਰਿਕਾ
ನೀಹೀಥಾ	ਨੀਹੀਥਾ
ನೀಹೀರಾ	ਨੀਹੀਰਾ
ನೇಮಾ	ਨੇਮਾ
ನೇಮಾಂಲೀ	ਨੇਮਾਂਲੀ
ನೇಹಾರಿಕಾ	ਨੇਹਾਰਿਕਾ
ನೈತಿ	ਨੈਤਿ
ನೈರೀತೀ	ਨੈਰੀਤੀ
ನೈವೇದ	ਨੈਵੇਦ
ನೈಷೀ	ਨੈਸ਼ੀ
ನೌಬಹಾರ	ਨੌਬਹਾਰ
ಪಂಕಜ಼ಾ	ਪੰਕਜ਼ਾ
ಪಂಖೀ	ਪੰਖੀ
ಪಂಚಮ	ਪੰਚਮ
ಪಂಚಾಲೀ	ਪੰਚਾਲੀ
ಪಂಥ	ਪੰਥ
ಪಂಧಾರೀ	ਪੰਧਾਰੀ
ಪಣ-ಗೇಶ	ਪਣ-ਗੇਸ਼
ಪತಾಲಾ	ਪਤਾਲਾ
ಪತ್ರಲಿಕಾ	ਪਤ੍ਰਲਿਕਾ
ಪದಮಾವತೀ	ਪਦਮਾਵਤੀ
ಪದ್ಮಬಂಧೂ	ਪਦ੍ਮਬੰਧੂ
ಪದ್ಮಹಸ್ತಾ	ਪਦ੍ਮਹਸ੍ਤਾ
ಪದ್ಮಾಂನಾಭಾ ಪ್ರಿಯಾ	ਪਦ੍ਮਾਂਨਾਭਾ ਪ੍ਰਿਯਾ
ಪನೀಶ್ಕಾ	ਪਨੀਸ਼੍ਕਾ
ಪನ್ಕಾಜಮ	ਪਨ੍ਕਾਜਮ
ಪನ್ದಾಲಾವಾಸನ	ਪਨ੍ਦਾਲਾਵਾਸਨ
ಪಪಮ್ಮಾಂ	ਪਪਮ੍ਮਾਂ
ಪರಮಂದಾ	ਪਰਮੰਦਾ
ಪರಮಪುರುಷ	ਪਰਮਪੁਰੁਸ਼
ಪರಮಹಂಸ	ਪਰਮਹੰਸ
ಪರಮಾ	ਪਰਮਾ
ಪರಮೇಶ್ವರೀ	ਪਰਮੇਸ਼੍ਵਰੀ
ಪರಮ್ವಾರ್ದಾನ	ਪਰਮ੍ਵਾਰ੍ਦਾਨ
ಪರವೀನ	ਪਰਵੀਨ
ಪರಾಯಂತ್ರ	ਪਰਾਯੰਤ੍ਰ
ಪರಾಶ	ਪਰਾਸ਼
ಪರಿಕ್ಷಿತ	ਪਰਿਕ੍ਸ਼ਿਤ
ಪರಿಣೀತಾ	ਪਰਿਣੀਤਾ
ಪರಿತಾ	ਪਰਿਤਾ
ಪರಿತುಷ್ಟಿ	ਪਰਿਤੁਸ਼੍ਟਿ
ಪರಿಷ್ಕಾರ	ਪਰਿਸ਼੍ਕਾਰ
ಪರಿಹಾ	ਪਰਿਹਾ
ಪರೀಮೀತ	ਪਰੀਮੀਤ
ಪರು	ਪਰੁ
ಪರ್ಣವ	ਪਰ੍ਣਵ
ಪರ್ಣಿಕಾ	ਪਰ੍ਣਿਕਾ
ಪರ್ನಾಭಾ	ਪਰ੍ਨਾਭਾ
ಪರ್ವತ	ਪਰ੍ਵਤ
ಪರ್ವತೀಪ್ರಿತ	ਪਰ੍ਵਤੀਪ੍ਰਿਤ
ಪರ್ವತೇಶ್ವರ	ਪਰ੍ਵਤੇਸ਼੍ਵਰ
ಪರ್ವನ	ਪਰ੍ਵਨ
ಪಲಾನೀಚಾಮ್ಯ	ਪਲਾਨੀਚਾਮ੍ਯ
ಪಲಾಶೀನೀ	ਪਲਾਸ਼ੀਨੀ
ಪವನ	ਪਵਨ
ಪವೀಥಾ	ਪਵੀਥਾ
ಪಾಂಖಡೀ	ਪਾਂਖਡੀ
ಪಾಂಚಾಲೀ	ਪਾਂਚਾਲੀ
ಪಾಂಡುರಂಗ	ਪਾਂਡੁਰੰਗ
ಪಾಓಲಾ	ਪਾਓਲਾ
ಪಾರಸ	ਪਾਰਸ
ಪಾರಾ	ਪਾਰਾ
ಪಾರ್ತೀಬನ	ਪਾਰ੍ਤੀਬਨ
ಪಾರ್ಥಾಪ್ರತಿಮ	ਪਾਰ੍ਥਾਪ੍ਰਤਿਮ
ಪಾರ್ಥಿಕ	ਪਾਰ੍ਥਿਕ
ಪಾರ್ವತೀ	ਪਾਰ੍ਵਤੀ
ಪಾರ್ವಾಥೀ	ਪਾਰ੍ਵਾਥੀ
ಪಾಲ	ਪਾਲ
ಪಾಲನೀವೇಲ	ਪਾਲਨੀਵੇਲ
ಪಾಲೀನ	ਪਾਲੀਨ
ಪಾವಾನಾ	ਪਾਵਾਨਾ
ಪಾವಾನೀ	ਪਾਵਾਨੀ
ಪಾಸೀ	ਪਾਸੀ
ಪಿಂಗಲ	ਪਿਂਗਲ
ಪಿಂಗಲಾ	ਪਿਂਗਲਾ
ಪಿತಾವಾಸನೇ	ਪਿਤਾਵਾਸਨੇ
ಪಿವಾಲ	ਪਿਵਾਲ
ಪೀಉಶಾ	ਪੀਉਸ਼ਾ
ಪೀತೋಬಾಶ	ਪੀਤੋਬਾਸ਼
ಪೀನ್ಕೇಶ	ਪੀਨ੍ਕੇਸ਼
ಪೀರನೀಥಾ	ਪੀਰਨੀਥਾ
ಪುರ್ನೀಮಾಂ	ਪੁਰ੍ਨੀਮਾਂ
ಪೂಜನ	ਪੂਜਨ
ಪೂಜಾ	ਪੂਜਾ
ಪೂನಿಶ	ਪੂਨਿਸ਼
ಪೂರಬ	ਪੂਰਬ
ಪೂರ್ವಗಂಗಾ	ਪੂਰ੍ਵਗੰਗਾ
ಪೂರ್ವಜ	ਪੂਰ੍ਵਜ
ಪೂರ್ವಾ	ਪੂਰ੍ਵਾ
ಪೇಮಲ	ਪੇਮਲ
ಪೌಶಾಲೀ	ਪੌਸ਼ਾਲੀ
ಪ್ರಗನ್ಯಾ	ਪ੍ਰਗਨ੍ਯਾ
ಪ್ರಗಿತ	ਪ੍ਰਗਿਤ
ಪ್ರಚೀತೀ	ਪ੍ਰਚੀਤੀ
ಪ್ರಜೀಶಾ	ਪ੍ਰਜੀਸ਼ਾ
ಪ್ರದಿಪಾ	ਪ੍ਰਦਿਪਾ
ಪ್ರದೀಪ್ತಾ	ਪ੍ਰਦੀਪ੍ਤਾ
ಪ್ರನಾವಾಶ್ರೀ	ਪ੍ਰਨਾਵਾਸ਼੍ਰੀ
ಪ್ರನಿತಾ	ਪ੍ਰਨਿਤਾ
ಪ್ರನೀಕಾ	ਪ੍ਰਨੀਕਾ
ಪ್ರಭಂಜನ	ਪ੍ਰਭੰਜਨ
ಪ್ರಭಾಕರ	ਪ੍ਰਭਾਕਰ
ಪ್ರಭಾದಾ	ਪ੍ਰਭਾਦਾ
ಪ್ರಮಿಕಾ	ਪ੍ਰਮਿਕਾ
ಪ್ರಹಾರ್ಶೀನೀ	ਪ੍ਰਹਾਰ੍ਸ਼ੀਨੀ
ಪ್ರಹಾಸಾ	ਪ੍ਰਹਾਸਾ
ಪ್ರಾನಲ	ਪ੍ਰਾਨਲ
ಫಣೀಶ	ਫਣੀਸ਼
ಫ಼ಾಲ್ಗುನ	ਫ਼ਾਲ੍ਗੁਨ
ಫುಲ್ಲಾರಾ	ਫੁਲ੍ਲਾਰਾ
ಬಂದನಾ	ਬੰਦਨਾ
ಬಂಧೀನೀ	ਬੰਧੀਨੀ
ಬಂಸೀಲಾಲ	ਬੰਸੀਲਾਲ
ಬಖ್ತಾವರ	ਬਖ੍ਤਾਵਰ
ಬಗ್ಯಾರಾಜ	ਬਗ੍ਯਾਰਾਜ
ಬನಬಿಹಾರೀ	ਬਨਬਿਹਾਰੀ
ಬರ್ಷಾ	ਬਰ੍ਸ਼ਾ
ಬಲರಾಮ	ਬਲਰਾਮ
ಬಲವಾನ	ਬਲਵਾਨ
ಬಲಾದೀತ್ಯ	ਬਲਾਦੀਤ੍ਯ
ಬವೀಶ್ಯಸರೀ	ਬਵੀਸ਼੍ਯਸਰੀ
ಬಹವಾಸ್ಯ	ਬਹਵਾਸ੍ਯ
ಬಹುಲಾ	ਬਹੁਲਾ
ಬಹುಲೇಯನ	ਬਹੁਲੇਯਨ
ಬಾಂಕೇ ಬಿಹಾರೀ	ਬਾਂਕੇ ਬਿਹਾਰੀ
ಬಾಜೀನಾಥ	ਬਾਜੀਨਾਥ
ಬಾನೀ	ਬਾਨੀ
ಬಾಪು	ਬਾਪੁ
ಬಾಲಗೋಪಾಲ	ਬਾਲਗੋਪਾਲ
ಬಾಲಚಂದ್ರಾ	ਬਾਲਚੰਦ੍ਰਾ
ಬಾಲನಾಥ	ਬਾਲਨਾਥ
ಬಾಲಾಜೀ	ਬਾਲਾਜੀ
ಬಾಲಾರವೀ	ਬਾਲਾਰਵੀ
ಬಿಂದುಮಾಲಿನೀ	ਬਿਂਦੁਮਾਲਿਨੀ
ಬಿಂದೂಸರ	ਬਿਂਦੂਸਰ
ಬಿಜೋಯ	ਬਿਜੋਯ
ಬಿನೋದ	ਬਿਨੋਦ
ಬಿಪಾಶಾ	ਬਿਪਾਸ਼ਾ
ಬಿಮ್ಬಾ	ਬਿਮ੍ਬਾ
ಬಿರಂಚೀ	ਬਿਰੰਚੀ
ಬಿಲ್ವಾ	ਬਿਲ੍ਵਾ
ಬೀದಯುಂತ	ਬੀਦਯੁਂਤ
ಬೀನೋದೀನೀ	ਬੀਨੋਦੀਨੀ
ಬೀನ್ಕಾಲ	ਬੀਨ੍ਕਾਲ
ಬೀಭು	ਬੀਭੁ
ಬೀರಾತ	ਬੀਰਾਤ
ಬುದ್ಧ	ਬੁਦ੍ਧ
ಬುದ್ಧಿ	ਬੁਦ੍ਧਿ
ಬೇನುಂ	ਬੇਨੁਂ
ಬೇನ್ನೀ	ਬੇਨ੍ਨੀ
ಬೇನ್ಶಿಕ	ਬੇਨ੍ਸ਼ਿਕ
ಬೇಲುರಮೀ	ਬੇਲੁਰਮੀ
ಬೈರ	ਬੈਰ
ಬೈಸಾಖೀ	ਬੈਸਾਖੀ
ಬೋನಾಸರೀ	ਬੋਨਾਸਰੀ
ಬ್ರಹ್ಮಾವತೀ	ਬ੍ਰਹ੍ਮਾਵਤੀ
ಬ್ರೀಜಲ	ਬ੍ਰੀਜਲ
ಬ್ರೀನ್ದಾವಾನೀ	ਬ੍ਰੀਨ੍ਦਾਵਾਨੀ
ಬ್ಲೇಸ್ಸೀ	ਬ੍ਲੇਸ੍ਸੀ
ಭಕ್ತಿ	ਭਕ੍ਤਿ
ಭಗವತೀ	ਭਗਵਤੀ
ಭದ್ರಕ	ਭਦ੍ਰਕ
ಭದ್ರಕ್ಷ	ਭਦ੍ਰਕ੍ਸ਼
ಭದ್ರಾ	ਭਦ੍ਰਾ
ಭದ್ರೀಶಾ	ਭਦ੍ਰੀਸ਼ਾ
ಭವಾನಿದಾಸ	ਭਵਾਨਿਦਾਸ
ಭವಿಷ್ಯಾ	ਭਵਿਸ਼੍ਯਾ
ಭವೀಶ	ਭਵੀਸ਼
ಭವ್ಯ	ਭਵ੍ਯ
ಭಾಗವಾಥ	ਭਾਗਵਾਥ
ಭಾಗಿರತ	ਭਾਗਿਰਤ
ಭಾಗ್ಯವತೀ	ਭਾਗ੍ਯਵਤੀ
ಭಾಗ್ಯಶ್ರೀ	ਭਾਗ੍ਯਸ਼੍ਰੀ
ಭಾಗ್ಯಾ	ਭਾਗ੍ਯਾ
ಭಾತ್ರಶ್ರೀ	ਭਾਤ੍ਰਸ਼੍ਰੀ
ಭಾದ್ರಿಕಾ	ਭਾਦ੍ਰਿਕਾ
ಭಾನುಜ	ਭਾਨੁਜ
ಭಾನುದಾಸ	ਭਾਨੁਦਾਸ
ಭಾನುಪ್ರಿಯಾ	ਭਾਨੁਪ੍ਰਿਯਾ
ಭಾರನೀಧಾರ	ਭਾਰਨੀਧਾਰ
ಭಾರೂಕ	ਭਾਰੂਕ
ಭಾರ್ತಿಹಾರೀ	ਭਾਰ੍ਤਿਹਾਰੀ
ಭಾವತೀ	ਭਾਵਤੀ
ಭಾವಾಥಾರೀನೀ	ਭਾਵਾਥਾਰੀਨੀ
ಭಾವಾಪ್ರಿಯಾ	ਭਾਵਾਪ੍ਰਿਯਾ
ಭಾವಿಕ	ਭਾਵਿਕ
ಭಾವಿತಾ	ਭਾਵਿਤਾ
ಭಾವೀಶಾ	ਭਾਵੀਸ਼ਾ
ಭಾವ್ಯಶ್ರೀ	ਭਾਵ੍ਯਸ਼੍ਰੀ
ಭಾಶ್ವೀನೀ	ਭਾਸ਼੍ਵੀਨੀ
ಭಾಸ್ಕರಣ	ਭਾਸ੍ਕਰਣ
ಭಾಸ್ಕೇರ	ਭਾਸ੍ਕੇਰ
ಭಿಮಾಂಬಾಲಾ	ਭਿਮਾਂਬਾਲਾ
ಭೀಮ	ਭੀਮ
ಭೀಷಮ	ਭੀਸ਼ਮ
ಭೀಷ್ಮ	ਭੀਸ਼੍ਮ
ಭುವಿಕ	ਭੁਵਿਕ
ಭೂತೇಶ್ವರ	ਭੂਤੇਸ਼੍ਵਰ
ಭೂಪಾಲ	ਭੂਪਾਲ
ಭೂಪಾಲೀ	ਭੂਪਾਲੀ
ಭೂಪೇನ	ਭੂਪੇਨ
ಭೂಮತ	ਭੂਮਤ
ಭೂಮಿಕಾ	ਭੂਮਿਕਾ
ಭೇರವೀ	ਭੇਰਵੀ
ಭೇರೇಶ	ਭੇਰੇਸ਼
ಭೋಲಾನಾಥ	ਭੋਲਾਨਾਥ
ಭ್ರೀಜ	ਭ੍ਰੀਜ
ಮಂಜುಶ್ರೀ	ਮੰਜੁਸ਼੍ਰੀ
ಮಂತವ್ಯ	ਮੰਤਵ੍ਯ
ಮಂದಾರ	ਮੰਦਾਰ
ಮಂದಿನ	ਮੰਦਿਨ
ಮಂದೀಪಾ	ਮੰਦੀਪਾ
ಮಂಶಾ	ਮੰਸ਼ਾ
ಮಕರ	ਮਕਰ
ಮಣಿಕಾಂತ	ਮਣਿਕਾਂਤ
ಮಣಿಮಾಲಾ	ਮਣਿਮਾਲਾ
ಮಣಿಶಂಕರ	ਮਣਿਸ਼ੰਕਰ
ಮದುರಾ	ਮਦੁਰਾ
ಮಧುಜಾ	ਮਧੁਜਾ
ಮಧುರಾನೀ	ਮਧੁਰਾਨੀ
ಮಧುಲಿಕಾ	ਮਧੁਲਿਕਾ
ಮಧುಶಾ	ਮਧੁਸ਼ਾ
ಮನನಶ	ਮਨਨਸ਼
ಮನಸ್ವೀ	ਮਨਸ੍ਵੀ
ಮನಹರ	ਮਨਹਰ
ಮನಾಗೋಬೀನದಾ	ਮਨਾਗੋਬੀਨਦਾ
ಮನಾಲೀ	ਮਨਾਲੀ
ಮನಿಕುನ್ತಾಲಾ	ਮਨਿਕੁਨ੍ਤਾਲਾ
ಮನಿರಾಮ	ਮਨਿਰਾਮ
ಮನಿಶಿಕಾ	ਮਨਿਸ਼ਿਕਾ
ಮನೀದೀಪ	ਮਨੀਦੀਪ
ಮನೀಬಲನ	ਮਨੀਬਲਨ
ಮನೀಷಾ	ਮਨੀਸ਼ਾ
ಮನೋಜವಾಯಾ	ਮਨੋਜਵਾਯਾ
ಮನೋರಥ	ਮਨੋਰਥ
ಮನೋಹರಣ	ਮਨੋਹਰਣ
ಮನ್ನನ	ਮਨ੍ਨਨ
ಮನ್ವೀರ	ਮਨ੍ਵੀਰ
ಮರಲಾ	ਮਰਲਾ
ಮಲಯಾ	ਮਲਯਾ
ಮಲಿಕಾ	ਮਲਿਕਾ
ಮಲೀಂಗಾ	ਮਲੀਂਗਾ
ಮಲ್ಕಾ	ਮਲ੍ਕਾ
ಮಹಂತ	ਮਹੰਤ
ಮಹಾಕಾಲ	ਮਹਾਕਾਲ
ಮಹಾಗಂಗಾ	ਮਹਾਗੰਗਾ
ಮಹಾತ್ಮಾ	ਮਹਾਤ੍ਮਾ
ಮಹಾತ್ರೂ	ਮਹਾਤ੍ਰੂ
ಮಹಾನ್ಯ	ਮਹਾਨ੍ਯ
ಮಹಾಬಲಾ	ਮਹਾਬਲਾ
ಮಹಾಬಾಲಾ	ਮਹਾਬਾਲਾ
ಮಹಾಬುದ್ಧಿ	ਮਹਾਬੁਦ੍ਧਿ
ಮಹಾಲಕ್ಷ್ಮೀ	ਮਹਾਲਕ੍ਸ਼੍ਮੀ
ಮಹಿರಂಶ	ਮਹਿਰੰਸ਼
ಮಹೀಧೇರ	ਮਹੀਧੇਰ
ಮಹುಬಾಲಾ	ਮਹੁਬਾਲਾ
ಮಾಂಧುಘನೇ	ਮਾਂਧੁਘਨੇ
ಮಾಂಧುವೇಮಾನ	ਮਾਂਧੁਵੇਮਾਨ
ಮಾಂನಾಶ್ಯುಂ	ਮਾਂਨਾਸ਼੍ਯੁਂ
ಮಾಂನುರಾಈ	ਮਾਂਨੁਰਾਈ
ಮಾಂನೋತ	ਮਾਂਨੋਤ
ಮಾಂಮೋನ	ਮਾਂਮੋਨ
ಮಾಇಲ	ਮਾਇਲ
ಮಾಗತ	ਮਾਗਤ
ಮಾಗಧೀ	ਮਾਗਧੀ
ಮಾತನ	ਮਾਤਨ
ಮಾಧವನ	ਮਾਧਵਨ
ಮಾಧುಜ	ਮਾਧੁਜ
ಮಾಧುರೀ	ਮਾਧੁਰੀ
ಮಾಧುರ್ಯ	ਮਾਧੁਰ੍ਯ
ಮಾನಸ್ವೀತಾ	ਮਾਨਸ੍ਵੀਤਾ
ಮಾನ್ಮಾತನ	ਮਾਨ੍ਮਾਤਨ
ಮಾನ್ವಿತ	ਮਾਨ੍ਵਿਤ
ಮಾಯರಾ	ਮਾਯਰਾ
ಮಾರೀರಾಜ	ਮਾਰੀਰਾਜ
ಮಾರುತ	ਮਾਰੁਤ
ಮಾರೂತ	ਮਾਰੂਤ
ಮಾರ್ಗಶೀ	ਮਾਰ੍ਗਸ਼ੀ
ಮಾಲವ	ਮਾਲਵ
ಮಾಲಾರ್ಕೋಡೀ	ਮਾਲਾਰ੍ਕੋਡੀ
ಮಾಲ್ಲೇಶಾ	ਮਾਲ੍ਲੇਸ਼ਾ
ಮಾಹಿತ	ਮਾਹਿਤ
ಮೇಧೀನೀ	ਮੇਧੀਨੀ
ಯಂಶ	ਯੰਸ਼
ಯಜನ	ਯਜਨ
ಯಜುಸ	ਯਜੁਸ
ಯದುನಂದನ	ਯਦੁਨੰਦਨ
ಯಶಸ್ವಿನೀ	ਯਸ਼ਸ੍ਵਿਨੀ
ಯಶಾಲ	ਯਸ਼ਾਲ
ಯಶುಸ	ਯਸ਼ੁਸ
ಯಶೋದಾಗರ್ಬಾ ಸಮ್ಭೂತಾ	ਯਸ਼ੋਦਾਗਰ੍ਬਾ ਸਮ੍ਭੂਤਾ
ಯಶ್ಯಾಸ್ಸರೀ	ਯਸ਼੍ਯਾਸ੍ਸਰੀ
ಯಶ್ವಾರ್ಧಾನಾ	ਯਸ਼੍ਵਾਰ੍ਧਾਨਾ
ಯಾಗ್ನೀಥಾ	ਯਾਗ੍ਨੀਥਾ
ಯಾದ್ನ್ಯೇಶ	ਯਾਦ੍ਨ੍ਯੇਸ਼
ಯಾಮಾಜೀತ	ਯਾਮਾਜੀਤ
ಯಾಲೀನೀ	ਯਾਲੀਨੀ
ಯಾಲೀಸಾಈ	ਯਾਲੀਸਾਈ
ಯಾಶೀನೀ	ਯਾਸ਼ੀਨੀ
ಯಾಶ್ವನ	ਯਾਸ਼੍ਵਨ
ಯುಕ್ತಾತಮಾಂ	ਯੁਕ੍ਤਾਤਮਾਂ
ಯುಗಲ	ਯੁਗਲ
ಯುಗಾಂಕ	ਯੁਗਾਂਕ
ಯುಗಾನ್ಧರ	ਯੁਗਾਨ੍ਧਰ
ಯುಗ್ಮ	ਯੁਗ੍ਮ
ಯುಥಿಕಾ	ਯੁਥਿਕਾ
ಯುಧಾವ	ਯੁਧਾਵ
ಯುಧ್ಧ	ਯੁਧ੍ਧ
ಯುವಾಕ್ಷೀ	ਯੁਵਾਕ੍ਸ਼ੀ
ಯುವಾನೀ	ਯੁਵਾਨੀ
ಯುವೀ	ਯੁਵੀ
ಯುವೀನ	ਯੁਵੀਨ
ಯುಸು	ਯੁਸੁ
ಯೇಶಾಸ್ವೀ	ਯੇਸ਼ਾਸ੍ਵੀ
ಯೇಶ್ವೀ	ਯੇਸ਼੍ਵੀ
ಯೇಸ್ವಂಠ	ਯੇਸ੍ਵੰਠ
ಯೋಗದಾ	ਯੋਗਦਾ
ಯೋಗಲಕ್ಷ್ಮೀ	ਯੋਗਲਕ੍ਸ਼੍ਮੀ
ಯೋಗಾ	ਯੋਗਾ
ಯೋಗೀ ಶ್ರೀ	ਯੋਗੀ ਸ਼੍ਰੀ
ಯೋಗೀಸಾಇ	ਯੋਗੀਸਾਇ
ಯೋಗ್ದೀಪ	ਯੋਗ੍ਦੀਪ
ಯೋಗ್ರಾಮ	ਯੋਗ੍ਰਾਮ
ಯೋನಿತಾ	ਯੋਨਿਤਾ
ಯೋಹನ	ਯੋਹਨ
ರಂಗೀತ	ਰੰਗੀਤ
ರಂಗೇಶ	ਰੰਗੇਸ਼
ರಂತೀಕಾ	ਰੰਤੀਕਾ
ರಕ್ತ	ਰਕ੍ਤ
ರಕ್ಷಾತೀ	ਰਕ੍ਸ਼ਾਤੀ
ರಕ್ಷಾನಾ	ਰਕ੍ਸ਼ਾਨਾ
ರಕ್ಷ್ಯ	ਰਕ੍ਸ਼੍ਯ
ರಘುನನ್ದನ	ਰਘੁਨਨ੍ਦਨ
ರಘುಪತಿ	ਰਘੁਪਤਿ
ರಘುಪ್ರಿಯಾ	ਰਘੁਪ੍ਰਿਯਾ
ರಚನಾ	ਰਚਨਾ
ರಣಜೀ	ਰਣਜੀ
ರಣವಿಜಯ	ਰਣਵਿਜਯ
ರತಿಕಾ	ਰਤਿਕਾ
ರತ್ನಕುಂಡಲ	ਰਤ੍ਨਕੁਂਡਲ
ರತ್ನಾಲೀ	ਰਤ੍ਨਾਲੀ
ರತ್ನೇಶ	ਰਤ੍ਨੇਸ਼
ರಥನಾ	ਰਥਨਾ
ರನಾಮೀತಾ	ਰਨਾਮੀਤਾ
ರನ್ಯ	ਰਨ੍ਯ
ರಮಾ  ದೇವೀ	ਰਮਾ  ਦੇਵੀ
ರಮಾಕಾಂತ	ਰਮਾਕਾਂਤ
ರಮಿಲಾ	ਰਮਿਲਾ
ರಮೋಲಾ	ਰਮੋਲਾ
ರವಿಕೀರ್ತೀ	ਰਵਿਕੀਰ੍ਤੀ
ರವಿಚಂದ್ರ	ਰਵਿਚੰਦ੍ਰ
ರವಿಜ	ਰਵਿਜ
ರವಿತಾ	ਰਵਿਤਾ
ರವಿನಾ	ਰਵਿਨਾ
ರವಿಶಂಕರ	ਰਵਿਸ਼ੰਕਰ
ರವೀಂದ್ರ	ਰਵੀਂਦ੍ਰ
ರಶೀಕಾ	ਰਸ਼ੀਕਾ
ರಶ್ಮೀ	ਰਸ਼੍ਮੀ
ರಶ್ಮೀಸ್ರಯಾ	ਰਸ਼੍ਮੀਸ੍ਰਯਾ
ರಸರಾಜ	ਰਸਰਾਜ
ರಸಿಕಾ	ਰਸਿਕਾ
ರಾಗಾ	ਰਾਗਾ
ರಾಗಾವೀ	ਰਾਗਾਵੀ
ರಾಗಾವೀನೋದೀನೀ	ਰਾਗਾਵੀਨੋਦੀਨੀ
ರಾಜಕುಮಾರೀ	ਰਾਜਕੁਮਾਰੀ
ರಾಜನ	ਰਾਜਨ
ರಾಜಬೀರ	ਰਾਜਬੀਰ
ರಾಜವೀ	ਰਾਜਵੀ
ರಾಜಸೇಕರಣ	ਰਾਜਸੇਕਰਣ
ರಾಜಾಹಮ್ಸನ	ਰਾਜਾਹਮ੍ਸਨ
ರಾಜೀ	ਰਾਜੀ
ರಾಜ್ಕಲಾ	ਰਾਜ੍ਕਲਾ
ರಾಜ್ಬಲಾ	ਰਾਜ੍ਬਲਾ
ರಾತ್ನಾನೀಧೀ	ਰਾਤ੍ਨਾਨੀਧੀ
ರಾಧೇಯಾ	ਰਾਧੇਯਾ
ರಾನಾ	ਰਾਨਾ
ರಾಮಚರಣ	ਰਾਮਚਰਣ
ರಾಮರಾಜ	ਰਾਮਰਾਜ
ರಾಮಸುಂದರ	ਰਾਮਸੁਂਦਰ
ರಾಮಾದೀಪ	ਰਾਮਾਦੀਪ
ರಾಯಂಶ	ਰਾਯੰਸ਼
ರಾಷೀಪ	ਰਾਸ਼ੀਪ
ರಾಸ್ಯಾ	ਰਾਸ੍ਯਾ
ರಿಶಿಮಾ	ਰਿਸ਼ਿਮਾ
ರಿಹಾನ	ਰਿਹਾਨ
ರೀಅನಾ	ਰੀਅਨਾ
ರೀತಮಾಂ	ਰੀਤਮਾਂ
ರೀತ್ಶೀಕಾ	ਰੀਤ੍ਸ਼ੀਕਾ
ರೀಥೀಶಾ	ਰੀਥੀਸ਼ਾ
ರೀಥ್ವೀ	ਰੀਥ੍ਵੀ
ರೀದ್ಧೀಮಾಂ	ਰੀਦ੍ਧੀਮਾਂ
ರೀನ್ಸೀನ	ਰੀਨ੍ਸੀਨ
ರೀಮೀ	ਰੀਮੀ
ರೀಶಾನೀ	ਰੀਸ਼ਾਨੀ
ರೀಶೋನಾ	ਰੀਸ਼ੋਨਾ
ರೀಸ್ಲುಂನಾ	ਰੀਸ੍ਲੁਂਨਾ
ರೂಂಗ / ರಂಗ	ਰੂਂਗ / ਰੰਗ
ರೇಡ್ಡೀ	ਰੇਡ੍ਡੀ
ರೇಥುಶಾನಾ	ਰੇਥੁਸ਼ਾਨਾ
ರೇನುಕ	ਰੇਨੁਕ
ರೇಭಾ	ਰੇਭਾ
ರೇಮಾಂನೀಕಾ	ਰੇਮਾਂਨੀਕਾ
ರೇಮ್ಯಾ	ਰੇਮ੍ਯਾ
ರೇವಂತ	ਰੇਵੰਤ
ರೇಶಿಕಾ	ਰੇਸ਼ਿਕਾ
ರೇಹಾ	ਰੇਹਾ
ರೇಹ್ನುಘಾ	ਰੇਹ੍ਨੁਘਾ
ಲಕೀ	ਲਕੀ
ಲಕ್ಷಾಕೀ	ਲਕ੍ਸ਼ਾਕੀ
ಲಕ್ಷಿತಾ	ਲਕ੍ਸ਼ਿਤਾ
ಲಕ್ಷ್ಮಣಅಪರಣದಾತಾ	ਲਕ੍ਸ਼੍ਮਣਅਪਰਣਦਾਤਾ
ಲಕ್ಷ್ಮೀ	ਲਕ੍ਸ਼੍ਮੀ
ಲಕ್ಷ್ಮೀ   ನಾರಾಯಣ	ਲਕ੍ਸ਼੍ਮੀ   ਨਾਰਾਯਣ
ಲಕ್ಷ್ಮೀನ	ਲਕ੍ਸ਼੍ਮੀਨ
ಲಖಿತ	ਲਖਿਤ
ಲಜ್ಜಕ	ਲਜ੍ਜਕ
ಲಜ್ಜಾ	ਲਜ੍ਜਾ
ಲತಾಕಾರಾ	ਲਤਾਕਾਰਾ
ಲಯನಾ	ਲਯਨਾ
ಲಲಿತಾದಿತ್ಯ	ਲਲਿਤਾਦਿਤ੍ਯ
ಲವಂಗೀ	ਲਵੰਗੀ
ಲವನಾ	ਲਵਨਾ
ಲವಲೀನ	ਲਵਲੀਨ
ಲವಾಮ	ਲਵਾਮ
ಲಾಥಾನಗೀ	ਲਾਥਾਨਗੀ
ಲಾಬನ್ಯ	ਲਾਬਨ੍ਯ
ಲಾಬುಕೀ	ਲਾਬੁਕੀ
ಲಾಭಾ	ਲਾਭਾ
ಲಾರ್ಮಿಕಾ	ਲਾਰ੍ਮਿਕਾ
ಲಾಲಸಾ	ਲਾਲਸਾ
ಲಾಲಾತೇಂದು	ਲਾਲਾਤੇਂਦੁ
ಲಾವನ್ತೀಕಾ	ਲਾਵਨ੍ਤੀਕਾ
ಲಾವಾಲಿಕಾ	ਲਾਵਾਲਿਕਾ
ಲಾಸ್ಯಾವೀ	ਲਾਸ੍ਯਾਵੀ
ಲಿಖಿತ	ਲਿਖਿਤ
ಲಿಮಿಯಾ	ਲਿਮਿਯਾ
ಲೀಗ	ਲੀਗ
ಲೀತೀಶಾ	ਲੀਤੀਸ਼ਾ
ಲೀನಾಥಾ	ਲੀਨਾਥਾ
ಲೀನೀತ	ਲੀਨੀਤ
ಲೀನ್ಗದೇವಾರುಂ	ਲੀਨ੍ਗਦੇਵਾਰੁਂ
ಲೀನ್ಗರಾಜಾ	ਲੀਨ੍ਗਰਾਜਾ
ಲೀನ್ಗೀಃ	ਲੀਨ੍ਗੀ
ಲೀಪಿಕಾ	ਲੀਪਿਕਾ
ಲೀಲಾಮಈ	ਲੀਲਾਮਈ
ಲೀಲಾವತೀ	ਲੀਲਾਵਤੀ
ಲೀಶಾ	ਲੀਸ਼ਾ
ಲುಕೇಶ	ਲੁਕੇਸ਼
ಲುಪೇಶ	ਲੁਪੇਸ਼
ಲೇಈಶಾ	ਲੇਈਸ਼ਾ
ಲೇಕ್ಯಾ	ਲੇਕ੍ਯਾ
ಲೇಕ್ಷಾನಾ	ਲੇਕ੍ਸ਼ਾਨਾ
ಲೇಖಕ	ਲੇਖਕ
ಲೇಖೀಶಾ	ਲੇਖੀਸ਼ਾ
ಲೋಕಪ್ರಕಾಶ	ਲੋਕਪ੍ਰਕਾਸ਼
ಲೋಕಾಕೃತಿ	ਲੋਕਾਕਤਿ
ಲೋಕಾಜನಾನೀ	ਲੋਕਾਜਨਾਨੀ
ಲೋಕಾಧ್ಯಕ್ಷ	ਲੋਕਾਧ੍ਯਕ੍ਸ਼
ಲೋಕ್ಭುಶನ	ਲੋਕ੍ਭੁਸ਼ਨ
ಲೋಕ್ಷೀ	ਲੋਕ੍ਸ਼ੀ
ಲೋಗಚಾನ್ದ್ರಣ	ਲੋਗਚਾਨ੍ਦ੍ਰਣ
ಲೋಗನ	ਲੋਗਨ
ಲೋಗನಾಥನ	ਲੋਗਨਾਥਨ
ಲೋಗೀನೀ	ਲੋਗੀਨੀ
ಲೋಗೇಶ	ਲੋਗੇਸ਼
ಲೋನಾ	ਲੋਨਾ
ಲೋಮಶ	ਲੋਮਸ਼
ಲೋಮಾಂಕೇಶ	ਲੋਮਾਂਕੇਸ਼
ಲೋಲೀಥ್ಯಾ	ਲੋਲੀਥ੍ਯਾ
ಲೋವೇಯಂಶ	ਲੋਵੇਯੰਸ਼
ಲೋಶೀನೀ	ਲੋਸ਼ੀਨੀ
ಲೋಹೀತಾ	ਲੋਹੀਤਾ
ಲೋಹೀತ್ಸರಣ	ਲੋਹੀਤ੍ਸਰਣ
ವಂಶಿಕಾ	ਵੰਸ਼ਿਕਾ
ವಕ್ರತುನ್ಡಾ	ਵਕ੍ਰਤੁਨ੍ਡਾ
ವಕ್ಷ	ਵਕ੍ਸ਼
ವಚನ	ਵਚਨ
ವತ್ಸಲಾ	ਵਤ੍ਸਲਾ
ವರಲಕ್ಷ್ಮೀ	ਵਰਲਕ੍ਸ਼੍ਮੀ
ವರ್ದಾನೀ	ਵਰ੍ਦਾਨੀ
ವರ್ಧಾನೀ	ਵਰ੍ਧਾਨੀ
ವರ್ನೀಥಾ	ਵਰ੍ਨੀਥਾ
ವರ್ಷಾನ	ਵਰ੍ਸ਼ਾਨ
ವಲ್ಲಭೀ	ਵਲ੍ਲਭੀ
ವಶೀತಾ	ਵਸ਼ੀਤਾ
ವಸತೀನ	ਵਸਤੀਨ
ವಸಾ	ਵਸਾ
ವಸೀಸತಾ	ਵਸੀਸਤਾ
ವಸುಧಾ	ਵਸੁਧਾ
ವಸುಮಿತ್ರ	ਵਸੁਮਿਤ੍ਰ
ವಸುರೂಪ	ਵਸੁਰੂਪ
ವಸುಶ	ਵਸੁਸ਼
ವಸ್ಥಾವೀ	ਵਸ੍ਥਾਵੀ
ವಹೀಂ	ਵਹੀਂ
ವಾಕ್ಶಾನಾ	ਵਾਕ੍ਸ਼ਾਨਾ
ವಾಗ್ಮೀನ	ਵਾਗ੍ਮੀਨ
ವಾಜ್ರಕ್ಷ	ਵਾਜ੍ਰਕ੍ਸ਼
ವಾಜ್ರನಾಖಾ	ਵਾਜ੍ਰਨਾਖਾ
ವಾತ್ಸಲ್ರಾಜ	ਵਾਤ੍ਸਲ੍ਰਾਜ
ವಾದಿವೇಲನ	ਵਾਦਿਵੇਲਨ
ವಾದಿವೇಲುಂ	ਵਾਦਿਵੇਲੁਂ
ವಾದೀರಾಜ	ਵਾਦੀਰਾਜ
ವಾನಿಶ್ರೀ	ਵਾਨਿਸ਼੍ਰੀ
ವಾನುಜಾ	ਵਾਨੁਜਾ
ವಾಮನ	ਵਾਮਨ
ವಾಮಾಂಕ್ಷೀ	ਵਾਮਾਂਕ੍ਸ਼ੀ
ವಾಮಿಲ	ਵਾਮਿਲ
ವಾಮ್ಶೀಥಾ	ਵਾਮ੍ਸ਼ੀਥਾ
ವಾಯಾ	ਵਾਯਾ
ವಾಯು	ਵਾਯੁ
ವಾಸನ	ਵਾਸਨ
ವಾಸು	ਵਾਸੁ
ವಾಸುಮಾಂಥಾ	ਵਾਸੁਮਾਂਥਾ
ವಿಅರ	ਵਿਅਰ
ವಿಕ್ಟೋರಿಯಾ	ਵਿਕ੍ਟੋਰਿਯਾ
ವಿಕ್ರಾಂತಿ	ਵਿਕ੍ਰਾਂਤਿ
ವಿಜಯಾಲಕ್ಷ್ಮೀ	ਵਿਜਯਾਲਕ੍ਸ਼੍ਮੀ
ವಿಜೀತಾ	ਵਿਜੀਤਾ
ವಿಜುಲ	ਵਿਜੁਲ
ವಿದಿಶಾ	ਵਿਦਿਸ਼ਾ
ವಿದ್ವಾಥ	ਵਿਦ੍ਵਾਥ
ವಿನತಿ	ਵਿਨਤਿ
ವಿನಸ	ਵਿਨਸ
ವಿನಾ	ਵਿਨਾ
ವಿನಾಥೀ	ਵਿਨਾਥੀ
ವಿನಾಯಿಕಾ	ਵਿਨਾਯਿਕਾ
ವಿನ್ದ್ಯಾ	ਵਿਨ੍ਦ੍ਯਾ
ವಿಭಾಸ	ਵਿਭਾਸ
ವಿಭೀ	ਵਿਭੀ
ವಿಭೂಷ	ਵਿਭੂਸ਼
ವಿಮಲಾ	ਵਿਮਲਾ
ವಿರಬಾಬು	ਵਿਰਬਾਬੁ
ವಿಲಾಸಿನೀ	ਵਿਲਾਸਿਨੀ
ವಿಹಾನೀ	ਵਿਹਾਨੀ
ವಿಹಾರಿಕಾ	ਵਿਹਾਰਿਕਾ
ವೀಅಲಾಶೀನೀ	ਵੀਅਲਾਸ਼ੀਨੀ
ವೇಂಕಟ ಮಾನೀ	ਵੇਂਕਟ ਮਾਨੀ
ವೇತ್ರೀ	ਵੇਤ੍ਰੀ
ವೇದನ್ಜಾನಾ	ਵੇਦਨ੍ਜਾਨਾ
ವೇದಾಂಗ	ਵੇਦਾਂਗ
ವೇದಾತ್ಮನೇ	ਵੇਦਾਤ੍ਮਨੇ
ವೇದಾಸ್ವರೂಪೀ	ਵੇਦਾਸ੍ਵਰੂਪੀ
ವೇದೀಥಾ	ਵੇਦੀਥਾ
ವೇದ್ವಿಯನ	ਵੇਦ੍ਵਿਯਨ
ವೇಧಾವಲ್ಲೀ	ਵੇਧਾਵਲ੍ਲੀ
ವೇನಮಾಂಥೀ	ਵੇਨਮਾਂਥੀ
ವೇನಾ	ਵੇਨਾ
ವೇನೀ	ਵੇਨੀ
ವೇನ್ಕಟಾಗೀರೀ	ਵੇਨ੍ਕਟਾਗੀਰੀ
ವೇನ್ಕಟೇಶಾ	ਵੇਨ੍ਕਟੇਸ਼ਾ
ವೇನ್ಕನಾ	ਵੇਨ੍ਕਨਾ
ವೇಲ್ಕ್ಯ	ਵੇਲ੍ਕ੍ਯ
ವೇವೇಶಾ	ਵੇਵੇਸ਼ਾ
ವೈಗಾ	ਵੈਗਾ
ವೈಜಯಂತೀ	ਵੈਜਯੰਤੀ
ವೈಜಯೀ	ਵੈਜਯੀ
ವೈದಿಕ	ਵੈਦਿਕ
ವೈದೀಕಾ	ਵੈਦੀਕਾ
ವೈಧೇ	ਵੈਧੇ
ವೈಧ್ಯಾತ	ਵੈਧ੍ਯਾਤ
ಶೈಲೇಶ	ਸ਼ੈਲੇਸ਼
ಸಂಗಮ	ਸੰਗਮ
ಸಂಗೀತಾ	ਸੰਗੀਤਾ
ಸಂಚಾನಾ	ਸੰਚਾਨਾ
ಸಂಜಾಣಥೀ	ਸੰਜਾਣਥੀ
ಸಂಜೀವ	ਸੰਜੀਵ
ಸಂಜೀವೀ	ਸੰਜੀਵੀ
ಸಂಜುಕ್ಥಾ	ਸੰਜੁਕ੍ਥਾ
ಸಂಥೀನೀ	ਸੰਥੀਨੀ
ಸಂದೀಪ್ತಾ	ਸੰਦੀਪ੍ਤਾ
ಸಂಧರಾ	ਸੰਧਰਾ
ಸಂಪದಾ	ਸੰਪਦਾ
ಸಂಮತ	ਸੰਮਤ
ಸಕ್ಥೀದಾರ	ਸਕ੍ਥੀਦਾਰ
ಸಖಾ	ਸਖਾ
ಸಗ್ನೀಕ	ਸਗ੍ਨੀਕ
ಸಚ್ಚಿತ	ਸਚ੍ਚਿਤ
ಸಚ್ಚಿದಾನಂದ ವಿಗ್ರಹ	ਸਚ੍ਚਿਦਾਨੰਦ ਵਿਗ੍ਰਹ
ಸಜೂ	ਸਜੂ
ಸದಗತಾ	ਸਦਗਤਾ
ಸನಾತನ	ਸਨਾਤਨ
ಸನಾಥ	ਸਨਾਥ
ಸಫ಼ಲಾ	ਸਫ਼ਲਾ
ಸಫ್ಫರ	ਸਫ੍ਫਰ
ಸಬರಿಶ	ਸਬਰਿਸ਼
ಸಬಿತಾ	ਸਬਿਤਾ
ಸಮಕ್ಷ	ਸਮਕ੍ਸ਼
ಸಮಜ	ਸਮਜ
ಸಮನ್ಯು	ਸਮਨ੍ਯੁ
ಸಮಬರಣ	ਸਮਬਰਣ
ಸಮಭಾವನ	ਸਮਭਾਵਨ
ಸಮಾಂನ್ವಿತಾ	ਸਮਾਂਨ੍ਵਿਤਾ
ಸಮಾಂಶ್ರಯ	ਸਮਾਂਸ਼੍ਰਯ
ಸಮಿಕ	ਸਮਿਕ
ಸಮೀರ	ਸਮੀਰ
ಸಮೀರಾ	ਸਮੀਰਾ
ಸಮುದಾಯ	ਸਮੁਦਾਯ
ಸಮುದ್ರಾ	ਸਮੁਦ੍ਰਾ
ಸಮೇಂದು	ਸਮੇਂਦੁ
ಸಮ್ಪ್ರಸಾದ	ਸਮ੍ਪ੍ਰਸਾਦ
ಸಮ್ಪ್ರಿತೀ	ਸਮ੍ਪ੍ਰਿਤੀ
ಸಮ್ಬತ	ਸਮ੍ਬਤ
ಸಮ್ಮಾದ	ਸਮ੍ਮਾਦ
ಸಮ್ಯಕ	ਸਮ੍ਯਕ
ಸಮ್ಶೀನೀ	ਸਮ੍ਸ਼ੀਨੀ
ಸಮ್ಸ್ಕಾರಾ	ਸਮ੍ਸ੍ਕਾਰਾ
ಸಮ್ಹೀಠಾ	ਸਮ੍ਹੀਠਾ
ಸರಜಾ	ਸਰਜਾ
ಸರಿಶಾ	ਸਰਿਸ਼ਾ
ಸರ್ಗಿನೀ	ਸਰ੍ਗਿਨੀ
ಸಹಶ್ರದ	ਸਹਸ਼੍ਰਦ
ಸಾಈ ಅರ್ಜುನ	ਸਾਈ ਅਰ੍ਜੁਨ
ಸಾಈ ಶ್ರೀ	ਸਾਈ ਸ਼੍ਰੀ
ಸಾಈ ಸತ್ಪುರುಷಾ	ਸਾਈ ਸਤ੍ਪੁਰੁਸ਼ਾ
ಸಾಈ ಸುರಿಯಾ	ਸਾਈ ਸੁਰਿਯਾ
ಸಾತ್ವಿಕ	ਸਾਤ੍ਵਿਕ
ಸಾತ್ವಿಕಾ	ਸਾਤ੍ਵਿਕਾ
ಸಾದರೀ	ਸਾਦਰੀ
ಸಾದ್ವಿಥಾ	ਸਾਦ੍ਵਿਥਾ
ಸಾಧ್ಯ	ਸਾਧ੍ਯ
ಸಾನಾವೀ	ਸਾਨਾਵੀ
ಸಾಬೀತ್ರೀ	ਸਾਬੀਤ੍ਰੀ
ಸಾಮಂತ	ਸਾਮੰਤ
ಸಾಮೋದ	ਸਾਮੋਦ
ಸಾಮ್ರೀನ	ਸਾਮ੍ਰੀਨ
ಸಾಯರಾಮ	ਸਾਯਰਾਮ
ಸಾರಂಗೀ	ਸਾਰੰਗੀ
ಸಾರಸೀ	ਸਾਰਸੀ
ಸಾರಾನ್ಯ	ਸਾਰਾਨ੍ਯ
ಸಾರಾಹ	ਸਾਰਾਹ
ಸಾವಿತ್ರ	ਸਾਵਿਤ੍ਰ
ಸೈಕತ	ਸੈਕਤ
ಸೈಜಾಸೀ	ਸੈਜਾਸੀ
ಸೈನಿ	ਸੈਨਿ
ಸೈನೀತ್ಯ	ਸੈਨੀਤ੍ਯ
ಸೈನ್ಧಾವ	ਸੈਨ੍ਧਾਵ
ಹಂಸಾ	ਹੰਸਾ
ಹಂಸಿನ	ਹੰਸਿਨ
ಹಂಸ್ಧ್ವಾನೀ	ਹੰਸ੍ਧ੍ਵਾਨੀ
ಹಜೇಶ	ਹਜੇਸ਼
ಹನೀತಾ	ਹਨੀਤਾ
ಹನೀಮಾ	ਹਨੀਮਾ
ಹನೀಶ್ಕಾ	ਹਨੀਸ਼੍ਕਾ
ಹಮಸಾನಂದೀನೀ	ਹਮਸਾਨੰਦੀਨੀ
ಹಯಾತೀ	ਹਯਾਤੀ
ಹರನೀಶ	ਹਰਨੀਸ਼
ಹರಿಅಕ್ಸಾ	ਹਰਿਅਕ੍ਸਾ
ಹರಿಕಿಶನ	ਹਰਿਕਿਸ਼ਨ
ಹರಿತ	ਹਰਿਤ
ಹರಿದಾ	ਹਰਿਦਾ
ಹರಿದಾಸ	ਹਰਿਦਾਸ
ಹರಿನ್ದ್ರನಾಥ	ਹਰਿਨ੍ਦ੍ਰਨਾਥ
ಹರಿಪ್ರಸಾದ	ਹਰਿਪ੍ਰਸਾਦ
ಹರಿವಂಶ	ਹਰਿਵੰਸ਼
ಹರೀಜ	ਹਰੀਜ
ಹರೀಥ್ರಾ	ਹਰੀਥ੍ਰਾ
ಹರೀಧಾಮ	ਹਰੀਧਾਮ
ಹರೀಮಾಂರ್ಕಾತಾಮಾಂರ್ಕತಾ	ਹਰੀਮਾਂਰ੍ਕਾਤਾਮਾਂਰ੍ਕਤਾ
ಹರೀಶ್ರೀ	ਹਰੀਸ਼੍ਰੀ
ಹರೀಸಾಈ	ਹਰੀਸਾਈ
ಹರೇಕೃಷ್ಣ	ਹਰੇਕਸ਼੍ਣ
ಹರ್ಕೇಶ	ਹਰ੍ਕੇਸ਼
ಹರ್ಥೀಕಾ	ਹਰ੍ਥੀਕਾ
ಹರ್ಯಾಕ್ಷಾ	ਹਰ੍ਯਾਕ੍ਸ਼ਾ
ಹರ್ಲೇಯ	ਹਰ੍ਲੇਯ
ಹರ್ಶಾಶ್ರೀ	ਹਰ੍ਸ਼ਾਸ਼੍ਰੀ
ಹರ್ಷವರ್ದನ	ਹਰ੍ਸ਼ਵਰ੍ਦਨ
ಹರ್ಷಿತ	ਹਰ੍ਸ਼ਿਤ
ಹವೀಹ	ਹਵੀਹ
ಹಶ್ವರ್ಧನ	ਹਸ਼੍ਵਰ੍ਧਨ
ಹಸಂತ	ਹਸੰਤ
ಹಾಕೇಶ	ਹਾਕੇਸ਼
ಹಾರ್ಶೀನೀ	ਹਾਰ੍ਸ਼ੀਨੀ
ಹಾಸಂಥೀ	ਹਾਸੰਥੀ
ಹಿಡಿಂಬಾ	ਹਿਡਿਂਬਾ
ಹಿತಾಂಶು	ਹਿਤਾਂਸ਼ੁ
ಹಿತಾಂಸೀ	ਹਿਤਾਂਸੀ
ಹಿತೀ	ਹਿਤੀ
ಹಿತೀಕ್ಷಾ	ਹਿਤੀਕ੍ਸ਼ਾ
ಹಿತೇನ್ದ್ರ	ਹਿਤੇਨ੍ਦ੍ਰ
ಹಿತೈಷೀ	ਹਿਤੈਸ਼ੀ
ಹಿಥೀಕ್ಸಾ	ਹਿਥੀਕ੍ਸਾ
ಹಿಮವಂತ	ਹਿਮਵੰਤ
ಹಿಮಾಂಕ	ਹਿਮਾਂਕ
ಹಿಮಾಂನಿಶ	ਹਿਮਾਂਨਿਸ਼
ಹಿಮಾಂನ್ಗೀನೀ	ਹਿਮਾਂਨ੍ਗੀਨੀ
ಹಿಮಾಂಸೇಖರ	ਹਿਮਾਂਸੇਖਰ
ಹಿಮಾದ್ರೀ	ਹਿਮਾਦ੍ਰੀ
ಹಿಮಾನ್ಸು	ਹਿਮਾਨ੍ਸੁ
ಹಿಯಾ	ਹਿਯਾ
ಹಿಲೀ	ਹਿਲੀ
ಹೀಥಾ	ਹੀਥਾ
ಹೀಮೀರ	ਹੀਮੀਰ
ಹುಮೀಶಾ	ਹੁਮੀਸ਼ਾ
ಹುವೇನ್ದ್ರ	ਹੁਵੇਨ੍ਦ੍ਰ
ಹೇತ	ਹੇਤ
ಹೇತವ	ਹੇਤਵ
ಹೇತಾಂಶೀ	ਹੇਤਾਂਸ਼ੀ
ಹೇತ್ವಿಕ	ਹੇਤ੍ਵਿਕ
ಹೇಥಾನ್ಶ್ರೀ	ਹੇਥਾਨ੍ਸ਼੍ਰੀ
ಹೇನಾ	ਹੇਨਾ
ಹೇನೀತ	ਹੇਨੀਤ
ಹೇನ್ಸೀ	ਹੇਨ੍ਸੀ
ಹೇಮ ಲಥಾ	ਹੇਮ ਲਥਾ
ಹೇಮಚಂದರ	ਹੇਮਚੰਦਰ
ಹೇಮಾಕೇಶ	ਹੇਮਾਕੇਸ਼
ಹೇಮೀತಾ	ਹੇਮੀਤਾ
ಹೇಮೀತ್ರಾ	ਹੇਮੀਤ੍ਰਾ
ಹೇಮೀನ	ਹੇਮੀਨ
ಹೇಮೇಂದ್ರ	ਹੇਮੇਂਦ੍ਰ
ಹೇರಕ	ਹੇਰਕ
ಹೇರೀ	ਹੇਰੀ
ಹೇಲಸಾ	ਹੇਲਸਾ
ಹೇಲಾ	ਹੇਲਾ
ಹೇಲ್ಲ್ಯ	ਹੇਲ੍ਲ੍ਯ
ಹೋಜನ	ਹੋਜਨ
ಹೋಯಲಾ	ਹੋਯਲਾ
ಹ್ರೀತೀಕಾ	ਹ੍ਰੀਤੀਕਾ
ಹ್ರೀದೇಶ	ਹ੍ਰੀਦੇਸ਼
ಹ್ರೀದ್ಯೇಸಾ	ਹ੍ਰੀਦ੍ਯੇਸਾ
ಹ್ರೀಶನ	ਹ੍ਰੀਸ਼ਨ
#
#
# Territory names from CLDR
ಅಸೆನ್ಶನ್ ದ್ವೀಪ	ਅਸੇਨ੍ਸ਼ਨ੍ ਦ੍ਵੀਪ
ಅಂಡೋರಾ	ਅਂਡੋਰਾ
ಸಂಯುಕ್ತ ಅರಬ್ ಎಮಿರೇಟಸ್	ਸੰਯੁਕ੍ਤ ਅਰਬ੍ ਏਮਿਰੇਟਸ੍
ಅಫಘಾನಿಸ್ಥಾನ್	ਅਫਘਾਨਿਸ੍ਥਾਨ੍
ಆಂಟಿಗುವಾ ಮತ್ತು ಬರ್ಬುಡಾ	ਆਂਟਿਗੁਵਾ ਮਤ੍ਤੁ ਬਰ੍ਬੁਡਾ
ಆಂಗುಯಿಲ್ಲಾ	ਆਂਗੁਯਿਲ੍ਲਾ
ಅಲ್ಬೇನಿಯಾ	ਅਲ੍ਬੇਨਿਯਾ
ಅರ್ಮೇನಿಯಾ	ਅਰ੍ਮੇਨਿਯਾ
ಅಂಗೋಲಾ	ਅਂਗੋਲਾ
ಅಂಟಾರ್ಟಿಕಾ	ਅਂਟਾਰ੍ਟਿਕਾ
ಅರ್ಜೆಂಟಿನಾ	ਅਰ੍ਜੇਂਟਿਨਾ
ಅಮೇರಿಕನ್ ಸಮೋವಾ	ਅਮੇਰਿਕਨ੍ ਸਮੋਵਾ
ಆಸ್ಟ್ರಿಯಾ	ਆਸ੍ਟ੍ਰਿਯਾ
ಆಸ್ಟ್ರೇಲಿಯ	ਆਸ੍ਟ੍ਰੇਲਿਯ
ಅರುಬಾ	ਅਰੁਬਾ
ಆಲ್ಯಾಂಡ್ ದ್ವೀಪಗಳು	ਆਲ੍ਯਾਂਡ੍ ਦ੍ਵੀਪਗਲੁ
ಅಜರ್ಬೈಜಾನ್	ਅਜਰ੍ਬੈਜਾਨ੍
ಬೋಸ್ನಿಯಾ ಮತ್ತು ಹರ್ಜೆಗೋವಿನಾ	ਬੋਸ੍ਨਿਯਾ ਮਤ੍ਤੁ ਹਰ੍ਜੇਗੋਵਿਨਾ
ಬಾರ್ಬಡೋಸ್	ਬਾਰ੍ਬਡੋਸ੍
ಬಾಂಗ್ಲಾದೇಶ್	ਬਾਂਗ੍ਲਾਦੇਸ਼੍
ಬೆಲ್ಜಿಯಮ್	ਬੇਲ੍ਜਿਯਮ੍
ಬುರ್ಕಿನಾ ಫಾಸೋ	ਬੁਰ੍ਕਿਨਾ ਫਾਸੋ
ಬಲ್ಗೇರಿಯಾ	ਬਲ੍ਗੇਰਿਯਾ
ಬಹರೈನ್	ਬਹਰੈਨ੍
ಬುರುಂಡಿ	ਬੁਰੁਂਡਿ
ಬೆನಿನ್	ਬੇਨਿਨ੍
ಸೇಂಟ್ ಬಾರ್ಥೆಲೆಮಿ	ਸੇਂਟ੍ ਬਾਰ੍ਥੇਲੇਮਿ
ಬರ್ಮುಡಾ	ਬਰ੍ਮੁਡਾ
ಬ್ರೂನಿ	ਬ੍ਰੂਨਿ
ಬೊಲಿವಿಯಾ	ਬੋਲਿਵਿਯਾ
ಕೆರೀಬಿಯನ್ ನೆದರ್‌ಲ್ಯಾಂಡ್ಸ್	ਕੇਰੀਬਿਯਨ੍ ਨੇਦਰ੍‌ਲ੍ਯਾਂਡ੍ਸ੍
ಬ್ರೆಜಿಲ್	ਬ੍ਰੇਜਿਲ੍
ಬಹಾಮಾಸ್	ਬਹਾਮਾਸ੍
ಭೂತಾನ್	ਭੂਤਾਨ੍
ಬೋವೆಟ್ ದ್ವೀಪ	ਬੋਵੇਟ੍ ਦ੍ਵੀਪ
ಬೋಟ್ಸ್‌ವಾನಾ	ਬੋਟ੍ਸ੍‌ਵਾਨਾ
ಬೆಲಾರಸ್	ਬੇਲਾਰਸ੍
ಬೆಲಿಜ್	ਬੇਲਿਜ੍
ಕೆನಡಾ	ਕੇਨਡਾ
ಕೊಕೊಸ್ (ಕೀಲಿಂಗ್) ದ್ವೀಪಗಳು	ਕੋਕੋਸ੍ (ਕੀਲਿਂਗ੍) ਦ੍ਵੀਪਗਲੁ
ಕಾಂಗೋ - ಕಿನ್ಶಾಸಾ	ਕਾਂਗੋ - ਕਿਨ੍ਸ਼ਾਸਾ
ಕಾಂಗೋ (DRC)	ਕਾਂਗੋ (DRC)
ಮಧ್ಯ ಆಫ್ರಿಕಾ ಗಣರಾಜ್ಯ	ਮਧ੍ਯ ਆਫ੍ਰਿਕਾ ਗਣਰਾਜ੍ਯ
ಕಾಂಗೋ - ಬ್ರಾಜಾವಿಲ್ಲೇ	ਕਾਂਗੋ - ਬ੍ਰਾਜਾਵਿਲ੍ਲੇ
ಕಾಂಗೋ (ಗಣರಾಜ್ಯ)	ਕਾਂਗੋ (ਗਣਰਾਜ੍ਯ)
ಸ್ವಿಟ್ಜರ್ಲ್ಯಾಂಡ್	ਸ੍ਵਿਟ੍ਜਰ੍ਲ੍ਯਾਂਡ੍
ಕೋತ್‌ ದಿವಾರ್‍	ਕੋਤ੍‌ ਦਿਵਾਰ੍‍
ಐವರಿ ಕೋಸ್ಟ್	ਐਵਰਿ ਕੋਸ੍ਟ੍
ಕುಕ್ ದ್ವೀಪಗಳು	ਕੁਕ੍ ਦ੍ਵੀਪਗਲੁ
ಚಿಲಿ	ਚਿਲਿ
ಕ್ಯಾಮರೋನ್	ਕ੍ਯਾਮਰੋਨ੍
ಚೀನಾ	ਚੀਨਾ
ಕೊಲಂಬಿಯಾ	ਕੋਲੰਬਿਯਾ
ಕ್ಲಿಪ್ಪರ್‌ಟಾನ್ ದ್ವೀಪಗಳು	ਕ੍ਲਿਪ੍ਪਰ੍‌ਟਾਨ੍ ਦ੍ਵੀਪਗਲੁ
ಕೊಸ್ಟಾ ರಿಕಾ	ਕੋਸ੍ਟਾ ਰਿਕਾ
ಕ್ಯೂಬಾ	ਕ੍ਯੂਬਾ
ಕೇಪ್ ವರ್ಡೆ	ਕੇਪ੍ ਵਰ੍ਡੇ
ಕುರಾಕಾವ್	ਕੁਰਾਕਾਵ੍
ಕ್ರಿಸ್ಮಸ್ ದ್ವೀಪ	ਕ੍ਰਿਸ੍ਮਸ੍ ਦ੍ਵੀਪ
ಸೈಪ್ರಸ್	ਸੈਪ੍ਰਸ੍
ಚೆಕ್ ರಿಪಬ್ಲಿಕ್	ਚੇਕ੍ ਰਿਪਬ੍ਲਿਕ੍
ಜರ್ಮನಿ	ਜਰ੍ਮਨਿ
ಡೈಗೋ ಗಾರ್ಸಿಯ	ਡੈਗੋ ਗਾਰ੍ਸਿਯ
ಜಿಬೋಟಿ	ਜਿਬੋਟਿ
ಡೆನ್ಮಾರ್ಕ್	ਡੇਨ੍ਮਾਰ੍ਕ੍
ಡೊಮಿನಿಕಾ	ਡੋਮਿਨਿਕਾ
ಡೊಮೆನಿಕನ್ ರಿಪಬ್ಲಿಕ್	ਡੋਮੇਨਿਕਨ੍ ਰਿਪਬ੍ਲਿਕ੍
ಅಲ್ಗೇರಿಯಾ	ਅਲ੍ਗੇਰਿਯਾ
ಸೆಯುಟಾ ಹಾಗೂ ಮೆಲಿಲ್ಲಾ	ਸੇਯੁਟਾ ਹਾਗੂ ਮੇਲਿਲ੍ਲਾ
ಈಕ್ವೆಡಾರ್	ਈਕ੍ਵੇਡਾਰ੍
ಎಸ್ಟೋನಿಯಾ	ਏਸ੍ਟੋਨਿਯਾ
ಈಜಿಪ್ಟ್	ਈਜਿਪ੍ਟ੍
ಪಶ್ಚಿಮ ಸಹಾರಾ	ਪਸ਼੍ਚਿਮ ਸਹਾਰਾ
ಏರಿಟ್ರಿಯಾ	ਏਰਿਟ੍ਰਿਯਾ
ಸ್ಪೇನ್	ਸ੍ਪੇਨ੍
ಇಥಿಯೋಪಿಯಾ	ਇਥਿਯੋਪਿਯਾ
ಯುರೋಪಿಯನ್ ಯೂನಿಯನ್	ਯੁਰੋਪਿਯਨ੍ ਯੂਨਿਯਨ੍
ಫಿನ್‌ಲ್ಯಾಂಡ್	ਫਿਨ੍‌ਲ੍ਯਾਂਡ੍
ಫಿಜಿ	ਫਿਜਿ
ಫಾಲ್ಕ್‌ಲ್ಯಾಂಡ್ ದ್ವೀಪಗಳು	ਫਾਲ੍ਕ੍‌ਲ੍ਯਾਂਡ੍ ਦ੍ਵੀਪਗਲੁ
ಫಾಲ್ಕ್‌ಲ್ಯಾಂಡ್ ದ್ವೀಪಗಳು (ಇಸ್ಲಾಸ್ ಮಾಲ್ವಿನಸ್)	ਫਾਲ੍ਕ੍‌ਲ੍ਯਾਂਡ੍ ਦ੍ਵੀਪਗਲੁ (ਇਸ੍ਲਾਸ੍ ਮਾਲ੍ਵਿਨਸ੍)
ಮೈಕ್ರೋನೇಶಿಯಾ	ਮੈਕ੍ਰੋਨੇਸ਼ਿਯਾ
ಫರೋ ದ್ವೀಪಗಳು	ਫਰੋ ਦ੍ਵੀਪਗਲੁ
ಫ್ರಾನ್ಸ್	ਫ੍ਰਾਨ੍ਸ੍
ಗೆಬೊನ್	ਗੇਬੋਨ੍
ಬ್ರಿಟನ್/ಇಂಗ್ಲೆಂಡ್	ਬ੍ਰਿਟਨ੍/ਇਂਗ੍ਲੇਂਡ੍
ಗ್ರೆನೆಡಾ	ਗ੍ਰੇਨੇਡਾ
ಜಾರ್ಜಿಯಾ	ਜਾਰ੍ਜਿਯਾ
ಫ್ರೆಂಚ್ ಗಯಾನಾ	ਫ੍ਰੇਂਚ੍ ਗਯਾਨਾ
ಗುರ್ನ್‌ಸೆ	ਗੁਰ੍ਨ੍‌ਸੇ
ಘಾನಾ	ਘਾਨਾ
ಗಿಬ್ರಾಲ್ಟರ್	ਗਿਬ੍ਰਾਲ੍ਟਰ੍
ಗ್ರೀನ್‌ಲ್ಯಾಂಡ್	ਗ੍ਰੀਨ੍‌ਲ੍ਯਾਂਡ੍
ಗ್ಯಾಂಬಿಯಾ	ਗ੍ਯਾਂਬਿਯਾ
ಗಿನಿ	ਗਿਨਿ
ಗುಡೆಲೋಪ್	ਗੁਡੇਲੋਪ੍
ಈಕ್ವೆಟೋರಿಯಲ್ ಗಿನಿ	ਈਕ੍ਵੇਟੋਰਿਯਲ੍ ਗਿਨਿ
ಗ್ರೀಸ್	ਗ੍ਰੀਸ੍
ದಕ್ಷಿಣ ಜಾರ್ಜಿಯಾ ಮತ್ತು ದಕ್ಷಿಣ ಸ್ಯಾಂಡ್‍ವಿಚ್ ದ್ವೀಪಗಳು	ਦਕ੍ਸ਼ਿਣ ਜਾਰ੍ਜਿਯਾ ਮਤ੍ਤੁ ਦਕ੍ਸ਼ਿਣ ਸ੍ਯਾਂਡ੍‍ਵਿਚ੍ ਦ੍ਵੀਪਗਲੁ
ಗ್ವಾಟೆಮಾಲಾ	ਗ੍ਵਾਟੇਮਾਲਾ
ಗುಯಾಮ್	ਗੁਯਾਮ੍
ಗಿನಿ-ಬಿಸ್ಸಾವ್	ਗਿਨਿ-ਬਿਸ੍ਸਾਵ੍
ಗಯಾನಾ	ਗਯਾਨਾ
ಹಾಂಗ್ ಕಾಂಗ್ SAR ಚೈನಾ	ਹਾਂਗ੍ ਕਾਂਗ੍ SAR ਚੈਨਾ
ಹಾಂಗ್ ಕಾಂಗ್	ਹਾਂਗ੍ ਕਾਂਗ੍
ಹರ್ಡ್ ದ್ವೀಪ ಮತ್ತು ಮ್ಯಾಕ್‍ಡೊನಾಲ್ಡ್ ದ್ವೀಪಗಳು	ਹਰ੍ਡ੍ ਦ੍ਵੀਪ ਮਤ੍ਤੁ ਮ੍ਯਾਕ੍‍ਡੋਨਾਲ੍ਡ੍ ਦ੍ਵੀਪਗਲੁ
ಹೊಂಡುರಾಸ್	ਹੋਂਡੁਰਾਸ੍
ಕ್ರೊಯೇಶಿಯಾ	ਕ੍ਰੋਯੇਸ਼ਿਯਾ
ಹೈಟಿ	ਹੈਟਿ
ಹಂಗಾರಿ	ਹੰਗਾਰਿ
ಕ್ಯಾನರಿ ದ್ವೀಪಗಳು	ਕ੍ਯਾਨਰਿ ਦ੍ਵੀਪਗਲੁ
ಇಂಡೋನೇಶಿಯಾ	ਇਂਡੋਨੇਸ਼ਿਯਾ
ಐರ್ಲೆಂಡ್	ਐਰ੍ਲੇਂਡ੍
ಇಸ್ರೇಲ್	ਇਸ੍ਰੇਲ੍
ಐಲ್ ಆಫ್ ಮ್ಯಾನ್	ਐਲ੍ ਆਫ੍ ਮ੍ਯਾਨ੍
ಭಾರತ	ਭਾਰਤ
ಬ್ರಿಟೀಶ್ ಇಂಡಿಯನ್ ಮಹಾಸಾಗರ ಪ್ರದೇಶ	ਬ੍ਰਿਟੀਸ਼੍ ਇਂਡਿਯਨ੍ ਮਹਾਸਾਗਰ ਪ੍ਰਦੇਸ਼
ಇರಾಕ್	ਇਰਾਕ੍
ಇರಾನ್	ਇਰਾਨ੍
ಐಸ್‌ಲ್ಯಾಂಡ್	ਐਸ੍‌ਲ੍ਯਾਂਡ੍
ಇಟಲಿ	ਇਟਲਿ
ಜೆರ್ಸಿ	ਜੇਰ੍ਸਿ
ಜಮೈಕಾ	ਜਮੈਕਾ
ಜೋರ್ಡಾನ್	ਜੋਰ੍ਡਾਨ੍
ಜಪಾನ್	ਜਪਾਨ੍
ಕೀನ್ಯಾ	ਕੀਨ੍ਯਾ
ಕಿರ್ಗಿಸ್ಥಾನ್	ਕਿਰ੍ਗਿਸ੍ਥਾਨ੍
ಕಾಂಬೋಡಿಯಾ	ਕਾਂਬੋਡਿਯਾ
ಕಿರಿಬಾತಿ	ਕਿਰਿਬਾਤਿ
ಕೊಮೊರೊಸ್	ਕੋਮੋਰੋਸ੍
ಸೇಂಟ್ ಕಿಟ್ಸ್ ಮತ್ತು ನೆವಿಸ್	ਸੇਂਟ੍ ਕਿਟ੍ਸ੍ ਮਤ੍ਤੁ ਨੇਵਿਸ੍
ಉತ್ತರ ಕೋರಿಯಾ	ਉਤ੍ਤਰ ਕੋਰਿਯਾ
ದಕ್ಷಿಣ ಕೋರಿಯಾ	ਦਕ੍ਸ਼ਿਣ ਕੋਰਿਯਾ
ಕುವೈತ್	ਕੁਵੈਤ੍
ಕೇಮನ್ ದ್ವೀಪಗಳು	ਕੇਮਨ੍ ਦ੍ਵੀਪਗਲੁ
ಕಝಾಕಿಸ್ಥಾನ್	ਕਝਾਕਿਸ੍ਥਾਨ੍
ಲಾವೋಸ್	ਲਾਵੋਸ੍
ಲೆಬನಾನ್	ਲੇਬਨਾਨ੍
ಸೇಂಟ್ ಲೂಸಿಯಾ	ਸੇਂਟ੍ ਲੂਸਿਯਾ
ಲಿಚೆನ್‌ಸ್ಟೈನ್	ਲਿਚੇਨ੍‌ਸ੍ਟੈਨ੍
ಶ್ರೀಲಂಕಾ	ਸ਼੍ਰੀਲੰਕਾ
ಲಿಬೇರಿಯಾ	ਲਿਬੇਰਿਯਾ
ಲೆಸೊಥೋ	ਲੇਸੋਥੋ
ಲಿಥುವೇನಿಯಾ	ਲਿਥੁਵੇਨਿਯਾ
ಲಕ್ಸಂಬರ್ಗ್	ਲਕ੍ਸੰਬਰ੍ਗ੍
ಲಾಟ್ವಿಯಾ	ਲਾਟ੍ਵਿਯਾ
ಲಿಬಿಯಾ	ਲਿਬਿਯਾ
ಮೊರಾಕ್ಕೊ	ਮੋਰਾਕ੍ਕੋ
ಮೊನಾಕೊ	ਮੋਨਾਕੋ
ಮೊಲ್ಡೋವಾ	ਮੋਲ੍ਡੋਵਾ
ಮೊಂಟೆನೆಗ್ರೋ	ਮੋਂਟੇਨੇਗ੍ਰੋ
ಸೇಂಟ್ ಮಾರ್ಟಿನ್	ਸੇਂਟ੍ ਮਾਰ੍ਟਿਨ੍
ಮಡಗಾಸ್ಕರ್	ਮਡਗਾਸ੍ਕਰ੍
ಮಾರ್ಷಲ್ ದ್ವೀಪಗಳು	ਮਾਰ੍ਸ਼ਲ੍ ਦ੍ਵੀਪਗਲੁ
ಮ್ಯಾಸಿಡೋನಿಯಾ	ਮ੍ਯਾਸਿਡੋਨਿਯਾ
ಮ್ಯಾಸಿಡೋನಿಯ (FYROM)	ਮ੍ਯਾਸਿਡੋਨਿਯ (FYROM)
ಮಾಲಿ	ਮਾਲਿ
ಮಯನ್ಮಾರ್ (ಬರ್ಮಾ)	ਮਯਨ੍ਮਾਰ੍ (ਬਰ੍ਮਾ)
ಮೊಂಗೋಲಿಯಾ	ਮੋਂਗੋਲਿਯਾ
ಮಖಾವ್ (SAR) ಚೈನಾ	ਮਖਾਵ੍ (SAR) ਚੈਨਾ
ಮಖಾವ್	ਮਖਾਵ੍
ಉತ್ತರ ಮರಿಯಾನಾ ದ್ವೀಪಗಳು	ਉਤ੍ਤਰ ਮਰਿਯਾਨਾ ਦ੍ਵੀਪਗਲੁ
ಮಾರ್ಟಿನಿಕ್	ਮਾਰ੍ਟਿਨਿਕ੍
ಮಾರಿಟೇನಿಯಾ	ਮਾਰਿਟੇਨਿਯਾ
ಮಾಂಟ್‌ಸೆರೇಟ್	ਮਾਂਟ੍‌ਸੇਰੇਟ੍
ಮಾಲ್ಟಾ	ਮਾਲ੍ਟਾ
ಮಾರಿಶಿಯಸ್	ਮਾਰਿਸ਼ਿਯਸ੍
ಮಾಲ್ಡಿವ್ಸ್	ਮਾਲ੍ਡਿਵ੍ਸ੍
ಮಲಾವಿ	ਮਲਾਵਿ
ಮೆಕ್ಸಿಕೊ	ਮੇਕ੍ਸਿਕੋ
ಮಲೇಶಿಯಾ	ਮਲੇਸ਼ਿਯਾ
ಮೊಜಾಂಬಿಕ್	ਮੋਜਾਂਬਿਕ੍
ನಮೀಬಿಯಾ	ਨਮੀਬਿਯਾ
ನ್ಯೂ ಕ್ಯಾಲಿಡೋನಿಯಾ	ਨ੍ਯੂ ਕ੍ਯਾਲਿਡੋਨਿਯਾ
ನೈಜರ್	ਨੈਜਰ੍
ನಾರ್ಫೋಕ್ ದ್ವೀಪ	ਨਾਰ੍ਫੋਕ੍ ਦ੍ਵੀਪ
ನೈಜೀರಿಯಾ	ਨੈਜੀਰਿਯਾ
ನಿಕಾರಾಗುವಾ	ਨਿਕਾਰਾਗੁਵਾ
ನೆದರ್‌ಲ್ಯಾಂಡ್ಸ್	ਨੇਦਰ੍‌ਲ੍ਯਾਂਡ੍ਸ੍
ನಾರ್ವೇ	ਨਾਰ੍ਵੇ
ನೇಪಾಳ	ਨੇਪਾਲ
ನೌರು	ਨੌਰੁ
ನಿಯು	ਨਿਯੁ
ನ್ಯೂಜಿಲೆಂಡ್	ਨ੍ਯੂਜਿਲੇਂਡ੍
ಓಮನ್	ਓਮਨ੍
ಪನಾಮಾ	ਪਨਾਮਾ
ಪೆರು	ਪੇਰੁ
ಫ್ರೆಂಚ್ ಪಾಲಿನೇಷ್ಯಾ	ਫ੍ਰੇਂਚ੍ ਪਾਲਿਨੇਸ਼੍ਯਾ
ಪಪುವಾ ನ್ಯೂಗಿನಿಯಾ	ਪਪੁਵਾ ਨ੍ਯੂਗਿਨਿਯਾ
ಫಿಲಿಫೈನ್ಸ್	ਫਿਲਿਫੈਨ੍ਸ੍
ಪಾಕಿಸ್ತಾನ	ਪਾਕਿਸ੍ਤਾਨ
ಪೋಲ್ಯಾಂಡ್	ਪੋਲ੍ਯਾਂਡ੍
ಸೇಂಟ್ ಪಿಯರೆ ಮತ್ತು ಮಿಕೆಲನ್	ਸੇਂਟ੍ ਪਿਯਰੇ ਮਤ੍ਤੁ ਮਿਕੇਲਨ੍
ಪಿಟ್‌ಕೈರ್ನ್ ದ್ವೀಪಗಳು	ਪਿਟ੍‌ਕੈਰ੍ਨ੍ ਦ੍ਵੀਪਗਲੁ
ಪ್ಯೂರ್ಟೋ ರಿಕೊ	ਪ੍ਯੂਰ੍ਟੋ ਰਿਕੋ
ಪ್ಯಾಲೇಸ್ಟೇನಿಯನ್ ಪ್ರದೇಶ	ਪ੍ਯਾਲੇਸ੍ਟੇਨਿਯਨ੍ ਪ੍ਰਦੇਸ਼
ಪ್ಯಾಲೆಸ್ಟೇನ್	ਪ੍ਯਾਲੇਸ੍ਟੇਨ੍
ಪೋರ್ಚುಗಲ್	ਪੋਰ੍ਚੁਗਲ੍
ಪಲಾವು	ਪਲਾਵੁ
ಪರಾಗ್ವೇ	ਪਰਾਗ੍ਵੇ
ಖತಾರ್	ਖਤਾਰ੍
ಔಟ್ ಲೈಯಿಂಗ್ ಓಷಿಯಾನಿಯಾ	ਔਟ੍ ਲੈਯਿਂਗ੍ ਓਸ਼ਿਯਾਨਿਯਾ
ರೀಯೂನಿಯನ್	ਰੀਯੂਨਿਯਨ੍
ರೊಮೇನಿಯಾ	ਰੋਮੇਨਿਯਾ
ಸೆರ್ಬಿಯಾ	ਸੇਰ੍ਬਿਯਾ
ರಷ್ಯಾ	ਰਸ਼੍ਯਾ
ರುವಾಂಡಾ	ਰੁਵਾਂਡਾ
ಸೌದಿ ಅರೇಬಿಯಾ	ਸੌਦਿ ਅਰੇਬਿਯਾ
ಸೊಲೊಮನ್ ದ್ವೀಪಗಳು	ਸੋਲੋਮਨ੍ ਦ੍ਵੀਪਗਲੁ
ಸೀಶೆಲ್ಲೆಸ್	ਸੀਸ਼ੇਲ੍ਲੇਸ੍
ಸೂಡಾನ್	ਸੂਡਾਨ੍
ಸ್ವೀಡನ್	ਸ੍ਵੀਡਨ੍
ಸಿಂಗಾಪುರ್	ਸਿਂਗਾਪੁਰ੍
ಸೇಂಟ್ ಹೆಲೆನಾ	ਸੇਂਟ੍ ਹੇਲੇਨਾ
ಸ್ಲೋವೇನಿಯಾ	ਸ੍ਲੋਵੇਨਿਯਾ
ಸ್ವಾಲ್ಬಾರ್ಡ್ ಮತ್ತು ಜಾನ್ ಮೆಯನ್	ਸ੍ਵਾਲ੍ਬਾਰ੍ਡ੍ ਮਤ੍ਤੁ ਜਾਨ੍ ਮੇਯਨ੍
ಸ್ಲೋವೇಕಿಯಾ	ਸ੍ਲੋਵੇਕਿਯਾ
ಸಿಯೆರ್ರಾ ಲಿಯೋನ್	ਸਿਯੇਰ੍ਰਾ ਲਿਯੋਨ੍
ಸ್ಯಾನ್ ಮೆರಿನೋ	ਸ੍ਯਾਨ੍ ਮੇਰਿਨੋ
ಸೆನೆಗಲ್	ਸੇਨੇਗਲ੍
ಸೊಮಾಲಿಯಾ	ਸੋਮਾਲਿਯਾ
ಸುರಿನಾಮ	ਸੁਰਿਨਾਮ
ದಕ್ಷಿಣ ಸೂಡಾನ್	ਦਕ੍ਸ਼ਿਣ ਸੂਡਾਨ੍
ಸಾವೋ ಟೋಮ್ ಮತ್ತು ಪ್ರಿನ್ಸಿಪಿ	ਸਾਵੋ ਟੋਮ੍ ਮਤ੍ਤੁ ਪ੍ਰਿਨ੍ਸਿਪਿ
ಎಲ್ ಸಾಲ್ವೇಡಾರ್	ਏਲ੍ ਸਾਲ੍ਵੇਡਾਰ੍
ಸಿಂಟ್ ಮಾರ್ಟೆನ್	ਸਿਂਟ੍ ਮਾਰ੍ਟੇਨ੍
ಸಿರಿಯಾ	ਸਿਰਿਯਾ
ಸ್ವಾಜಿಲ್ಯಾಂಡ್	ਸ੍ਵਾਜਿਲ੍ਯਾਂਡ੍
ಟ್ರಿಸ್ತನ್ ಡಾ ಕುನ್ಹಾ	ਟ੍ਰਿਸ੍ਤਨ੍ ਡਾ ਕੁਨ੍ਹਾ
ಟರ್ಕ್ಸ್ ಮತ್ತು ಕೈಕೋಸ್ ದ್ವೀಪಗಳು	ਟਰ੍ਕ੍ਸ੍ ਮਤ੍ਤੁ ਕੈਕੋਸ੍ ਦ੍ਵੀਪਗਲੁ
ಚಾದ್	ਚਾਦ੍
ಫ್ರೆಂಚ್ ದಕ್ಷಿಣ ಪ್ರದೇಶಗಳು	ਫ੍ਰੇਂਚ੍ ਦਕ੍ਸ਼ਿਣ ਪ੍ਰਦੇਸ਼ਗਲੁ
ಟೋಗೋ	ਟੋਗੋ
ಥೈಲ್ಯಾಂಡ್	ਥੈਲ੍ਯਾਂਡ੍
ತಜಾಕಿಸ್ಥಾನ್	ਤਜਾਕਿਸ੍ਥਾਨ੍
ಟೊಕೆಲಾವ್	ਟੋਕੇਲਾਵ੍
ಪೂರ್ವ ತಿಮೋರ್	ਪੂਰ੍ਵ ਤਿਮੋਰ੍
ಈಸ್ಟ್ ಟಿಮೋರ್	ਈਸ੍ਟ੍ ਟਿਮੋਰ੍
ತುರ್ಕ್ಮೇನಿಸ್ಥಾನ್	ਤੁਰ੍ਕ੍ਮੇਨਿਸ੍ਥਾਨ੍
ಟುನಿಶಿಯಾ	ਟੁਨਿਸ਼ਿਯਾ
ಟೊಂಗ	ਟੋਂਗ
ಟರ್ಕಿ	ਟਰ੍ਕਿ
ಟ್ರಿನಿಡಾಡ್ ಮತ್ತು ಟೊಬಾಗೊ	ਟ੍ਰਿਨਿਡਾਡ੍ ਮਤ੍ਤੁ ਟੋਬਾਗੋ
ಟುವಾಲು	ਟੁਵਾਲੁ
ಥೈವಾನ್	ਥੈਵਾਨ੍
ತಾಂಜೇನಿಯಾ	ਤਾਂਜੇਨਿਯਾ
ಉಕ್ರೈನ್	ਉਕ੍ਰੈਨ੍
ಉಗಾಂಡಾ	ਉਗਾਂਡਾ
ಅಮೇರಿಕಾ ಸಂಯುಕ್ತ ಸಂಸ್ಥಾನ	ਅਮੇਰਿਕਾ ਸੰਯੁਕ੍ਤ ਸੰਸ੍ਥਾਨ
ಉರುಗ್ವೇ	ਉਰੁਗ੍ਵੇ
ಉಜ್ಬೇಕಿಸ್ಥಾನ್	ਉਜ੍ਬੇਕਿਸ੍ਥਾਨ੍
ವ್ಯಾಟಿಕನ್	ਵ੍ਯਾਟਿਕਨ੍
ವೆನೆಜುವೆಲಾ	ਵੇਨੇਜੁਵੇਲਾ
ಬ್ರಿಟಿಷ್ ವರ್ಜಿನ್ ದ್ವೀಪಗಳು	ਬ੍ਰਿਟਿਸ਼੍ ਵਰ੍ਜਿਨ੍ ਦ੍ਵੀਪਗਲੁ
ವಿಯೇಟ್ನಾಮ್	ਵਿਯੇਟ੍ਨਾਮ੍
ವನೌಟು	ਵਨੌਟੁ
ವಾಲಿಸ್ ಮತ್ತು ಫುಟುನಾ	ਵਾਲਿਸ੍ ਮਤ੍ਤੁ ਫੁਟੁਨਾ
ಸಮೋವಾ	ਸਮੋਵਾ
ಕೊಸೊವೊ	ਕੋਸੋਵੋ
ಯೆಮನ್	ਯੇਮਨ੍
ಮಯೊಟ್ಟೆ	ਮਯੋਟ੍ਟੇ
ದಕ್ಷಿಣ ಆಫ್ರಿಕಾ	ਦਕ੍ਸ਼ਿਣ ਆਫ੍ਰਿਕਾ
ಝಾಂಬಿಯಾ	ਝਾਂਬਿਯਾ
ಜಿಂಬಾಬ್ವೆ	ਜਿਂਬਾਬ੍ਵੇ
ಅಜ್ಞಾತ ಪ್ರದೇಶ	ਅਜ੍ਞਾਤ ਪ੍ਰਦੇਸ਼
