# Baby names
ଅକର୍ଯସୁଟ	અકર્યસુટ
ଅଚଲା	અચલા
ଅଚିଟ୍	અચિટ્
ଅଦିତା	અદિતા
ଅଦ୍ବୈଯା	અદ્બૈયા
ଅଫ୍ର	અફ્ર
ଅବିଶ	અબિશ
ଅବ୍ଭିନବ୍	અબ્ભિનબ્
ଅଭିନତ	અભિનત
ଅଭିନିତି	અભિનિતિ
ଅଭିପ୍ରିତି	અભિપ્રિતિ
ଅଭିମନି	અભિમનિ
ଅଭିରତି	અભિરતિ
ଅଭିସର୍	અભિસર્
ଆଅଶ୍ନା	આઅશ્ના
ଆଇଶ୍	આઇશ્
ଆଗନେଯ	આગનેય
ଆଗନେୟା	આગનેય઼ા
ଆଘନ୍ୟା	આઘન્ય઼ા
ଆଟିଶ୍	આટિશ્
ଆଡିତ୍	આડિત્
ଆଡ୍ରିଟି	આડ્રિટિ
ଆତ୍ମିକ	આત્મિક
ଆଦବିକା	આદબિકા
ଆଦିନାଥ୍	આદિનાથ્
ଆଧାବ୍	આધાબ્
ଆନଗଟ୍	આનગટ્
ଆନନ୍ଦସ୍ବରୁପ୍	આનન્દસ્બરુપ્
ଆନଶଲ୍	આનશલ્
ଆନାଲ୍	આનાલ્
ଆପଟ୍	આપટ્
ଆମୁକଥା	આમુકથા
ଆଯୁ	આયુ
ଆରଣା	આરણા
ଆରଥ୍	આરથ્
ଆରବ୍	આરબ્
ଆରଭି	આરભિ
ଆରିଟ୍	આરિટ્
ଆରୁନା	આરુના
ଆରୁଶା	આરુશા
ଆର୍ଥୀ	આર્થી
ଆର୍ନବ୍	આર્નબ્
ଆରୟାନ୍	આરય઼ાન્
ଆରୟାମନ୍	આરય઼ામન્
ଆଲିୟଃ	આલિય઼ઃ
ଆଶାଲତା	આશાલતા
ଆସ୍ତ	આસ્ત
ଆସ୍ମି	આસ્મિ
ଇକ୍ଶିତା	ઇક્શિતા
ଇଟନ୍	ઇટન્
ଇଡିକା	ઇડિકા
ଇନକନ୍ଟା	ઇનકન્ટા
ଇନିଯବନ୍	ઇનિયબન્
ଇନେଶ୍	ઇનેશ્
ଇନ୍ଡରେଶ୍	ઇન્ડરેશ્
ଇନ୍ଡୁକାନ୍ଟ୍	ઇન્ડુકાન્ટ્
ଇନ୍ଡୁଜ୍	ઇન્ડુજ્
ଇନ୍ଡ୍ରଯନି	ઇન્ડ્રયનિ
ଇପ୍ସିଟା	ઇપ્સિટા
ଇବାନ୍କା	ઇબાન્કા
ଇଭ୍ଯା	ઇભ્યા
ଇମ୍ପାଲ୍	ઇમ્પાલ્
ଇମ୍ଲା	ઇમ્લા
ଇରାନା	ઇરાના
ଇରେନ୍ପ୍ରୀଟ୍	ઇરેન્પ્રીટ્
ଇଲବେନିଲ୍	ઇલબેનિલ્
ଇଲିଶା	ઇલિશા
ଇଶା କ୍ରିଟିକ୍	ઇશા ક્રિટિક્
ଇଶି	ઇશિ
ଇଶିର୍	ઇશિર્
ଇସାଇଅରାସୁ	ઇસાઇઅરાસુ
ଇସ୍ଶୁ	ઇસ્શુ
ଇହା	ઇહા
ଇହାମ୍	ઇહામ્
ଈଶାନି	ઈશાનિ
ଉଜାଲା	ઉજાલા
ଉଜ୍ଜାନିନି	ઉજ્જાનિનિ
ଉଟନ୍କା	ઉટન્કા
ଉଟ୍କର୍ଶା	ઉટ્કર્શા
ଉଡାନ୍ଟିକା	ઉડાન્ટિકા
ଉଡିଶା	ઉડિશા
ଉଡେଯ୍	ઉડેય્
ଉଡ୍ଡିଶ୍	ઉડ્ડિશ્
ଉଡ୍ଯମ୍	ઉડ્યમ્
ଉତାମି	ઉતામિ
ଉତିରା	ઉતિરા
ଉନ୍ନତିଶ୍	ઉન્નતિશ્
ଉନ୍ନଭ୍	ઉન્નભ્
ଉନ୍ନିକ୍ରିଶ୍ନନ୍	ઉન્નિક્રિશ્નન્
ଉନ୍ମାଇବିଲମ୍ବି	ઉન્માઇબિલમ્બિ
ଉପାନ୍ଶୁ	ઉપાન્શુ
ଉପେନ୍ଡ୍ରା	ઉપેન્ડ્રા
ଉପ୍ଜୀତ୍	ઉપ્જીત્
ଉପ୍ମା	ઉપ્મા
ଉମା	ઉમા
ଉର୍ବଶି	ઉર્બશિ
ଉର୍ବଶୀ	ઉર્બશી
ଉର୍ବିଶ୍	ઉર્બિશ્
ଉଶା ଲକ୍ଶି	ઉશા લક્શિ
ଉଶ୍ନିସିନ୍	ઉશ્નિસિન્
ଉସ୍ରି	ઉસ્રિ
ଊର୍ଜିଟ୍	ઊર્જિટ્
ଏଇରାବଟି	એઇરાબટિ
ଏକଚକ୍ରା	એકચક્રા
ଏକଚନ୍ଡ୍ର	એકચન્ડ્ર
ଏକଚିତ୍	એકચિત્
ଏକବିରା	એકબિરા
ଏକଲିଙା	એકલિઙા
ଏକ୍ଟା	એક્ટા
ଏକ୍ଲବ୍ଯ	એક્લબ્ય
ଏଗୈଅରସୁ	એગૈઅરસુ
ଏଡୋମ୍	એડોમ્
ଏଦସ୍	એદસ્
ଏରା	એરા
ଏଲବେନ୍ଦନ୍	એલબેન્દન્
ଏଲିକା	એલિકા
ଏଲିଲ୍ବେନ୍ଡନ୍	એલિલ્બેન્ડન્
ଏଶଞା	એશઞા
ଏଶନି	એશનિ
ଏଶନ୍ଶ୍	એશન્શ્
ଏଶ୍ନି	એશ્નિ
ଏଶ୍ମା	એશ્મા
ଓଜାସ୍ବୁଇଟା	ઓજાસ્બુઇટા
ଓଜାସ୍ବୁଇନି	ઓજાસ્બુઇનિ
ଓବିଶ୍କର୍	ઓબિશ્કર્
ଓମାନା	ઓમાના
ଓମାର୍ଜୀଟ୍	ઓમાર્જીટ્
ଓମ୍ଜା	ઓમ્જા
ଓମ୍ଡୁଟ୍ଟ୍	ઓમ્ડુટ્ટ્
କଟେଲ୍ଯ୍ନ୍	કટેલ્ય્ન્
କନକବଟି	કનકબટિ
କନିସା	કનિસા
କନ୍ଡର୍ପା	કન્ડર્પા
କନ୍ନକି	કન્નકિ
କନ୍ଶ୍	કન્શ્
କନ୍ହୈଯାଲାଲ୍	કન્હૈયાલાલ્
କପିଲେଶ୍	કપિલેશ્
କପୀଶ୍	કપીશ્
କପୀଶ୍ବୁଅର୍	કપીશ્બુઅર્
କବଲ୍	કબલ્
କବିତା	કબિતા
କବିନଯା	કબિનયા
କମଲ୍ନଯନ୍	કમલ્નયન્
କମେଶ୍ବୁଅର୍	કમેશ્બુઅર્
କମୋଡ୍	કમોડ્
କଯଲ୍ବିଲି	કયલ્બિલિ
କରିଶ୍ମା	કરિશ્મા
କରୁନାକର୍	કરુનાકર્
କରୋନା	કરોના
କର୍ଟାର୍	કર્ટાર્
କର୍ତି	કર્તિ
କର୍ତୀକ୍	કર્તીક્
କର୍ହିକ୍	કર્હિક્
କଲବତି	કલબતિ
କଲୈଅରସି	કલૈઅરસિ
କଲ୍ପା	કલ્પા
କଲ୍ବା	કલ્બા
କଶିଶ୍	કશિશ્
କଶ୍ମିରା	કશ્મિરા
କସିଶ୍	કસિશ્
କସ୍ନି	કસ્નિ
କସ୍ସମଲି	કસ્સમલિ
କହର୍	કહર્
କହ୍ଲିମା	કહ્લિમા
କାକଲି	કાકલિ
କାକୋଲି	કાકોલિ
କାକ୍ଶା	કાક્શા
କାଜୋଲ୍	કાજોલ્
କାଡନ୍ମ୍ବରି	કાડન્મ્બરિ
କାନ୍ଟି	કાન્ટિ
କାଲିକା	કાલિકા
କାଲିଚରନ୍	કાલિચરન્
କାଲିନ୍ଡି	કાલિન્ડિ
କାଲିଯା	કાલિયા
କାଲିରନ୍ଜନ୍	કાલિરન્જન્
କୈରବ୍	કૈરબ્
କୈଲାସ୍	કૈલાસ્
କୌଶିକା	કૌશિકા
କୌଶ୍ଲେନ୍ଡେର୍	કૌશ્લેન્ડેર્
ଗଙାଡଟ୍ଟ୍	ગઙાડટ્ટ્
ଗଙେଶ୍	ગઙેશ્
ଗଜନନ	ગજનન
ଗଜାନନ୍ଡ୍	ગજાનન્ડ્
ଗଜ୍ରୁପ୍	ગજ્રુપ્
ଗନଦ୍ଯକ୍ଶିନା	ગનદ્યક્શિના
ଗନରାଜ୍	ગનરાજ્
ଗମ୍ଭିର୍	ગમ્ભિર્
ଗରିଶିଟ୍	ગરિશિટ્
ଗରିଶ୍ଟ୍	ગરિશ્ટ્
ଗରୁଡ୍	ગરુડ્
ଗାର୍ଗୀ	ગાર્ગી
ଗିଟାନ୍ଜଲି	ગિટાન્જલિ
ଗିଟିକା	ગિટિકા
ଗିବ୍ସୋନ୍	ગિબ્સોન્
ଗିରିଜନନ୍ଡନ୍	ગિરિજનન્ડન્
ଗିରିଶରନ୍	ગિરિશરન્
ଗୀଟାନ୍ଜଲି	ગીટાન્જલિ
ଗୀଟାସ୍ରି	ગીટાસ્રિ
ଗୀତିକା	ગીતિકા
ଗୁନସେକରନ୍	ગુનસેકરન્
ଗୁନିତା	ગુનિતા
ଗୁଫାମ୍	ગુફામ્
ଗୁରୁ	ગુરુ
ଗୁରୁ ଗୁଗନ୍	ગુરુ ગુગન્
ଗୁରୁସାରନ୍	ગુરુસારન્
ଗେଯା	ગેયા
ଗୋଉରଙି	ગોઉરઙિ
ଗୋଟମ୍	ગોટમ્
ଗୋଡବରି	ગોડબરિ
ଗୋପାଲ୍	ગોપાલ્
ଗୋପିନାତନ୍	ગોપિનાતન્
ଗୋପୁ	ગોપુ
ଗୋବିଲ୍	ગોબિલ્
ଗୋରଖ୍	ગોરખ્
ଗୋଲୋଚନ୍	ગોલોચન્
ଗୌରଂଗୀ	ગૌરંગી
ଗ୍ନନଲିଆ	ગ્નનલિઆ
ଗ୍ଯାନା	ગ્યાના
ଗ୍ରହିଲ୍	ગ્રહિલ્
ଗ୍ରିତେଶ୍	ગ્રિતેશ્
ଘନମଲିକା	ઘનમલિકા
ଘନଲିଙା	ઘનલિઙા
ଘୁଲିକା	ઘુલિકા
ଚଟୁର୍ଭୁଜା	ચટુર્ભુજા
ଚଟୁର୍ଭୁଜ୍	ચટુર્ભુજ્
ଚନ୍ଚଲା	ચન્ચલા
ଚନ୍ଡା ବର୍ମନ୍	ચન્ડા બર્મન્
ଚନ୍ଡେର୍	ચન્ડેર્
ଚନ୍ଡ୍ରକାନ୍ଟା	ચન્ડ્રકાન્ટા
ଚନ୍ଡ୍ରକିର୍ତି	ચન્ડ્રકિર્તિ
ଚନ୍ଡ୍ରଡିଟ୍ଯା	ચન્ડ્રડિટ્યા
ଚନ୍ଡ୍ରନାତ୍	ચન્ડ્રનાત્
ଚନ୍ଡ୍ରପ୍ରକାଶ୍	ચન્ડ્રપ્રકાશ્
ଚନ୍ଡ୍ରବାତି	ચન્ડ્રબાતિ
ଚନ୍ଡ୍ରମୋଉଲି	ચન્ડ્રમોઉલિ
ଚନ୍ଡ୍ରଲେଖା	ચન્ડ્રલેખા
ଚନ୍ଡ୍ରସହୋଡରି	ચન્ડ્રસહોડરિ
ଚନ୍ଡ୍ରାକିରନ୍	ચન્ડ્રાકિરન્
ଚନ୍ଡ୍ରେଯୀ	ચન્ડ્રેયી
ଚନ୍ଡ୍ର୍ପୀଡ୍	ચન્ડ્ર્પીડ્
ଚମ୍ପା	ચમ્પા
ଚମ୍ପିକା	ચમ્પિકા
ଚରନ୍ଜୀଟ୍	ચરન્જીટ્
ଚରନ୍ଡେବ୍	ચરન્ડેબ્
ଚରିଟା	ચરિટા
ଚରୁପ୍ରଭା	ચરુપ્રભા
ଚରୁଲେଖା	ચરુલેખા
ଚରୁଶିଲା	ચરુશિલા
ଚାଯା	ચાયા
ଚିଟ୍ରିଟା	ચિટ્રિટા
ଚିଡକଶ୍	ચિડકશ્
ଚିଡାନନ୍ଡ୍	ચિડાનન્ડ્
ଚିତ୍ରା	ચિત્રા
ଚିନ୍କଲ୍	ચિન્કલ્
ଚିନ୍ଟନା	ચિન્ટના
ଚିନ୍ଟନିକା	ચિન્ટનિકા
ଚିନ୍ଟଲ୍	ચિન્ટલ્
ଚିନ୍ମଯୁ	ચિન્મયુ
ଚିରନ୍ଜିବ୍	ચિરન્જિબ્
ଚିରନ୍ଜୀବି	ચિરન્જીબિ
ଚିରୁ	ચિરુ
ଚୁଟ୍କି	ચુટ્કિ
ଚେଟକ୍	ચેટક્
ଚେନ୍ନା	ચેન્ના
ଚେମ୍ମଲ୍	ચેમ્મલ્
ଚେରିତ୍	ચેરિત્
ଚେଲନ୍	ચેલન્
ଚେଲିଯନ୍	ચેલિયન્
ଚେଲୁବା	ચેલુબા
ଚୈଟ୍ରା	ચૈટ્રા
ଚୈନ୍	ચૈન્
ଚୋଲାନ୍	ચોલાન્
ଚ୍ହଯାନ୍କ୍	ચ્હયાન્ક્
ଜଗଟି	જગટિ
ଜଗଟ୍ଗୁରୁ	જગટ્ગુરુ
ଜଗଡମ୍ବିକା	જગડમ્બિકા
ଜଗଡ୍ବନ୍ଡୁ	જગડ્બન્ડુ
ଜଗନ୍ନାତନ୍	જગન્નાતન્
ଜଗନ୍ମଯୀ	જગન્મયી
ଜଗ୍ଜିବନ୍	જગ્જિબન્
ଜଗ୍ଜୀବନ୍	જગ્જીબન્
ଜନକିଭୁଶନ୍	જનકિભુશન્
ଜନଦର୍ନ୍	જનદર્ન્
ଜନାନି	જનાનિ
ଜନାର୍ଦନା	જનાર્દના
ଜମୁନା	જમુના
ଜଯ ପ୍ରଟୀକ୍	જય પ્રટીક્
ଜଯ ପ୍ରିଯା	જય પ્રિયા
ଜଯପୋର୍ନା	જયપોર્ના
ଜଯସ୍ରି	જયસ્રિ
ଜଯାନନ୍ଡ୍	જયાનન્ડ્
ଜଯ୍କିଶନ୍	જય્કિશન્
ଜଯ୍ସ୍ରୀ	જય્સ્રી
ଜଲକ୍	જલક્
ଜଲନ୍ହିଲି	જલન્હિલિ
ଜଲ୍ଦର୍	જલ્દર્
ଜଶି	જશિ
ଜଶୋଡା	જશોડા
ଜସମିଟ୍	જસમિટ્
ଜସ୍ବୁଇତା	જસ્બુઇતા
ଜସ୍ମେର୍	જસ્મેર્
ଜାଗ୍ରୁଟି	જાગ્રુટિ
ଜାନବି	જાનબિ
ଜାନ୍	જાન્
ଜାନ୍ଜର୍	જાન્જર્
ଜାବିଅନ୍	જાબિઅન્
ଜାବେଶ୍	જાબેશ્
ଜାହି	જાહિ
ଜିଗନଶା	જિગનશા
ଜିଗ୍ଯାଶା	જિગ્યાશા
ଜିତ୍ଯା	જિત્યા
ଜିନ୍ସ୍ଯ୍	જિન્સ્ય્
ଜିବଟି	જિબટિ
ଜିଯା ଉଶସ୍	જિયા ઉશસ્
ଜିଶା	જિશા
ଜୀବିଟା	જીબિટા
ଜୀବ୍ନୀ	જીબ્ની
ଜେନିଶା	જેનિશા
ଜେନ୍ସ୍ଯ୍	જેન્સ્ય્
ଜେଯରଟ୍ନମ୍	જેયરટ્નમ્
ଜେଲସ୍ମି	જેલસ્મિ
ଜେସ୍ରି	જેસ્રિ
ଜେହନ୍ନଜ୍	જેહન્નજ્
ଜୈଚନ୍ଡ୍ରନ୍	જૈચન્ડ્રન્
ଜୈଟୈଶ୍	જૈટૈશ્
ଜୈଡଯାଲ୍	જૈડયાલ્
ଜୈନନ୍ଡ୍	જૈનન્ડ્
ଜୈନିଶ୍	જૈનિશ્
ଜୈନେଶ୍	જૈનેશ્
ଜୈବୀର୍	જૈબીર્
ଜୈବୁଅନ୍ଟ୍	જૈબુઅન્ટ્
ଜୈମନ୍	જૈમન્
ଜୈଶନ୍କର୍	જૈશન્કર્
ଜୈସୁଦନ୍	જૈસુદન્
ଜୋଲ୍ଯ୍	જોલ્ય્
ଝିନୁକ୍	ઝિનુક્
ଝିଲ୍ମିଲ୍	ઝિલ્મિલ્
ଟିଟିର୍	ટિટિર્
ଟିଲୋଟ୍ଟମା	ટિલોટ્ટમા
ଟିସ୍ଟା	ટિસ્ટા
ଟେଜସ୍ବୁଇନ୍	ટેજસ્બુઇન્
ଟୋଶନ୍	ટોશન્
ଟ୍ରୈଲୋକ୍ବା	ટ્રૈલોક્બા
ଡଦିଜା	ડદિજા
ଡବୀଟ୍	ડબીટ્
ଡାନିଶ୍	ડાનિશ્
ଣିଲାନ୍ଜନା	ણિલાન્જના
ତଙାଡୁରାଇ	તઙાડુરાઇ
ତଙାମନି	તઙામનિ
ତଙାରାଜ୍	તઙારાજ્
ତତ୍ବ	તત્બ
ତନଯ୍ମୀ	તનય્મી
ତନିଆ	તનિઆ
ତନିଗାଇ	તનિગાઇ
ତନିଶ୍କ	તનિશ્ક
ତନିଶ୍ତା	તનિશ્તા
ତନୁଜ୍	તનુજ્
ତନୋଜ୍	તનોજ્
ତନ୍ଶୁ	તન્શુ
ତପସ୍ଯା	તપસ્યા
ତବୁ	તબુ
ତମୋଘ୍ନା	તમોઘ્ના
ତରକାର୍ ସେର୍ରୋନ୍	તરકાર્ સેર્રોન્
ତରକ୍	તરક્
ତରଶ	તરશ
ତରାନିକା	તરાનિકા
ତର୍ଜ୍ନି	તર્જ્નિ
ତର୍ପନ୍	તર્પન્
ତର୍ଲି	તર્લિ
ତର୍ଶିନି	તર્શિનિ
ତଶ୍ବି	તશ્બિ
ତହାନ୍	તહાન્
ତାରା	તારા
ତିଇବ୍ଯେଶ୍	તિઇબ્યેશ્
ତିବ୍ଯାନ୍	તિબ્યાન્
ତିରୁଚନ୍ଡ୍ରା	તિરુચન્ડ્રા
ତୀକ୍ଶିକ	તીક્શિક
ତୀନିଶ୍	તીનિશ્
ତୁମ୍କି	તુમ્કિ
ତେଜସ୍	તેજસ્
ତେଜସ୍ବ୍ବିତ	તેજસ્બ્બિત
ତେଜି	તેજિ
ତେଜୋବିକସ୍	તેજોબિકસ્
ତେଜ୍	તેજ્
ତେଶିନୀ	તેશિની
ତୋମୋଗ୍ନା	તોમોગ્ના
ତ୍ରିଲୂକାମନ୍	ત્રિલૂકામન્
ତ୍ରିଲୋକ୍	ત્રિલોક્
ତ୍ରିଶ୍	ત્રિશ્
ତ୍ରେଶା	ત્રેશા
ଦକ୍ଶକ୍	દક્શક્
ଦକ୍ଶେଶ୍	દક્શેશ્
ଦଜ୍ଶି	દજ્શિ
ଦଞଟା	દઞટા
ଦଞ୍ଟା	દઞ્ટા
ଦଟ୍ଟଟ୍ରି	દટ્ટટ્રિ
ଦନନ୍ଜଯ୍	દનન્જય્
ଦନଶ୍ରି	દનશ્રિ
ଦନିଏଲ୍	દનિએલ્
ଦନିଶ୍ଟା	દનિશ્ટા
ଦନିଶ୍ତା	દનિશ્તા
ଦନୁଶ୍	દનુશ્
ଦନୁଶ୍ରି	દનુશ્રિ
ଦନେଶି	દનેશિ
ଦନ୍ବି	દન્બિ
ଦବିନ୍	દબિન્
ଦବୀନା	દબીના
ଦଯନିଟା	દયનિટા
ଦଯମଯୀ	દયમયી
ଦଯରାମ୍	દયરામ્
ଦରହସି	દરહસિ
ଦର୍ମେନ୍ଦର୍	દર્મેન્દર્
ଦର୍ରେନ୍	દર્રેન્
ଦସା	દસા
ଦାମିନି	દામિનિ
ଦୀକ୍ଶି	દીક્શિ
ଦୀନା	દીના
ଦୀପକ୍ରାଜ୍	દીપક્રાજ્
ଦୀପଶ୍ରି	દીપશ્રિ
ଦୀପେଶ୍	દીપેશ્
ଦୀପ୍ଟିକା	દીપ્ટિકા
ଦୀପ୍ଟିମୋଯୀ	દીપ્ટિમોયી
ଦୀପ୍ମାଲା	દીપ્માલા
ଦୀପ୍ଯୋଗ୍	દીપ્યોગ્
ଦୀଶ୍ନା	દીશ્ના
ଦୀହେର୍	દીહેર્
ଦେକ୍ଶିତ୍	દેક્શિત્
ଦେନିଶ୍	દેનિશ્
ଦେବ ପ୍ରିଯା	દેબ પ્રિયા
ଦେବର୍ପନା	દેબર્પના
ଦେବାର୍ଟି	દેબાર્ટિ
ଦେବିକ୍	દેબિક્
ଦେବିଡାସ୍	દેબિડાસ્
ଦେବିଲାଲ୍	દેબિલાલ્
ଦେବେନ୍	દેબેન્
ଦେବେନ୍ଡ୍ରନାତ୍	દેબેન્ડ્રનાત્
ଦେବେନ୍ଡ୍ରଶିକା	દેબેન્ડ્રશિકા
ଦେବେଶି	દેબેશિ
ଦେବ୍ ନରେନ୍	દેબ્ નરેન્
ଦେବ୍କି	દેબ્કિ
ଦେବ୍ଜନି	દેબ્જનિ
ଦେବ୍ଯଶି	દેબ્યશિ
ଦେଲୀନା	દેલીના
ଦେଶ୍ନୀ	દેશ્ની
ଦେହଯ୍	દેહય્
ଦୈବି	દૈબિ
ଦୈବିକ୍	દૈબિક્
ନକ୍ଶା	નક્શા
ନଖ୍ରାଜ୍	નખ્રાજ્
ନଗନାତ୍	નગનાત્
ନଗାନ୍ଜଲି	નગાન્જલિ
ନଗ୍ଗର୍	નગ્ગર્
ନଗ୍ଦର୍	નગ્દર્
ନଙୈ	નઙૈ
ନଚ୍ନି	નચ્નિ
ନଟ୍ରାଜ୍	નટ્રાજ્
ନଡୀଶ୍	નડીશ્
ନନ୍ଡି	નન્ડિ
ନବନୀତା	નબનીતા
ନବରାଜ୍	નબરાજ્
ନବରାନ୍ଜନି	નબરાન્જનિ
ନବିନା	નબિના
ନବିନ୍ଡ୍	નબિન્ડ્
ନବିଲ୍	નબિલ્
ନବୁଅଲ୍	નબુઅલ્
ନବେଶା	નબેશા
ନବ୍କର୍	નબ્કર્
ନବ୍କିରନ୍	નબ્કિરન્
ନବ୍କୁନ୍ଜ୍	નબ્કુન્જ્
ନବ୍ଯା ଦୁର୍ଗା	નબ્યા દુર્ગા
ନଭଯନ୍	નભયન્
ନଭା	નભા
ନଭିଜ୍	નભિજ્
ନଭିତା	નભિતા
ନମି	નમિ
ନମିଟା	નમિટા
ନମିଟ୍	નમિટ્
ନମିତା	નમિતા
ନମିଶା	નમિશા
ନମ୍ଡେବ୍	નમ્ડેબ્
ନରସିମ୍ହା	નરસિમ્હા
ନରେନ୍ଡ୍ରନ୍	નરેન્ડ્રન્
ନର୍ମଡ୍	નર્મડ્
ନର୍ରେଶ୍	નર્રેશ્
ନଲିନାକ୍ଶ୍	નલિનાક્શ્
ନାଇଟିକ୍	નાઇટિક્
ନାଲନ୍	નાલન્
ନାଲବେନ୍ଭା	નાલબેન્ભા
ନିକ୍କି	નિક્કિ
ନିଦି	નિદિ
ନିଲମ୍ବରି	નિલમ્બરિ
ନୀଇଲ୍	નીઇલ્
ନୀଜା	નીજા
ନୀତୁ	નીતુ
ନୀରାଜା	નીરાજા
ନୀଲବତି	નીલબતિ
ନୀଲବ୍ଜା	નીલબ્જા
ନୀଲମେଗନ୍	નીલમેગન્
ନୀଲଯା	નીલયા
ନୀଲୁ	નીલુ
ନୀଲ୍	નીલ્
ନୀଲ୍ମାଦବ୍	નીલ્માદબ્
ନୀହା	નીહા
ନେଟ୍ରାବଟି	નેટ્રાબટિ
ନେଡୁମରନ୍	નેડુમરન્
ନେମି	નેમિ
ନେର୍ଯା	નેર્યા
ନେଲ୍ବିନ୍	નેલ્બિન્
ନୈମିଶ୍	નૈમિશ્
ପଝନନ୍ଡାବର୍	પઝનન્ડાબર્
ପତଲା	પતલા
ପତୋଜ୍	પતોજ્
ପତ୍ରଲିକା	પત્રલિકા
ପଦାମବତି	પદામબતિ
ପଦ୍ମଜା	પદ્મજા
ପଦ୍ମବସା	પદ્મબસા
ପଦ୍ମମଲଧର	પદ્મમલધર
ପଦ୍ମଯନି	પદ્મયનિ
ପଦ୍ମାଗ୍ରିହ	પદ્માગ્રિહ
ପଦ୍ମାମୁଖୀ	પદ્મામુખી
ପଦ୍ମୋଡ୍ଭବ	પદ્મોડ્ભબ
ପଦ୍ମ୍	પદ્મ્
ପନିଟା	પનિટા
ପନ୍କଜା	પન્કજા
ପନ୍ଖୁଡି	પન્ખુડિ
ପନ୍ଖୁରି	પન્ખુરિ
ପନ୍ଚଜନା	પન્ચજના
ପନ୍ଚାବକ୍ଟ୍ରା	પન્ચાબક્ટ્રા
ପନ୍ଡୁ	પન્ડુ
ପନ୍ନାଲାଲ୍	પન્નાલાલ્
ପବନ୍ କୁମାର୍	પબન્ કુમાર્
ପବିକରାନ୍	પબિકરાન્
ପବେଶ୍	પબેશ્
ପବ୍ଲୀନ୍	પબ્લીન્
ପରବାସୁ	પરબાસુ
ପରବି	પરબિ
ପରବ୍	પરબ્
ପରମାର୍ତା	પરમાર્તા
ପରମେସ୍ବୁଅରି	પરમેસ્બુઅરિ
ପରିକା	પરિકા
ପରିକେତ୍	પરિકેત્
ପରିଜଟ୍	પરિજટ્
ପରିତୋଶ୍	પરિતોશ્
ପରିସା	પરિસા
ପର୍ଦୁ	પર્દુ
ପର୍ନାଦ୍	પર્નાદ્
ପର୍ନାଲ୍	પર્નાલ્
ପର୍ନି	પર્નિ
ପର୍ନିତା	પર્નિતા
ପର୍ବି	પર્બિ
ପର୍ବୁଇନ୍ଡେର୍	પર્બુઇન્ડેર્
ପର୍ମିତା	પર્મિતા
ପର୍ମେଶ୍ବୁଅର୍	પર્મેશ્બુઅર્
ପର୍ଶ୍ବା	પર્શ્બા
ପଲକ୍	પલક્
ପଲକ୍ଶି	પલક્શિ
ପଲାନି କୁମାର୍	પલાનિ કુમાર્
ପଲ୍ବିଶ୍	પલ્બિશ્
ପାଚକ୍	પાચક્
ପାବକି	પાબકિ
ପାବନ୍	પાબન્
ପାର୍ତନ୍	પાર્તન્
ପାର୍ତିଭ୍	પાર્તિભ્
ପାର୍ବଟିନନ୍ଡନ୍	પાર્બટિનન્ડન્
ପିଯାଶା	પિયાશા
ପିଯୁଶା	પિયુશા
ପୀଟଶ୍ମା	પીટશ્મા
ପୂଜିତା	પૂજિતા
ପୂବିତନା	પૂબિતના
ପୂରିକା	પૂરિકા
ପେର୍ନିତା	પેર્નિતા
ପୋଉଶାଲି	પોઉશાલિ
ପ୍ରଭା	પ્રભા
ପ୍ରଭାବତ୍ଯ୍	પ્રભાબત્ય્
ପ୍ରାନ୍ବି	પ્રાન્બિ
ଫନିଶ୍ବୁଅର୍	ફનિશ્બુઅર્
ଫଲାନି	ફલાનિ
ଫେରଲ୍	ફેરલ્
ବକ୍ରାଭୁଜ୍	બક્રાભુજ્
ବକ୍ରୁତ୍	બક્રુત્
ବଗ୍ମିନେ	બગ્મિને
ବଟୁକ୍	બટુક્
ବତତ୍ମଜ୍	બતત્મજ્
ବତ୍ସ୍ଯଯନ୍	બત્સ્યયન્
ବନବରାଯନ୍	બનબરાયન્
ବନାର୍	બનાર્
ବନିନି	બનિનિ
ବନିଲା	બનિલા
ବନିସ୍ରୀ	બનિસ્રી
ବନ୍କା	બન્કા
ବନ୍ଦୁ	બન્દુ
ବନ୍ବିହାରି	બન્બિહારિ
ବନ୍ଭଟ୍ଟ୍	બન્ભટ્ટ્
ବନ୍ମାଲା	બન્માલા
ବନ୍ମ୍ଜଲଜ୍	બન્મ્જલજ્
ବନ୍ଶି	બન્શિ
ବନ୍ଶିଟା	બન્શિટા
ବନ୍ଶିଲ୍	બન્શિલ્
ବନ୍ସରି	બન્સરિ
ବବଞା	બબઞા
ବମାନିଏ	બમાનિએ
ବମ୍ସି	બમ્સિ
ବମ୍ସୀ	બમ્સી
ବଯୁନ୍	બયુન્
ବରଦବିନଯକା	બરદબિનયકા
ବରଲକ୍ଶ୍ମି	બરલક્શ્મિ
ବରୁନ୍	બરુન્
ବରେନ୍ଡ୍ରା	બરેન્ડ્રા
ବର୍ଚେକା	બર્ચેકા
ବର୍ଦମାନ୍	બર્દમાન્
ବର୍ଦାନ୍	બર્દાન્
ବର୍ନିକା	બર્નિકા
ବର୍ଶନା	બર્શના
ବର୍ଶନି	બર્શનિ
ବର୍ଶିକା	બર્શિકા
ବଲାବନ୍	બલાબન્
ବଲେନ୍ଡୁ	બલેન્ડુ
ବଲ୍ମେକି	બલ્મેકિ
ବଲ୍ଲକି	બલ્લકિ
ବଲ୍ଲି	બલ્લિ
ବସନ୍ଟାପ୍ରଭା	બસન્ટાપ્રભા
ବସନ୍ଟି	બસન્ટિ
ବସନ୍ତ୍	બસન્ત્
ବସବି	બસબિ
ବସବ୍	બસબ્
ବସୁପତି	બસુપતિ
ବସ୍ଟିନ୍	બસ્ટિન્
ବାଗ୍ଡେବି	બાગ્ડેબિ
ବାଚି	બાચિ
ବାନି	બાનિ
ବାଲା ଗୋବିନ୍ଡ୍	બાલા ગોબિન્ડ્
ବାଲ୍ ଗୋପଲ୍	બાલ્ ગોપલ્
ବାସି	બાસિ
ବାସୁଦା	બાસુદા
ବାସୁଲକ୍ଶ୍ମି	બાસુલક્શ્મિ
ବିତିକା	બિતિકા
ବିଭା	બિભા
ବିଲ୍ବୁଆସ୍ରି	બિલ્બુઆસ્રિ
ବିଶ୍ନୁ	બિશ્નુ
ବୀଦାସ୍ରୀ	બીદાસ્રી
ବୀନାବନି	બીનાબનિ
ବୀରସୁନ୍ଡରି	બીરસુન્ડરિ
ବୁଆମନ୍	બુઆમન્
ବୁଆମିକା	બુઆમિકા
ବୁବନା	બુબના
ବେଡାନ୍	બેડાન્
ବେଡାନ୍ଶି	બેડાન્શિ
ବେଡିତା	બેડિતા
ବେଦା	બેદા
ବେମ୍ବରାସି	બેમ્બરાસિ
ବେଲ୍	બેલ્
ବୈଜାଯନ୍ଟି	બૈજાયન્ટિ
ବୈଡିଶ୍	બૈડિશ્
ବୈଦିକ୍	બૈદિક્
ବୈନବି	બૈનબિ
ବୈବଟ୍	બૈબટ્
ବୈରବି	બૈરબિ
ବୈଶାଲି	બૈશાલિ
ବୈଶେକା	બૈશેકા
ବୈଶ୍ନବି	બૈશ્નબિ
ବୈଶ୍ନୋଦେବି	બૈશ્નોદેબિ
ବୈଶ୍ନୋବ୍	બૈશ્નોબ્
ବ୍ରିଜା	બ્રિજા
ବ୍ରିତ୍ହି	બ્રિત્હિ
ବ୍ରିଶା	બ્રિશા
ବ୍ରୁନ୍ଡା	બ્રુન્ડા
ଭନଦବ୍ଯା	ભનદબ્યા
ଭଶ୍ବିକା	ભશ્બિકા
ଭସ୍କରା	ભસ્કરા
ଭାwନା	ભાwના
ଭାଗ୍ବୁଅଟି	ભાગ્બુઅટિ
ଭାଗ୍ବୁଅନ୍ଟି	ભાગ્બુઅન્ટિ
ଭାଗ୍ଯ	ભાગ્ય
ଭାଗ୍ଯନନ୍ଡନା	ભાગ્યનન્ડના
ଭାଗ୍ଯଶ୍ରି	ભાગ્યશ્રિ
ଭାବଲନ୍	ભાબલન્
ଭାବିକ୍	ભાબિક્
ଭାରବି	ભારબિ
ଭାସ୍କରି	ભાસ્કરિ
ଭାସ୍ବୁଅତ୍	ભાસ્બુઅત્
ଭିଶ୍ମା	ભિશ્મા
ଭୁମା	ભુમા
ଭୌଟିକ୍	ભૌટિક્
ଭୌମି	ભૌમિ
ଭ୍ରିତି	ભ્રિતિ
ଭ୍ରୁହନ୍ତ୍	ભ્રુહન્ત્
ମଗନ୍	મગન્
ମଙଲମ୍	મઙલમ્
ମଙଲା	મઙલા
ମଙିରି	મઙિરિ
ମଙୈ	મઙૈ
ମଡନ୍ମୋହନ୍	મડન્મોહન્
ମଡୁର୍	મડુર્
ମଦୁ ବିନ୍ଡୁ	મદુ બિન્ડુ
ମଦୁକ୍	મદુક્
ମଦୁଚନ୍ଡା	મદુચન્ડા
ମଦୁନିକା	મદુનિકા
ମଦୁମଯ୍	મદુમય્
ମଦୁମିତା	મદુમિતા
ମଦୁରି	મદુરિ
ମନସ୍ବି	મનસ્બિ
ମନସ୍ବୁଇନି	મનસ્બુઇનિ
ମନିଟ୍	મનિટ્
ମନିତା	મનિતા
ମନିନ୍ଡ୍ରା	મનિન્ડ્રા
ମନିମୋଝି	મનિમોઝિ
ମନିରାମ୍	મનિરામ્
ମନୀଟ୍	મનીટ્
ମନୋଜ୍ନା	મનોજ્ના
ମନ୍ଜିରି	મન્જિરિ
ମନ୍ଜୁଲ୍	મન્જુલ્
ମନ୍ଡରା	મન્ડરા
ମନ୍ଡର୍ମଲିକା	મન્ડર્મલિકા
ମନ୍ଡାବି	મન્ડાબિ
ମନ୍ତିକା	મન્તિકા
ମମତି	મમતિ
ମମ୍ତା	મમ્તા
ମଲିନି	મલિનિ
ମଲ୍ଲି	મલ્લિ
ମଲ୍ଲୁ	મલ્લુ
ମଲ୍ଲେଶମ୍	મલ્લેશમ્
ମଲ୍ଲେଶ୍	મલ્લેશ્
ମହାକାଲ୍	મહાકાલ્
ମହାକ୍ରମ୍	મહાક્રમ્
ମହାଗୌରି	મહાગૌરિ
ମହାଜୀଟ୍	મહાજીટ્
ମହାଞା	મહાઞા
ମହାଟେଜସ୍	મહાટેજસ્
ମହାଡେବ୍	મહાડેબ્
ମହାତି	મહાતિ
ମହାନନ୍ଡ୍	મહાનન્ડ્
ମହାନ୍ଟ୍	મહાન્ટ્
ମହାନ୍ତି	મહાન્તિ
ମହାବାଲା	મહાબાલા
ମହାଭଡ୍ରା	મહાભડ્રા
ମହାମନି	મહામનિ
ମହାରନ୍ତ୍	મહારન્ત્
ମହାଲ୍ଯା	મહાલ્યા
ମହାଶ୍ରି	મહાશ્રિ
ମହିରା	મહિરા
ମହିର୍	મહિર્
ମହେନ୍ଡ୍ରା	મહેન્ડ્રા
ମହେଶ୍ବୁଅର୍	મહેશ્બુઅર્
ମହେସ୍ବୁଅରି	મહેસ્બુઅરિ
ମହ୍ନବ୍	મહ્નબ્
ମାକାଲି	માકાલિ
ମାଞଟା	માઞટા
ମାନବ୍	માનબ્
ମାନିକାନ୍ଟ୍	માનિકાન્ટ્
ମାଲ୍ବିକା	માલ્બિકા
ମୈଟ୍ରଯୀ	મૈટ્રયી
ଯକ୍ଶିଟା	યક્શિટા
ଯକ୍ଶିତ୍	યક્શિત્
ଯଗ୍ନକଯା	યગ્નકયા
ଯଟିଶ୍	યટિશ્
ଯତି	યતિ
ଯତିଶ୍	યતિશ્
ଯଯିନ୍	યયિન્
ଯଶବୁଇନି	યશબુઇનિ
ଯଶାଶ୍ରୀ	યશાશ્રી
ଯଶାସ୍ବି	યશાસ્બિ
ଯଶି	યશિ
ଯଶ୍ ରାଜ୍	યશ્ રાજ્
ଯଶ୍ବନ୍ତ୍	યશ્બન્ત્
ଯଶ୍ରୀ	યશ્રી
ଯସ୍ବୁଅନ୍ତ୍	યસ્બુઅન્ત્
ଯାଗ୍ଯାସେନ୍	યાગ્યાસેન્
ଯାଜଟ୍	યાજટ્
ଯାଟୁଦନି	યાટુદનિ
ଯାଡାବେନ୍ଡ୍ରା	યાડાબેન્ડ્રા
ଯାମାହିଲ୍	યામાહિલ્
ଯାମୁନା	યામુના
ଯାମ୍ଯା	યામ્યા
ଯାହ୍ବି	યાહ્બિ
ଯୁକସ୍ରି	યુકસ્રિ
ଯୁଗନ୍ଶ୍	યુગન્શ્
ଯୁଗେନ୍ଡେର୍	યુગેન્ડેર્
ଯୁବନ୍ ସୁର୍ଯା	યુબન્ સુર્યા
ଯୁବରାନି	યુબરાનિ
ଯୁବାରାମ୍	યુબારામ્
ଯୁବିନ୍	યુબિન્
ଯୁବ୍ରାନି	યુબ્રાનિ
ଯେଇଗବନ୍	યેઇગબન્
ଯେଘରାଜ୍	યેઘરાજ્
ଯେତର୍ତ୍	યેતર્ત્
ଯେମା	યેમા
ଯେସ୍ବୁଅନ୍ତ୍	યેસ્બુઅન્ત્
ଯେସ୍ବୁଇନ୍	યેસ્બુઇન્
ଯୋଗାଜି	યોગાજિ
ଯୋଗୀଟା	યોગીટા
ଯୋହନ୍	યોહન્
ରକଶ୍ନ୍ଡା	રકશ્ન્ડા
ରକ୍ଶଟି	રક્શટિ
ରକ୍ଶିନା	રક્શિના
ରଘୁନନ୍ଡନ୍	રઘુનન્ડન્
ରଘୁନାତ୍	રઘુનાત્
ରଙିତ୍	રઙિત્
ରଜନିକାନ୍ଟା	રજનિકાન્ટા
ରଜନ୍ଞା	રજન્ઞા
ରଟନା	રટના
ରଟ୍ନା ପ୍ରିଯା	રટ્ના પ્રિયા
ରଟ୍ନାଜ୍ଯୋଟି	રટ્નાજ્યોટિ
ରଟ୍ନାବଲି	રટ્નાબલિ
ରତ୍ନା	રત્ના
ରନିଶ୍	રનિશ્
ରନ୍ଜନି	રન્જનિ
ରନ୍ଜଯ୍	રન્જય્
ରନ୍ଜୁ	રન્જુ
ରନ୍ବିତା	રન્બિતા
ରବିପ୍ରଭା	રબિપ્રભા
ରବିଯାନ୍କି	રબિયાન્કિ
ରବେକ୍	રબેક્
ରମନୁଜମ୍	રમનુજમ્
ରମାକାନ୍ଟ୍	રમાકાન્ટ્
ରମାଦେବି	રમાદેબિ
ରମୈଅହ୍	રમૈઅહ્
ରମ୍ଯଦେବି	રમ્યદેબિ
ରଶିକା	રશિકા
ରଶିଲା	રશિલા
ରଶ୍ବୁଇନା	રશ્બુઇના
ରଶ୍ମିନ୍	રશ્મિન્
ରସୁଲ୍	રસુલ્
ରହାମ୍	રહામ્
ରହ୍ନି	રહ્નિ
ରାଓସହେବ୍	રાઓસહેબ્
ରାକା	રાકા
ରାଗେଶ୍	રાગેશ્
ରାଘବା	રાઘબા
ରାଘବ୍	રાઘબ્
ରାଜଲକ୍ଶ୍ମି	રાજલક્શ્મિ
ରାଜାରମନ୍	રાજારમન્
ରାଜାରମେଶ୍	રાજારમેશ્
ରାଜେଶ୍ରମ୍	રાજેશ્રમ્
ରାଜ୍	રાજ્
ରାଜ୍ କିରନ୍	રાજ્ કિરન્
ରାଜ୍କଲା	રાજ્કલા
ରାଝନ୍ସ୍	રાઝન્સ્
ରାଧା କ୍ରିଶ୍ନା	રાધા ક્રિશ્ના
ରାମୋଜି	રામોજિ
ରାମ୍	રામ્
ରାମ୍ଗୋପାଲ୍	રામ્ગોપાલ્
ରାମ୍ସାଗର୍	રામ્સાગર્
ରାହୁଲ୍ରାଜ୍	રાહુલ્રાજ્
ରୀଟ୍	રીટ્
ରୀତନା	રીતના
ରୀନା	રીના
ରୀମା	રીમા
ରେବନ୍ତି	રેબન્તિ
ରେବନ୍ତିକା	રેબન્તિકા
ରେମିତା	રેમિતા
ରେଶିତା	રેશિતા
ରେହେଇଲା	રેહેઇલા
ରୈନା	રૈના
ଲକ୍ଶନା	લક્શના
ଲକ୍ଶା	લક્શા
ଲକ୍ଶିଟା	લક્શિટા
ଲକ୍ଶ୍ମି	લક્શ્મિ
ଲକ୍ଶ୍ମି ପ୍ରିଯା	લક્શ્મિ પ્રિયા
ଲଜ୍ଜବୁଅଟି	લજ્જબુઅટિ
ଲଜ୍ବଟି	લજ્બટિ
ଲଜ୍ବନ୍ଟି	લજ્બન્ટિ
ଲତା	લતા
ଲନିବନ୍	લનિબન્
ଲବନା	લબના
ଲବିନ୍	લબિન્
ଲବ୍ଯ୍	લબ્ય્
ଲମ୍ବକର୍ନା	લમ્બકર્ના
ଲରଞା	લરઞા
ଲରିନା	લરિના
ଲଲମ୍	લલમ્
ଲଲିଟ୍ମୋହନ୍	લલિટ્મોહન્
ଲଲିଟ୍ରାଜ୍	લલિટ્રાજ્
ଲସିକ୍	લસિક્
ଲହାରି	લહારિ
ଲାଲିଟ୍ଯା	લાલિટ્યા
ଲାଲିମା	લાલિમા
ଲାସ୍ଯା	લાસ્યા
ଲିଙେଶ୍	લિઙેશ્
ଲିନିଶା	લિનિશા
ଲିମିଶା	લિમિશા
ଲିଯାନା	લિયાના
ଲିଲା	લિલા
ଲିଲାଦର୍	લિલાદર્
ଲିଶନ୍ତ୍	લિશન્ત્
ଲୀଲବୁଅଟି	લીલબુઅટિ
ଲୁନି	લુનિ
ଲୁମ୍ବିକା	લુમ્બિકા
ଲୁମ୍ବିନି	લુમ્બિનિ
ଲୁହିଟ୍	લુહિટ્
ଲୂକେଶ୍ବୁଅରି	લૂકેશ્બુઅરિ
ଲେଖିଶା	લેખિશા
ଲେଖ୍ଯା	લેખ્યા
ଲେନିଶା	લેનિશા
ଲେପକ୍ଶ୍	લેપક્શ્
ଲେମା	લેમા
ଲୋଉକ୍ଯା	લોઉક્યા
ଲୋକକ୍ରିଟି	લોકક્રિટિ
ଲୋକିନି	લોકિનિ
ଲୋକେଶ୍ବୁଅରନ୍	લોકેશ્બુઅરન્
ଲୋକ୍ପ୍ରକାଶ୍	લોક્પ્રકાશ્
ଲୋଗିଟା	લોગિટા
ଲୋବେଶ୍	લોબેશ્
ଲୋମଶ୍	લોમશ્
ଲୋହିଟା	લોહિટા
ସକଲେଶ୍ବୁଅର୍	સકલેશ્બુઅર્
ସଙିଟା	સઙિટા
ସଙିନି	સઙિનિ
ସଚନ୍ଡ୍ରା	સચન્ડ્રા
ସଚି	સચિ
ସଚିଡାନନ୍ଡ୍	સચિડાનન્ડ્
ସଚିନ୍	સચિન્
ସଚିନ୍ଡେଓ	સચિન્ડેઓ
ସଚେଟନ୍	સચેટન્
ସଡାର୍	સડાર્
ସଡାଶିବା	સડાશિબા
ସଡିଶ୍	સડિશ્
ସଡ୍ଗଟି	સડ્ગટિ
ସଡ୍ଗୁରୁ	સડ્ગુરુ
ସଦନା	સદના
ସନ୍କରି	સન્કરિ
ସନ୍ଜନ	સન્જન
ସନ୍ଜିଟା	સન્જિટા
ସବରୀଶ୍	સબરીશ્
ସବିତା	સબિતા
ସବୁରି	સબુરિ
ସବ୍ରଙ୍	સબ્રઙ્
ସଭ୍ଯା	સભ્યા
ସଭ୍ରନ୍ଟ୍	સભ્રન્ટ્
ସମଞା	સમઞા
ସମତା	સમતા
ସମିକା	સમિકા
ସମେନ୍	સમેન્
ସମେଶ୍	સમેશ્
ସମ୍ବିତି	સમ્બિતિ
ସମ୍ବିତ୍	સમ્બિત્
ସମ୍ବୁଡ୍ଦା	સમ્બુડ્દા
ସମ୍ବୋଦ୍	સમ્બોદ્
ସମ୍ଯତା	સમ્યતા
ସମ୍ରିଡ୍ଦା	સમ્રિડ્દા
ସଲେନା	સલેના
ସଲୋଖ୍	સલોખ્
ସଲୋହି	સલોહિ
ସହଡେବ୍	સહડેબ્
ସହ୍ଡେବ୍	સહ્ડેબ્
ସାଇ ଆନନ୍ଡ୍	સાઇ આનન્ડ્
ସାଇ କୁମାରି	સાઇ કુમારિ
ସାଇ କୁମାର୍	સાઇ કુમાર્
ସାଇ ବାନି	સાઇ બાનિ
ସାଇ ସର୍ବେଶ୍	સાઇ સર્બેશ્
ସାଇଯ୍ଯାନ୍	સાઇય્યાન્
ସାଜିତ୍	સાજિત્
ସାଜିଲି	સાજિલિ
ସାଟ୍ବିକ୍	સાટ્બિક્
ସାନିଦ୍ଯା	સાનિદ્યા
ସାନିଯା	સાનિયા
ସାରାନ୍ଶ୍	સારાન્શ્
ସାହସ୍ଟ୍ରାଜିଟ୍	સાહસ્ટ્રાજિટ્
ସାହିଟ୍ଯା	સાહિટ્યા
ସାହିରାମ୍	સાહિરામ્
ସାହିଲ୍	સાહિલ્
ସାହୁଲ୍	સાહુલ્
ସୈଜଯାନି	સૈજયાનિ
ସୈଜାସି	સૈજાસિ
ସୈଜିଲ୍	સૈજિલ્
ସୈନାତ୍	સૈનાત્
ସୈନିଟ୍	સૈનિટ્
ସୈହିଶ୍	સૈહિશ્
ହନିମା	હનિમા
ହନିଶା	હનિશા
ହନିଶ୍	હનિશ્
ହନୀଶା	હનીશા
ହନୁମନ୍ଟା	હનુમન્ટા
ହବିହ୍	હબિહ્
ହମ୍ସାନନ୍ଡି	હમ્સાનન્ડિ
ହମ୍ସିକା	હમ્સિકા
ହରିକିଶନ୍	હરિકિશન્
ହରିଟେଜା	હરિટેજા
ହରିତା	હરિતા
ହରିତ୍	હરિત્
ହରିଦ	હરિદ
ହରିନା	હરિના
ହରିନାରାଯନ୍	હરિનારાયન્
ହରିପେଅସାଡ୍	હરિપેઅસાડ્
ହରିମନ୍ଟି	હરિમન્ટિ
ହରେଶ୍	હરેશ્
ହର୍କେଶ୍	હર્કેશ્
ହର୍ଟେଇଜ୍	હર્ટેઇજ્
ହର୍ବି	હર્બિ
ହର୍ଶଲା	હર્શલા
ହର୍ଶିତା	હર્શિતા
ହର୍ଶିତ୍	હર્શિત્
ହର୍ଶ୍ ବୀର୍	હર્શ્ બીર્
ହର୍ଶ୍ନିଲ୍	હર્શ્નિલ્
ହର୍ସିକା	હર્સિકા
ହଶ୍ମିତା	હશ્મિતા
ହଶ୍ରୀ	હશ્રી
ହସିଟା	હસિટા
ହସିନା	હસિના
ହସ୍ତା	હસ્તા
ହସ୍ବିତା	હસ્બિતા
ହସ୍ମିତା	હસ્મિતા
ହାରିତ୍	હારિત્
ହିଟେନ୍ଡ୍ରା	હિટેન્ડ્રા
ହିତେଶ୍	હિતેશ્
ହିମା	હિમા
ହିମାଗୋଉରି	હિમાગોઉરિ
ହିମାଘ୍ନା	હિમાઘ્ના
ହିମାନ୍ସୁ	હિમાન્સુ
ହିମାବନ୍ତ୍	હિમાબન્ત્
ହିରଞଦା	હિરઞદા
ହିରନ୍ମଯି	હિરન્મયિ
ହିରନ୍ମଯ୍	હિરન્મય્
ହିରିଶା	હિરિશા
ହିର୍ବୁଅ	હિર્બુઅ
ହିଲ୍ଲା	હિલ્લા
ହୀଟ୍ରାଜ୍	હીટ્રાજ્
ହୀନା	હીના
ହୀର୍ବ	હીર્બ
ହେଇଡି	હેઇડિ
ହେଟବ୍	હેટબ્
ହେଟୁ	હેટુ
ହେଟ୍ବୀକ୍	હેટ્બીક્
ହେଟ୍ସ୍ଯା	હેટ્સ્યા
ହେତନ୍ଶି	હેતન્શિ
ହେନଲ୍	હેનલ્
ହେମଙିନି	હેમઙિનિ
ହେମନ୍ଟ୍	હેમન્ટ્
ହେମନ୍ତ୍	હેમન્ત્
ହେମନ୍ତ୍ସ୍ରୀ	હેમન્ત્સ્રી
ହେମପ୍ରସାଡ୍	હેમપ્રસાડ્
ହେମବଟିନନ୍ଡନ୍	હેમબટિનન્ડન્
ହେମସ୍ରି	હેમસ્રિ
ହେମିଶା	હેમિશા
ହେମ୍କେଶ୍	હેમ્કેશ્
ହେମ୍କ୍ରିଶ୍	હેમ્ક્રિશ્
ହେମ୍ରାଜ୍	હેમ્રાજ્
ହେରକ୍	હેરક્
ହୋନ୍ହାର୍	હોન્હાર્
ହ୍ରିଦ୍ଯା	હ્રિદ્યા
#
#
# Territory names from CLDR
ଆଣ୍ଡୋରା	આણ્ડોરા
ସଂଯୁକ୍ତ ଆରବ ଏମିରେଟସ୍	સંયુક્ત આરબ એમિરેટસ્
ଆଫାଗାନିସ୍ତାନ୍	આફાગાનિસ્તાન્
ଆଣ୍ଟିଗୁଆ ଏବଂ ବାରବୁଦା	આણ્ટિગુઆ એબં બારબુદા
ଆଙ୍ଗୁଇଲ୍ଲା	આઙ્ગુઇલ્લા
ଆଲବାନିଆ	આલબાનિઆ
ଆର୍ମେନିଆ	આર્મેનિઆ
ଆଙ୍ଗୋଲା	આઙ્ગોલા
ଆର୍ଣ୍ଟକଟିକା	આર્ણ્ટકટિકા
ଆର୍ଜେଣ୍ଟିନା	આર્જેણ્ટિના
ଆମେରିକାନ୍ ସାମୋଆ	આમેરિકાન્ સામોઆ
ଅଷ୍ଟ୍ରିଆ	અષ્ટ્રિઆ
ଅଷ୍ଟ୍ରେଲିଆ	અષ્ટ્રેલિઆ
ଆରୁବା	આરુબા
ଆଲାଣ୍ଡ ଆଇସଲ୍ୟାଣ୍ଡ	આલાણ્ડ આઇસલ્ય઼ાણ્ડ
ଆଜେରବାଇଜାନ୍	આજેરબાઇજાન્
ବୋସନିଆ ଏବଂ ହର୍ଜଗୋଭିନା	બોસનિઆ એબં હર્જગોભિના
ବାରବାଡୋସ୍	બારબાડોસ્
ବାଙ୍ଗଲାଦେଶ୍	બાઙ્ગલાદેશ્
ବେଲଜିୟମ୍	બેલજિય઼મ્
ବୁର୍କିନୋ ଫାସୋ	બુર્કિનો ફાસો
ବୁଲଗେରିଆ	બુલગેરિઆ
ବାହାରିନ୍	બાહારિન્
ବୁରୁନ୍ଦି	બુરુન્દિ
ବେନିନ୍	બેનિન્
ସେଣ୍ଟ ବାର୍ଥେଲେମି	સેણ્ટ બાર્થેલેમિ
ବରମୁଡା	બરમુડા
ବ୍ରୁନେଇ	બ્રુનેઇ
ବୋଲଭିଆ	બોલભિઆ
ବ୍ରାଜିଲ୍	બ્રાજિલ્
ବାହାମାସ୍	બાહામાસ્
ଭୁଟାନ୍	ભુટાન્
ବୌଭେଟ୍ ଆଇସଲ୍ୟାଣ୍ଡ	બૌભેટ્ આઇસલ્ય઼ાણ્ડ
ବୋଟସ୍ବାନ୍	બોટસ્બાન્
ବେଲାରୁଷ୍	બેલારુષ્
ବେଲିଜ୍	બેલિજ્
କାନାଡା	કાનાડા
କୋକୋସ୍ ଆଇସଲ୍ୟାଣ୍ଡ	કોકોસ્ આઇસલ્ય઼ાણ્ડ
କଙ୍ଗୋ-କିନସାସା	કઙ્ગો-કિનસાસા
ମଧ୍ୟ ଆଫ୍ରିକୀୟ ଗଣତନ୍ତ୍ର	મધ્ય઼ આફ્રિકીય઼ ગણતન્ત્ર
କଙ୍ଗୋ-ବ୍ରାଜିଭିଲ୍ଲେ	કઙ્ગો-બ્રાજિભિલ્લે
ସ୍ବିଜରଲ୍ୟାଣ୍ଡ	સ્બિજરલ્ય઼ાણ્ડ
ଆଇବରୀ କୋଷ୍ଟ	આઇબરી કોષ્ટ
କୁକ୍ ଆଇସଲ୍ୟାଣ୍ଡ	કુક્ આઇસલ્ય઼ાણ્ડ
ଚିଲ୍ଲୀ	ચિલ્લી
କାମେରୁନ୍	કામેરુન્
ଚିନ୍	ચિન્
କୋଲମ୍ବିଆ	કોલમ્બિઆ
କୋଷ୍ଟା ରିକା	કોષ્ટા રિકા
କ୍ୱିବା	ક્વિબા
କେପ୍ ଭର୍ଦେ	કેપ્ ભર્દે
ଖ୍ରୀଷ୍ଟମାସ ଆଇଲ୍ୟାଣ୍ଡ	ખ્રીષ્ટમાસ આઇલ્ય઼ાણ્ડ
ସାଇପ୍ରସ୍	સાઇપ્રસ્
ଚେକ୍ ସାଧାରଣତନ୍ତ୍ର	ચેક્ સાધારણતન્ત્ર
ଜର୍ମାନୀ	જર્માની
ଡିବୌଟି	ડિબૌટિ
ଡେନମାର୍କ	ડેનમાર્ક
ଡୋମିନାକା	ડોમિનાકા
ଡୋମିନକାନ୍ ପ୍ରଜାତନ୍ତ୍ର	ડોમિનકાન્ પ્રજાતન્ત્ર
ଆଲଜେରିଆ	આલજેરિઆ
ଇକ୍ୱାଡୋର୍	ઇક્વાડોર્
ଏସ୍ତୋନିଆ	એસ્તોનિઆ
ଇଜିପ୍ଟ	ઇજિપ્ટ
ପଶ୍ଚିମ ସାହାରା	પશ્ચિમ સાહારા
ଇରିଟ୍ରିୟା	ઇરિટ્રિય઼ા
ସ୍ପେନ୍	સ્પેન્
ଇଥିଓପିଆ	ઇથિઓપિઆ
ୟୁରୋପିଆନ୍ ୟୁନିଅନ୍	ય઼ુરોપિઆન્ ય઼ુનિઅન્
ଫିନଲ୍ୟାଣ୍ଡ	ફિનલ્ય઼ાણ્ડ
ଫିଜି	ફિજિ
ଫଲ୍କଲ୍ୟାଣ୍ଡ ଦ୍ବୀପପୁଞ୍ଜ	ફલ્કલ્ય઼ાણ્ડ દ્બીપપુઞ્જ
ମାଇକ୍ରୋନେସିଆ	માઇક્રોનેસિઆ
ଫାରୋଇ ଦ୍ବୀପପୁଞ୍ଜ	ફારોઇ દ્બીપપુઞ્જ
ଫ୍ରାନ୍ସ	ફ્રાન્સ
ଗାବୋନ୍	ગાબોન્
ବ୍ରିଟେନ୍	બ્રિટેન્
ଗ୍ରେନାଡା	ગ્રેનાડા
ଜର୍ଜିଆ	જર્જિઆ
ଫ୍ରେଞ୍ଚ ଗୁଇନା	ફ્રેઞ્ચ ગુઇના
ଗୁଏରନେସି	ગુએરનેસિ
ଘାନା	ઘાના
ଜିବ୍ରାଲ୍ଟର୍	જિબ્રાલ્ટર્
ଗ୍ରୀନଲ୍ୟାଣ୍ଡ	ગ્રીનલ્ય઼ાણ્ડ
ଗାମ୍ବିଆ	ગામ્બિઆ
ଗୁଏନେଆ	ગુએનેઆ
ଗୌଡେଲୌପେ	ગૌડેલૌપે
ଇକ୍ବାଟେରିଆଲ୍ ଗୁଇନିଆ	ઇક્બાટેરિઆલ્ ગુઇનિઆ
ଗ୍ରୀସ୍	ગ્રીસ્
ଦକ୍ଷିଣ ଜର୍ଜିଆ ଏବଂ ଦକ୍ଷିଣ ସାଣ୍ଡୱିଚ୍ ଦ୍ବୀପପୁଞ୍ଜ	દક્ષિણ જર્જિઆ એબં દક્ષિણ સાણ્ડવિચ્ દ્બીપપુઞ્જ
ଗୁଏତମାଲା	ગુએતમાલા
ଗୁଆମ୍	ગુઆમ્
ଗୁଇନିଆ-ବିସାଉ	ગુઇનિઆ-બિસાઉ
ଗୁଇନା	ગુઇના
ହଂକଂ ବିଶେଷ ପ୍ରଶାସନିକ କ୍ଷେତ୍ର ଚୀନ୍	હંકં બિશેષ પ્રશાસનિક ક્ષેત્ર ચીન્
ହାର୍ଡ ଦ୍ବୀପପୁଞ୍ଜ ଏବଂ ମ୍ୟାକଡୋନାଲ୍ ଦ୍ବୀପପୁଞ୍ଜ	હાર્ડ દ્બીપપુઞ્જ એબં મ્ય઼ાકડોનાલ્ દ્બીપપુઞ્જ
ହୋଣ୍ଡାରୁସ୍	હોણ્ડારુસ્
କ୍ରୋଆଟିଆ	ક્રોઆટિઆ
ହାଇତି	હાઇતિ
ହଙ୍ଗେରୀ	હઙ્ગેરી
ଇଣ୍ଡୋନେସିଆ	ઇણ્ડોનેસિઆ
ଆୟରଲ୍ୟାଣ୍ଡ	આય઼રલ્ય઼ાણ્ડ
ଇସ୍ରାଏଲ୍	ઇસ્રાએલ્
ଆଇଲ୍ ଅଫ୍ ମୈନ୍	આઇલ્ અફ્ મૈન્
ଭାରତ	ભારત
ବ୍ରିଟିଶ୍ ଭାରତୀୟ ସାମୁଦ୍ରିକ କ୍ଷେତ୍ର	બ્રિટિશ્ ભારતીય઼ સામુદ્રિક ક્ષેત્ર
ଇରାକ୍	ઇરાક્
ଇରାନ୍	ઇરાન્
ଆଇସଲ୍ୟାଣ୍ଡ	આઇસલ્ય઼ાણ્ડ
ଇଟାଲୀ	ઇટાલી
ଜର୍ସି	જર્સિ
ଜାମାଇକା	જામાઇકા
ଜୋର୍ଡାନ୍	જોર્ડાન્
ଜାପାନ୍	જાપાન્
କେନିୟା	કેનિય઼ા
କିର୍ଗିଜିସ୍ଥାନ	કિર્ગિજિસ્થાન
କାମ୍ବୋଡିଆ	કામ્બોડિઆ
କିରିବାଟୀ	કિરિબાટી
କାମୋରସ୍	કામોરસ્
ସେଣ୍ଟ କିଟସ୍ ଏଣ୍ଡ ନେଭିସ୍	સેણ્ટ કિટસ્ એણ્ડ નેભિસ્
ଉତ୍ତର କୋରିଆ	ઉત્તર કોરિઆ
ଦକ୍ଷିଣ କୋରିଆ	દક્ષિણ કોરિઆ
କୁଏତ୍	કુએત્
କେମ୍ୟାନ୍ ଦ୍ବୀପପୁଞ୍ଜ	કેમ્ય઼ાન્ દ્બીપપુઞ્જ
କାଜାକାସ୍ଥାନ୍	કાજાકાસ્થાન્
ଲାଓସ୍	લાઓસ્
ଲେବାନନ୍	લેબાનન્
ସେଣ୍ଟ ଲୁସିଆ	સેણ્ટ લુસિઆ
ଲିଚେସ୍ତିଆନାନ୍	લિચેસ્તિઆનાન્
ଶ୍ରୀଲଙ୍କା	શ્રીલઙ્કા
ଲିବେରିଆ	લિબેરિઆ
ଲେସୋଥୋ	લેસોથો
ଲିଥାଆନିଆ	લિથાઆનિઆ
ଲକ୍ସେମବର୍ଗ	લક્સેમબર્ગ
ଲାଟଭିଆ	લાટભિઆ
ଲିବିଆ	લિબિઆ
ମୋରୋକ୍କୋ	મોરોક્કો
ମୋନାକୋ	મોનાકો
ମାଲଡୋଭା	માલડોભા
ମଣ୍ଟେଗ୍ରୋ	મણ્ટેગ્રો
ସେଣ୍ଟ ମାର୍ଟିନ୍	સેણ્ટ માર્ટિન્
ମାଡାଗାସ୍କର୍	માડાગાસ્કર્
ମାର୍ଶଲ୍ ଦ୍ବୀପପୁଞ୍ଜ	માર્શલ્ દ્બીપપુઞ્જ
ମାସେଡୋନିଆ	માસેડોનિઆ
ମାଳୀ	માળી
ମିୟାମାର୍	મિય઼ામાર્
ମଙ୍ଗୋଲିଆ	મઙ્ગોલિઆ
ମାକାଉ SAR ଚିନ୍	માકાઉ SAR ચિન્
ଉତ୍ତର ମାରିଆନା ଦ୍ବୀପପୁଞ୍ଜ	ઉત્તર મારિઆના દ્બીપપુઞ્જ
ମାର୍ଟିନିକ୍ୟୁ	માર્ટિનિક્ય઼ુ
ମାଉରିଟାନିଆ	માઉરિટાનિઆ
ମଣ୍ଟେସେରାଟ୍	મણ્ટેસેરાટ્
ମାଲ୍ଟା	માલ્ટા
ମୌରିସସ୍	મૌરિસસ્
ମାଳଦ୍ବୀପ	માળદ્બીપ
ମାଲୱି	માલવિ
ମେକ୍ସିକୋ	મેક્સિકો
ମାଲେସିଆ	માલેસિઆ
ମୋଜାମ୍ବିକ୍ୟୁ	મોજામ્બિક્ય઼ુ
ନାମ୍ବିଆ	નામ્બિઆ
ନୂତନ କାଲେଡୋନିଆ	નૂતન કાલેડોનિઆ
ନାଇଜର୍	નાઇજર્
ନରଫ୍ଲକ୍ ଦ୍ବୀପ	નરફ્લક્ દ્બીપ
ନାଇଜେରିଆ	નાઇજેરિઆ
ନିକାରାଗୁଆ	નિકારાગુઆ
ନେଦରଲ୍ୟାଣ୍ଡ	નેદરલ્ય઼ાણ્ડ
ନରୱେ	નરવે
ନେପାଳ	નેપાળ
ନାଉରୁ	નાઉરુ
ନିଉ	નિઉ
ନ୍ୟୁଜିଲାଣ୍ଡ	ન્ય઼ુજિલાણ્ડ
ଓମାନ୍	ઓમાન્
ପାନାମା	પાનામા
ପେରୁ	પેરુ
ଫ୍ରେଞ୍ଚ ପଲିନେସିଆ	ફ્રેઞ્ચ પલિનેસિઆ
ପପୁଆ ନ୍ୟୁ ଗୁଏନିଆ	પપુઆ ન્ય઼ુ ગુએનિઆ
ଫିଲିପାଇନସ୍	ફિલિપાઇનસ્
ପାକିସ୍ତାନ	પાકિસ્તાન
ପୋଲାଣ୍ଡ	પોલાણ્ડ
ସେଣ୍ଟ ପିଏରେ ଏବଂ ମିକ୍ବାଲୋନ୍	સેણ્ટ પિએરે એબં મિક્બાલોન્
ପିଟକାଇରିନ୍	પિટકાઇરિન્
ପୁଏର୍ତ୍ତୋ ରିକୋ	પુએર્ત્તો રિકો
ପାଲେସ୍ତେନିଆ	પાલેસ્તેનિઆ
ପର୍ତ୍ତୁଗାଲ୍	પર્ત્તુગાલ્
ପାଲାଉ	પાલાઉ
ପାରାଗୁଏ	પારાગુએ
କତାର୍	કતાર્
ଆଉଟଲେଇଂ ଓସେନିଆ	આઉટલેઇં ઓસેનિઆ
ରିୟୁନିଅନ୍	રિય઼ુનિઅન્
ରୋମାନିଆ	રોમાનિઆ
ସର୍ବିଆ	સર્બિઆ
ରୁଷିଆ	રુષિઆ
ରାୱାଣ୍ଡା	રાવાણ્ડા
ସାଉଦି ଆରବିଆ	સાઉદિ આરબિઆ
ସୋଲୋମନ୍ ଦ୍ବୀପପୁଞ୍ଜ	સોલોમન્ દ્બીપપુઞ્જ
ସେଚେଲସ୍	સેચેલસ્
ସୁଦାନ୍	સુદાન્
ସ୍ୱେଡେନ୍	સ્વેડેન્
ସିଙ୍ଗାପୁର୍	સિઙ્ગાપુર્
ସେଣ୍ଟ ହେଲେନା	સેણ્ટ હેલેના
ସ୍ଲୋଭେନିଆ	સ્લોભેનિઆ
ସାଲ୍ଭାର୍ଡ ଏବଂ ଜାନ୍ ମାୟୋନ୍	સાલ્ભાર્ડ એબં જાન્ માય઼ોન્
ସ୍ଲୋଭାକିଆ	સ્લોભાકિઆ
ସିଓରା ଲିଓନ୍	સિઓરા લિઓન્
ସାନ୍ ମାରିନୋ	સાન્ મારિનો
ସେନେଗାଲ୍	સેનેગાલ્
ସୋମାଲିଆ	સોમાલિઆ
ସୁରିନାମ	સુરિનામ
ଦକ୍ଷିନ ସୁଦାନ	દક્ષિન સુદાન
ସାଓ ଟୋମେ ଏବଂ ପ୍ରିନସିପି	સાઓ ટોમે એબં પ્રિનસિપિ
ଏଲ୍ ସାଲଭାଡୋର୍	એલ્ સાલભાડોર્
ସିରିଆ	સિરિઆ
ସ୍ବାଜିଲାଣ୍ଡ	સ્બાજિલાણ્ડ
ତୁର୍କସ୍ ଏବଂ ସାଇକସ୍ ଦ୍ବୀପପୁଞ୍ଜ	તુર્કસ્ એબં સાઇકસ્ દ્બીપપુઞ્જ
ଚାଦ୍	ચાદ્
ଫରାସୀ ଦକ୍ଷିଣ କ୍ଷେତ୍ର	ફરાસી દક્ષિણ ક્ષેત્ર
ଟୋଗୋ	ટોગો
ଥାଇଲାଣ୍ଡ	થાઇલાણ્ડ
ତାଜିକିସ୍ଥାନ୍	તાજિકિસ્થાન્
ଟୋକେଲାଉ	ટોકેલાઉ
ପୁର୍ବ ତିମୋର୍	પુર્બ તિમોર્
ତୁର୍କମେନିସ୍ତାନ୍	તુર્કમેનિસ્તાન્
ତୁନିସିଆ	તુનિસિઆ
ଟୋଙ୍ଗା	ટોઙ્ગા
ତୁର୍କୀ	તુર્કી
ତ୍ରିନିଦାଦ୍ ଏବଂ ଟୋବାଗୋ	ત્રિનિદાદ્ એબં ટોબાગો
ଟୁଭାଲୁ	ટુભાલુ
ତାଇୱାନ୍	તાઇવાન્
ତାଞ୍ଜାନିଆ	તાઞ્જાનિઆ
ୟୁକ୍ରାଇନ୍	ય઼ુક્રાઇન્
ଉଗାଣ୍ଡା	ઉગાણ્ડા
ୟୁନାଇଟେଡ୍ ଷ୍ଟେଟସ୍ ମାଇନର୍ ଆଉଟଲେଇଂ ଦ୍ବୀପପୁଞ୍ଜ	ય઼ુનાઇટેડ્ ષ્ટેટસ્ માઇનર્ આઉટલેઇં દ્બીપપુઞ્જ
ଯୁକ୍ତ ରାଷ୍ଟ୍ର ଆମେରିକା	યુક્ત રાષ્ટ્ર આમેરિકા
ଉରୁଗୁଏ	ઉરુગુએ
ଉଜବେକିସ୍ଥାନ୍	ઉજબેકિસ્થાન્
ଭାଟିକାନ୍	ભાટિકાન્
ସେଣ୍ଟ ଭିନସେଣ୍ଟ ଏବଂ ଦି ଗ୍ରେନାଡିସ୍	સેણ્ટ ભિનસેણ્ટ એબં દિ ગ્રેનાડિસ્
ଭେନଜୁଏଲା	ભેનજુએલા
ବ୍ରିଟିଶ୍ ଭର୍ଜିନ୍ ଦ୍ବୀପପୁଞ୍ଜ	બ્રિટિશ્ ભર્જિન્ દ્બીપપુઞ્જ
ୟୁଏସ୍ ଭର୍ଜିନ୍ ଦ୍ବୀପପୁଞ୍ଜ	ય઼ુએસ્ ભર્જિન્ દ્બીપપુઞ્જ
ଭିଏତନାମ୍	ભિએતનામ્
ଭାନୁଆତୁ	ભાનુઆતુ
ୱାଲିସ୍ ଏବଂ ଫୁତୁନା	વાલિસ્ એબં ફુતુના
ସାମୋଆ	સામોઆ
ୟେମେନ୍	ય઼ેમેન્
ମାୟୋଟେ	માય઼ોટે
ଦକ୍ଷିଣ ଆଫ୍ରିକା	દક્ષિણ આફ્રિકા
ଜାମ୍ବିଆ	જામ્બિઆ
ଜିମ୍ବାୱେ	જિમ્બાવે
ଅଜଣା କିମ୍ବା ଅବୈଧ ପ୍ରଦେଶ	અજણા કિમ્બા અબૈધ પ્રદેશ
