# Baby names
அகஜா	అకజా
அகந்ய	అకన్య
அகர்ஷா	అకర్షా
அகஷீதா	అకషీతా
அகஷீநீ	అకషీనీ
அகிலா	అకిలా
அக்நிஜ்வாளா	అక్నిజ్వాళా
அக்நிஷிகா	అక్నిషికా
அக்ஷ்யா	అక్ష్యా
அசிஂத்ய	అచింత్య
அச்யுதாந	అచ్యుతాన
அதரஷ	అతరష
அதீதீய	అతీతీయ
அதீஷா	అతీషా
அதோத்கா	అతోత్కా
அத்யயந	అత్యయన
அத்யுத	అత్యుత
அத்ரியந	అత్రియన
அத்விக	అత్విక
அத்விதேயா	అత్వితేయా
அபரா	అపరా
அபிஜந	అపిజన
அபிஜித	అపిజిత
அபிஜ்ஞா	అపిజ్ఞా
அபிஜ்ஞாந	అపిజ్ఞాన
அபிநபஸ	అపినపస
அபிம	అపిమ
அபிமாநீ	అపిమానీ
அபிராஜ	అపిరాజ
அபிருசி	అపిరుచి
அபீஜ்நா	అపీజ్నా
அபீத்யா	అపీత్యా
அபீநாவ	అపీనావ
அபீமாஂந்யுஂ	అపీమాంన్యుం
அபீராம	అపీరామ
அபீரூபா	అపీరూపా
அபீஷ்ரேய	అపీష్రేయ
அபீஹேஷாந	అపీహేషాన
அபேல	అపేల
அப்ஜாயோநீ	అప్జాయోనీ
அலாம்க்ரீதா	అలామ్క్రీతా
அஹலாதிதா	అహలాతితా
அஹில்யா	అహిల్యా
அஹீநா	అహీనా
அஹீந்ஜீதா	అహీన్జీతా
அஹ்லாதாஜநநீ	అహ్లాతాజననీ
ஆகர்ஷக	ఆకర్షక
ஆதிதேய	ఆతితేయ
ஆதித்வ	ఆతిత్వ
ஆதிபுருஷ	ఆతిపురుష
ஆதியா	ఆతియా
ஆதீதேய	ఆతీతేయ
ஆதீஷ்ரீ	ఆతీష్రీ
ஆத்மஜா	ఆత్మజా
ஆத்மய	ఆత్మయ
ஆத்மாநஂத	ఆత్మానంత
ஆத்வாய	ఆత్వాయ
ஆநஂத்யா	ఆనంత్యా
ஆநதாலீப	ఆనతాలీప
ஆநாயா	ఆనాయా
ஆபாஸ	ఆపాస
ஆயநா	ఆయనా
ஆயாஂஷ	ఆయాంష
ஆரஸீ	ఆరసీ
ஆராயநா	ఆరాయనా
ஆரித்ர	ఆరిత్ర
ஆரீ	ఆరీ
ஆரீஷ	ఆరీష
ஆருபா	ఆరుపా
ஆருல	ఆరుల
ஆரோசந	ఆరోచన
ஆர்த	ఆర్త
ஆர்யவீர	ఆర్యవీర
ஆவாநீ	ఆవానీ
ஆவீஷ	ఆవీష
ஆஷ்கா	ఆష్కా
ஆஷ்மீந	ఆష్మీన
ஆஷ்ரித	ఆష్రిత
ஆஷ்லேஷ	ఆష్లేష
இஂதுலால	ఇంతులాల
இஂதுஷேகர	ఇంతుషేకర
இஂத்ரா	ఇంత్రా
இஂபநாதந	ఇంపనాతన
இநோதய	ఇనోతయ
இந்தாருபீநீ	ఇన్తారుపీనీ
இந்தாலீ	ఇన్తాలీ
இந்துமத	ఇన్తుమత
இந்த்ரதநுஷ	ఇన్త్రతనుష
இந்த்ரதயும்ந	ఇన్త్రతయుమ్న
இந்த்ரந	ఇన్త్రన
இந்த்ரஸேநா	ఇన్త్రసేనా
இப்யா	ఇప్యా
இப்ஸா	ఇప్సా
இயலீஸாஈ	ఇయలీసాఈ
இய்யாப்பந	ఇయ్యాప్పన
இரித	ఇరిత
இலாஷ்பஸ்தீ	ఇలాష్పస్తీ
இலேஷ	ఇలేష
இஷாந	ఇషాన
இஷாந்வீ	ఇషాన్వీ
இஷ்ய	ఇష్య
இஸகீ	ఇసకీ
ஈதீ	ఈతీ
ஈந்துஸ	ఈన్తుస
ஈபா	ఈపా
ஈப்ஷா	ఈప్షా
ஈர்ஷீதா	ఈర్షీతా
ஈலமாஂ	ఈలమాం
ஈலாபதாயே	ఈలాపతాయే
ஈலில	ఈలిల
ஈல்வாகா	ఈల్వాకా
ஈஷ்தர	ఈష్తర
ஈஸீஃ	ఈసీః
ஈஸைவலந	ఈసైవలన
ஈஹம	ఈహమ
உக்ரஸ்ரவாஸ	ఉక్రస్రవాస
உசீமாஂகலீ	ఉచీమాంకలీ
உஜாயந	ఉజాయన
உஜேஷ	ఉజేష
உஜ்ஜவல	ఉజ్జవల
உஜ்வலீதா	ఉజ్వలీతా
உதஂகா	ఉతంకా
உதஂதா	ఉతంతా
உதாய	ఉతాయ
உதார	ఉతార
உத்கர்ஷ்ராஜ	ఉత్కర్ష్రాజ
உத்கஷாநா	ఉత్కషానా
உத்காலிகா	ఉత్కాలికా
உத்கிதா	ఉత్కితా
உத்தர	ఉత్తర
உத்தரக	ఉత్తరక
உத்தரா	ఉత్తరా
உத்தீயந	ఉత్తీయన
உத்பர	ఉత్పర
உத்யத	ఉత్యత
உத்வஹ	ఉత్వహ
உத்ஸர்க	ఉత్సర్క
உத்ஸா	ఉత్సా
உநமாஇவீலஂபீ	ఉనమాఇవీలంపీ
உபசீத்ரா	ఉపచీత్రా
உபநாயிக	ఉపనాయిక
உபமா	ఉపమా
உப்ஜஸ	ఉప్జస
உப்தம	ఉప్తమ
உப்பாஸ	ఉప్పాస
உமஂகீ	ఉమంకీ
உமாஂபுத்ர	ఉమాంపుత్ర
உமாகாஂத	ఉమాకాంత
உரவஷீ	ఉరవషీ
உரிஷிதா	ఉరిషితా
உர்மீ	ఉర్మీ
உர்வ	ఉర్వ
உர்வஂக	ఉర్వంక
உர்வா	ఉర్వా
உர்ஷிதா	ఉర్షితా
உஷாகிரண	ఉషాకిరణ
உஷாநா	ఉషానా
உஷீக	ఉషీక
உஸரீ	ఉసరీ
ஏகலிஂக	ఏకలింక
ஏகாதநா	ఏకాతనా
ஏகாத்யுஂ	ఏకాత్యుం
ஏகாம்பர	ఏకామ్పర
ஏகிஷா	ఏకిషా
ஏக்ஷித	ఏక్షిత
ஏதா	ఏతా
ஏதாஸ	ఏతాస
ஏதோம	ఏతోమ
ஏமா	ఏమా
ஏலாந்த்ர	ఏలాన్త్ర
ஏலுமலாஈ	ఏలుమలాఈ
ஏவாஂஷீ	ఏవాంషీ
ஏஷஂகா	ఏషంకా
ஐஷா	ఐషా
ஐஷீ	ఐషీ
ஐஷீநீ	ఐషీనీ
ஓஏஷீ	ఓఏషీ
ஓஜஸ்விநீ	ఓజస్వినీ
ஓஜஸ்வீத	ఓజస్వీత
ஓஜீஸ	ఓజీస
ஓதிதீ	ఓతితీ
ஓநிஷ	ఓనిష
ஓநீ	ఓనీ
ஓநீஸ	ఓనీస
ஓப்பிலமணி	ఓప్పిలమణి
ஓமகாரீ	ఓమకారీ
ஓமநா	ఓమనా
ஓமாஂஷ	ఓమాంష
ஓம்ஜா	ఓమ్జా
ஓவீஏ	ఓవీఏ
ஓவைஸ	ఓవైస
கஂகவார	కంకవార
கஂகா	కంకా
கஂகாதுத்த	కంకాతుత్త
கஂகேஷ	కంకేష
கஂஜரீ	కంజరీ
கஂதரஜ	కంతరజ
கஂதர்ப	కంతర్ప
கஂதாரா	కంతారా
கஂதிமோய	కంతిమోయ
கஂதிரா	కంతిరా
கஂவர	కంవర
கஜபாஹூ	కజపాహూ
கஜாதர	కజాతర
கஜாநந	కజానన
கஜாநநந	కజాననన
கணநாத	కణనాత
கணபத	కణపత
கதஂபீ	కతంపీ
கதித	కతిత
கதீர	కతీర
கநக்ஷா	కనక్షా
கநாதந	కనాతన
கநிக	కనిక
கநீரா	కనీరా
கநேஷ	కనేష
கநைய்யா	కనైయ్యా
கந்தாரவ	కన్తారవ
கந்தாரீந	కన్తారీన
கந்மாநீ	కన్మానీ
கந்வந	కన్వన
கந்வீ	కన్వీ
கபாலீந	కపాలీన
கமலாகர	కమలాకర
கமீத	కమీత
கமோத	కమోత
கயாலிகா	కయాలికా
கரமஷீ	కరమషీ
கருநேஷ	కరునేష
கருல	కరుల
கர்ண	కర్ణ
கர்வ	కర్వ
கர்ஷீந	కర్షీన
கலாநீதீ	కలానీతీ
கலாவதீ	కలావతీ
கலீபா	కలీపా
கலீல	కలీల
கல்யாணீ	కల్యాణీ
கல்ஹார	కల్హార
கவீநயா	కవీనయా
கவேஷண	కవేషణ
கவ்ய	కవ్య
கஷீக	కషీక
கஷ்விகா	కష్వికా
கஷ்விநீ	కష్వినీ
கஸ்துர	కస్తుర
கஹதா	కహతా
கஹுலீகா	కహులీకా
காஂதவ	కాంతవ
காஂதிக	కాంతిక
காஂதீ	కాంతీ
காஂவ	కాంవ
காஜீஷ	కాజీష
காதம்பரீ	కాతమ్పరీ
காதிரோலீ	కాతిరోలీ
காதீத	కాతీత
காதீர அமத்துஇகந	కాతీర అమత్తుఇకన
காதீராவண	కాతీరావణ
காத்யயாநீ	కాత్యయానీ
காத்யாயந	కాత్యాయన
காநகலதா	కానకలతా
காநாய	కానాయ
காநீத	కానీత
காநீமோஜ்ஹீ	కానీమోజ్హీ
காந்ஜாநா	కాన్జానా
காந்தா	కాన్తా
காந்ஷீகா	కాన్షీకా
காமஜ	కామజ
காமராஜ	కామరాజ
காமிய	కామియ
காமுநா	కామునా
காயல	కాయల
காயலே	కాయలే
காரடீ	కారటీ
கார்திகா	కార్తికా
கார்திகேயந	కార్తికేయన
காலகா	కాలకా
காலராத்ரீ	కాలరాత్రీ
காலீதா	కాలీతా
காவேரீ	కావేరీ
காவ்யஷ்ரீ	కావ్యష్రీ
காஷீ	కాషీ
காஸநீ	కాసనీ
கிஂஜல	కింజల
கிதிகா	కితికా
கிநாரீ	కినారీ
கிரிக	కిరిక
கிரீந்த்ர	కిరీన్త్ర
கீதிகா	కీతికా
கீநாரீ	కీనారీ
கீந்ஜு	కీన్జు
கீப்ஸோந	కీప్సోన
கீவீதா	కీవీతా
குகந	కుకన
குடடூ	కుటటూ
குணித	కుణిత
குதாகேஷ	కుతాకేష
குநாதிர	కునాతిర
குநாயூக்த	కునాయూక్త
குநாரத்நா	కునారత్నా
குநாஸேகரண	కునాసేకరణ
குநித	కునిత
குநிநா	కునినా
குநீந	కునీన
குரதயால	కురతయాల
குரு குகந	కురు కుకన
குருநாத	కురునాత
குருப்ரஸாத	కురుప్రసాత
குர்ஜரீ	కుర్జరీ
குலஜாரீலால	కులజారీలాల
கூஂஜீகா	కూంజీకా
கூஹாரீ	కూహారీ
கேஂகா	కేంకా
கேஓஷா	కేఓషా
கேதீத	కేతీత
கேது	కేతు
கேநீகா	కేనీకా
கேயுரா	కేయురా
கேவத	కేవత
கேவாஂஷீ	కేవాంషీ
கேஷிநீ	కేషినీ
கேஷீ	కేషీ
கேஷோரீ	కేషోరీ
கேஸர	కేసర
கேஸரீ	కేసరీ
கேஸவ	కేసవ
கேஸவார்தீநீ	కేసవార్తీనీ
கேஸவாளுஂ	కేసవాళుం
கைரவ	కైరవ
கோஉஂஷிக	కోఉంషిక
கோகீலாவாநீ	కోకీలావానీ
கோரல	కోరల
கோவ்தமீ	కోవ్తమీ
கோஷீதா	కోషీతా
கௌதிர்ய	కౌతిర్య
கௌராஂஷ	కౌరాంష
கௌரீமநோஹரீ	కౌరీమనోహరీ
கௌஷாலீ	కౌషాలీ
கௌஷ்லேந்தர	కౌష్లేన్తర
க்நாபீகா	క్నాపీకా
க்யாநாவீ	క్యానావీ
க்ரஂதநா	క్రంతనా
க்ராமாநீ	క్రామానీ
க்ரீதேஷ	క్రీతేష
க்ரீஷா	క్రీషా
சஂசாரீ	చంచారీ
சஂதாலிநீ	చంతాలినీ
சஂதாவர்மந	చంతావర్మన
சஂத்ர பாந	చంత్ర పాన
சஂத்ரந	చంత్రన
சஂத்ரபால	చంత్రపాల
சஂத்ரயாந	చంత్రయాన
சஂத்ரவாதி	చంత్రవాతి
சஂத்ராநீ	చంత్రానీ
சஂத்ராமாஸீ	చంత్రామాసీ
சஂத்ரிகா	చంత్రికా
சஂபா	చంపా
சஂபாகலீ	చంపాకలీ
சக்ரவர்தீ	చక్రవర్తీ
சக்ரிகா	చక్రికా
சதுர்புஜா	చతుర్పుజా
சந்த்ரவதந	చన్త్రవతన
சரந்தேவ	చరన్తేవ
சர்வாகா	చర్వాకా
சர்வீகேஷ	చర్వీకేష
சவி	చవి
சாதீமாஂ	చాతీమాం
சாத்விக	చాత్విక
சாநக்ய	చానక్య
சாருந	చారున
சாருவிந்தா	చారువిన్తా
சாருவீ	చారువీ
சார்வீ	చార్వీ
சாவீஷ்கா	చావీష్కా
சிஂதந	చింతన
சிஂதமாணீ	చింతమాణీ
சித்தப்ரஸாத	చిత్తప్రసాత
சித்ரஂஷீ	చిత్రంషీ
சித்ரக்ஷீ	చిత్రక్షీ
சித்ரா	చిత్రా
சித்ராமநீ	చిత్రామనీ
சித்ரிகா	చిత్రికా
சிந்மயாநஂதா	చిన్మయానంతా
சிரஂஜீவீ	చిరంజీవీ
சுஂபந	చుంపన
சேஜியந	చేజియన
சேரந்ராஜ	చేరన్రాజ
சேலுவா	చేలువా
சைதந்யா	చైతన్యా
சைநீகா	చైనీకా
ஜஂகரத	జంకరత
ஜகஂமோஹந	జకంమోహన
ஜகதகுரு	జకతకురు
ஜகதபால	జకతపాల
ஜகதம்பிகா	జకతమ్పికా
ஜகமாதா	జకమాతా
ஜக்ஸநா	జక్సనా
ஜத்யா	జత్యా
ஜநாதார்ண	జనాతార్ణ
ஜநாதேவ	జనాతేవ
ஜநித	జనిత
ஜநீதா	జనీతా
ஜநீஷா	జనీషా
ஜந்மயா	జన్మయా
ஜய ஸகாந	జయ సకాన
ஜய  ப்ரகாஷ	జయ  ప్రకాష
ஜய  ப்ரதிக	జయ  ప్రతిక
ஜயஂதாஸேநா	జయంతాసేనా
ஜயகோபால	జయకోపాల
ஜயநா	జయనా
ஜயவஂத	జయవంత
ஜயஸூர்யா	జయసూర్యా
ஜயாப்ரதா	జయాప్రతా
ஜயாலக்ஷ்மீ	జయాలక్ష్మీ
ஜயீ	జయీ
ஜலாகஂதா	జలాకంతా
ஜலோதரீ	జలోతరీ
ஜஷஂக	జషంక
ஜஷோதா	జషోతా
ஜஷ்மீநா	జష్మీనా
ஜஷ்லந	జష్లన
ஜஸ்வந்தீ	జస్వన్తీ
ஜாஂபுவந	జాంపువన
ஜாக்ராவீ	జాక్రావీ
ஜாநகீபூஷண	జానకీపూషణ
ஜாநா	జానా
ஜாஹீ	జాహీ
ஜிதேந்த்ரிய	జితేన్త్రియ
ஜீக்யாஂஷ	జీక్యాంష
ஜீக்யாஂஷு	జీక్యాంషు
ஜீஜீத	జీజీత
ஜீதீஷா	జీతీషా
ஜீதேஷீ	జీతేషీ
ஜீமீ	జీమీ
ஜீமீஷ	జీమీష
ஜீரல	జీరల
ஜீவநகலா	జీవనకలా
ஜீவநலதா	జీవనలతా
ஜீவநஷ	జీవనష
ஜீவந்தீநீ	జీవన్తీనీ
ஜீவாநாந்தாம	జీవానాన్తామ
ஜேதல	జేతల
ஜேதாஷ்ரீ	జేతాష్రీ
ஜேநீஷா	జేనీషా
ஜேராம	జేరామ
ஜேர்ரீஷ	జేర్రీష
ஜேர்ஷீகா	జేర్షీకా
ஜேஸ்வஂத	జేస్వంత
ஜேஸ்வீதா	జేస్వీతా
ஜைகரத	జైకరత
ஜைதாஷ்ரீ	జైతాష్రీ
ஜைதீ	జైతీ
ஜைப்ரித	జైప్రిత
ஜைமில	జైమిల
ஜைமேஷ	జైమేష
ஜைலேஷ	జైలేష
ஜைவஂதீ	జైవంతీ
ஜைவத	జైవత
ஜைவல	జైవల
ஜைவீந	జైవీన
ஜைஸுதந	జైసుతన
ஜோதா	జోతా
ஜோயஷ்ரீ	జోయష్రీ
ஜ்ஞாந	జ్ఞాన
ஜ்ஞாநதேவ	జ్ఞానతేవ
ஜ்யோஷநா	జ్యోషనా
ஜ்ஹில	జ్హిల
ஜ்ஹீதீந	జ్హీతీన
டாகோர	టాకోర
டீம்பீல	టీమ్పీల
தஂஷ	తంష
தஃந்யத	తఃన్యత
தக்ஷ	తక్ష
தக்ஷீண	తక్షీణ
தக்ஷேஷ	తక్షేష
தணீ	తణీ
தநதாந்யகீ	తనతాన్యకీ
தநலக்ஷ்மீ	తనలక్ష్మీ
தநவதீ	తనవతీ
தநஸிகா	తనసికా
தநாவர்ஷ	తనావర్ష
தநிப	తనిప
தநீஷ	తనీష
தநுஂ ப்ரவா	తనుం ప్రవా
தநுஂந்ஜய	తనుంన్జయ
தநுஂஷ்கா	తనుంష్కా
தநுஂஷ்ரீ	తనుంష్రీ
தநுபா	తనుపా
தநுல	తనుల
தநுஷீ	తనుషీ
தந்மாயா	తన్మాయా
தந்வந்தரீ	తన్వన్తరీ
தபீஷ	తపీష
தபேஷ	తపేష
தப்த	తప్త
தமஸீ	తమసీ
தமாலிகா	తమాలికా
தமிரா	తమిరా
தமிலந	తమిలన
தமிலா	తమిలా
தமேஷ	తమేష
தயஸரா	తయసరా
தயாகர	తయాకర
தயாதா	తయాతా
தயாஷ்ரீ	తయాష్రీ
தரநீதர	తరనీతర
தரலீ	తరలీ
தராஷா	తరాషా
தராஹாஸீ	తరాహాసీ
தரீநந	తరీనన
தருலதா	తరులతా
தர்பண	తర్పణ
தர்பித	తర్పిత
தர்மகீர்தி	తర్మకీర్తి
தர்மதித்ய	తర్మతిత్య
தர்ஷத	తర్షత
தர்ஷா	తర్షా
தர்ஷாநேயா	తర్షానేయా
தர்ஷீத	తర్షీత
தர்ஷீநீகா	తర్షీనీకా
தர்ஷீல	తర్షీల
தலஜீத	తలజీత
தலாபதீ	తలాపతీ
தஸ்ம்யா	తస్మ్యా
தாதாகா	తాతాకా
தாநஸ	తానస
தாநாஸ்வீ	తానాస్వీ
தாநுஂரீகியா	తానుంరీకియా
தாமா	తామా
தாமிநீ	తామినీ
தாரகேஷ்வர	తారకేష్వర
தாரீக	తారీక
தாரூ	తారూ
தாஷாரதீ	తాషారతీ
தாஸ	తాస
திக்ஷாந்ய	తిక్షాన్య
திக்ஷீ	తిక్షీ
திநாத	తినాత
திபஂஷீ	తిపంషీ
திபஷ்ரீ	తిపష్రీ
திபஸரீ	తిపసరీ
திப்ஜ்யோதீ	తిప్జ్యోతీ
திப்தீக்ஷா	తిప్తీక్షా
திப்யா	తిప్యా
திப்யோக	తిప్యోక
திருமாலா	తిరుమాలా
திரூமாலாஈ	తిరూమాలాఈ
திவேநா	తివేనా
திஸ்யா	తిస్యా
தீதா	తీతా
தீநபஂது	తీనపంతు
தீநா நாத	తీనా నాత
தீநோஷா	తీనోషా
தீபாஂஷ	తీపాంష
தீபாவதீ	తీపావతీ
தீப்தாந்ஷு	తీప్తాన్షు
தீமித	తీమిత
தீமிலா	తీమిలా
தீரந	తీరన
தீர்தஂகர	తీర్తంకర
தீர்தீகா	తీర్తీకా
தீவாஷீநீ	తీవాషీనీ
துஂகபத்ரா	తుంకపత్రా
துகாராம	తుకారామ
துந்கார	తున్కార
துந்தா	తున్తా
துரக	తురక
துஷஂத	తుషంత
துஷார காஂதி	తుషార కాంతి
துஷாரா	తుషారా
துஷார்ஸுவரா	తుషార్సువరా
தூந	తూన
தேஜ	తేజ
தேஜஸூர்ய	తేజసూర్య
தேஜாஂஷ	తేజాంష
தேதீப்ய	తేతీప్య
தேநாப்பந	తేనాప్పన
தேபஂஜந	తేపంజన
தேபதாத்தா	తేపతాత్తా
தேப்ஜாநீ	తేప్జానీ
தேய்ரியா	తేయ్రియా
தேவகீ	తేవకీ
தேவதத	తేవతత
தேவதத்த	తేవతత్త
தேவதாஸ	తేవతాస
தேவந	తేవన
தேவமாஂதா	తేవమాంతా
தேவர்ஷி	తేవర్షి
தேவாஂகநா	తేవాంకనా
தேவாதார்ஸ	తేవాతార్స
தேவாத்யுமநா	తేవాత్యుమనా
தேவாந	తేవాన
தேவாநஂதா	తేవానంతా
தேவாப்ரியா	తేవాప్రియా
தேவாரீஷீ	తేవారీషీ
தேவிநா	తేవినా
தேவிஷீ	తేవిషీ
தேவீ ப்ரிய	తేవీ ప్రియ
தேவேந	తేవేన
தேவேந்த்ர	తేవేన్త్ర
தேவேந்த்ரநாத	తేవేన్త్రనాత
தேவேஷீ	తేవేషీ
தேவேஷ்வர	తేవేష్వర
தேஷநா	తేషనా
தேஷா	తేషా
தேஸநா	తేసనా
தேஸ்பீநா	తేస్పీనా
தோலாக்ஷீ	తోలాక్షీ
தோஷண	తోషణ
தௌருஸ	తౌరుస
தௌஷீநீ	తౌషీనీ
த்ராயக்ஷ	త్రాయక్ష
த்ரிதேவ	త్రితేవ
த்ரிநேத்ர	త్రినేత్ర
த்ரிமாந	త్రిమాన
த்ரிலோகேஷ	త్రిలోకేష
த்ரிலோசந	త్రిలోచన
த்ரிவேணீ	త్రివేణీ
த்ரீஜ்யா	త్రీజ్యా
த்ரீதேஷ	త్రీతేష
த்ரீஷ	త్రీష
த்ரீஷஂட	త్రీషంట
த்ரீஷ்தீகா	త్రీష్తీకా
த்ருவிகா	త్రువికా
நஂத	నంత
நஂதந	నంతన
நஂதிதா	నంతితా
நஂதிநீ	నంతినీ
நகுலா	నకులా
நக்ஷத்ர	నక్షత్ర
நக்ஷத்ரா	నక్షత్రా
நதாலீஏ	నతాలీఏ
நதீஷ	నతీష
நதுந	నతున
நபீந	నపీన
நமஸ்தேதுஂ	నమస్తేతుం
நரபதி	నరపతి
நலிந	నలిన
நவநீத	నవనీత
நவநீத விலீப்தஂகா	నవనీత విలీప్తంకా
நவம	నవమ
நவாஜ	నవాజ
நவால	నవాల
நாகஜோதீ	నాకజోతీ
நாகபுஷண	నాకపుషణ
நாகாஂஜலீ	నాకాంజలీ
நாகிநீ	నాకినీ
நாகீஸகா	నాకీసకా
நாகேஷ	నాకేష
நாகேஷ்வர	నాకేష్వర
நாதாரஂஜநீ	నాతారంజనీ
நாதீநீ	నాతీనీ
நாதேஸந	నాతేసన
நாபநீதா	నాపనీతా
நாபாயண	నాపాయణ
நாபித	నాపిత
நாமாஂஹா	నామాంహా
நாம்ராதா	నామ్రాతా
நாராப	నారాప
நாராயணஸ்வாமீ	నారాయణస్వామీ
நாரீநே	నారీనే
நாவில்லா	నావిల్లా
நாவீல	నావీల
நாவ்கீரண	నావ్కీరణ
நாவ்யா	నావ్యా
நாஷால	నాషాల
நாஹுல	నాహుల
நிகாரா	నికారా
நிகேஷ	నికేష
நிஜு	నిజు
நிதல	నితల
நிமிதா	నిమితా
நிரமஈ	నిరమఈ
நிராமஈ	నిరామఈ
நிராலீ	నిరాలీ
நிர்மளா	నిర్మళా
நில்ல	నిల్ల
நிவேஷ	నివేష
நீகீத்ஸா	నీకీత్సా
நீகுல	నీకుల
நீகேத	నీకేత
நீக்குஂ	నీక్కుం
நீக்ஷா	నీక్షా
நீஜய	నీజయ
நீதார்ஸநா	నీతార్సనా
நீதீகா	నీతీకా
நீபீஷ	నీపీష
நீபுநா	నీపునా
நீமிலீதா	నీమిలీతా
நீரமாஂ	నీరమాం
நீராலிகா	నీరాలికా
நீருஈமீ	నీరుఈమీ
நீருதீ	నీరుతీ
நீலஂஜந	నీలంజన
நீலகஂட	నీలకంట
நீலக்ரீவ	నీలక్రీవ
நீலக்ஷ	నీలక్ష
நீலயா	నీలయా
நீலாஂஜந	నీలాంజన
நீலாயந	నీలాయన
நீல்ப்ரப்பா	నీల్ప్రప్పా
நீஷாலீ	నీషాలీ
நீஸிதீநீ	నీసితీనీ
நீஸ்சலா	నీస్చలా
நீஹீதா	నీహీతా
நீஹீரா	నీహీరా
நேத்ரா	నేత్రా
நேய்ஸா	నేయ్సా
நேர்யா	నేర్యా
நேவில	నేవిల
நேஷுஂ	నేషుం
நேஹல	నేహల
நேஹா ஷ்ரீ	నేహా ష్రీ
நைத்விக	నైత్విక
நைமிஷ	నైమిష
நைருதீ	నైరుతీ
நைவாதயா	నైవాతయా
நைஷத	నైషత
நைஷால	నైషాల
நௌபஹார	నౌపహార
பஂகிதா	పంకితా
பஂகிமசஂத்ர	పంకిమచంత్ర
பஂசபூதாத்மிகா	పంచపూతాత్మికా
பஂசவடீ	పంచవటీ
பஂசாஜநா	పంచాజనా
பஂடிதா	పంటితా
பஂதாந	పంతాన
பஂது	పంతు
பகீரா	పకీరా
பகு	పకు
பகுலா	పకులా
பக்தாவர	పక్తావర
பக்தாவாத்ஸலா	పక్తావాత్సలా
பக்தி	పక్తి
பக்யாராஜ	పక్యారాజ
பதக	పతక
பதமாஂக்ஷ்ய	పతమాంక్ష్య
பதமேஷ	పతమేష
பதாலா	పతాలా
பத்மக்ரிஹா	పత్మక్రిహా
பத்மரேகா	పత్మరేకా
பத்மவாஸா	పత్మవాసా
பத்மஷ்ரீ	పత్మష్రీ
பத்மாஂகல்யாநீ	పత్మాంకల్యానీ
பத்மிநிஷ	పత్మినిష
பத்ரக்ஷ	పత్రక్ష
பந்குரீ	పన్కురీ
பந்தீநீ	పన్తీనీ
பந்நா	పన్నా
பந்யஷ்ரீ	పన్యష్రీ
பந்ஹீ	పన్హీ
பபலா	పపలా
பயோஷ்நீகா	పయోష్నీకా
பரகா	పరకా
பரதாப ; பரதாப	పరతాప ; పరతాప
பரப்ரஹ்மநா	పరప్రహ్మనా
பரப்ரஹ்மா	పరప్రహ్మా
பரம	పరమ
பரம ஜ்யோதி	పరమ జ్యోతి
பரமா	పరమా
பரமாஂந்த்ர	పరమాంన్త్ర
பரமேஷ்வரீ	పరమేష్వరీ
பரவீந	పరవీన
பராகதீ	పరాకతీ
பராமாஂ	పరామాం
பராஸரா	పరాసరా
பரித	పరిత
பரிஷீ	పరిషీ
பரீகா	పరీకా
பரீஜாதாபா ஹராகாயா	పరీజాతాపా హరాకాయా
பரீநுத	పరీనుత
பரோமீதா	పరోమీతా
பர்தாத்வாஜாக்ரஸஂவாஸீநே	పర్తాత్వాజాక్రసంవాసీనే
பலப்ரதா	పలప్రతా
பலராம	పలరామ
பலாகஸீ	పలాకసీ
பலாநிகுமார	పలానికుమార
பலோமீ	పలోమీ
பல்மாநீ	పల్మానీ
பல்லப	పల్లప
பல்வித	పల్విత
பவாநாஜ	పవానాజ
பவாநிதாஸ	పవానితాస
பவியா	పవియా
பவீந	పవీన
பஸுந்தாரா	పసున్తారా
பஹவாஸ்ய	పహవాస్య
பஹுல	పహుల
பாஂகே	పాంకే
பாஂகேபிஹாரீ	పాంకేపిహారీ
பாஂசாலீ	పాంచాలీ
பாஓலா	పాఓలా
பாகாவாதி	పాకావాతి
பாகீரத	పాకీరత
பாக்ய	పాక్య
பாக்யலக்ஷ்மீ	పాక్యలక్ష్మీ
பாதாலவதீ	పాతాలవతీ
பாத்ரஷ்ரீ	పాత్రష్రీ
பாநபாத்த	పానపాత్త
பாநீக	పానీక
பாரூநா	పారూనా
பார்திஹாரீ	పార్తిహారీ
பார்நாயுஂ	పార్నాయుం
பார்வதீ	పార్వతీ
பார்ஷந	పార్షన
பார்ஷ்வ	పార్ష్వ
பார்ஹீ பர்ஹாவாதாம்ஸகா	పార్హీ పర్హావాతామ్సకా
பால கோபால	పాల కోపాల
பாலசஂத்ர	పాలచంత్ర
பாலநஹார	పాలనహార
பாலாமுருகந	పాలామురుకన
பாலாராம	పాలారామ
பால்குந	పాల్కున
பாவதீ	పావతీ
பாவாகீ	పావాకీ
பாவிகா	పావికా
பாவீ	పావీ
பாவேஷ	పావేష
பாவேஷ்வாரீ	పావేష్వారీ
பாவ்யஂஷ	పావ్యంష
பாஸ்கர	పాస్కర
பாஸ்வர	పాస్వర
பாஹுலேயா	పాహులేయా
பிஂகா	పింకా
பிதா வாஸஸே	పితా వాససే
பிபிந	పిపిన
பிபுல	పిపుల
பிமல	పిమల
பிம்பா	పిమ్పా
பியாலீ	పియాలీ
பிரவா	పిరవా
பீஂகாய	పీంకాయ
பீஜயா	పీజయా
பீநுஂ	పీనుం
பீபத்ஸுஂ	పీపత్సుం
பீப்லோஜீத	పీప్లోజీత
பீமஸேந	పీమసేన
பீர	పీర
பீர்நாவ	పీర్నావ
பீலாக்ஷ்யேந	పీలాక్ష్యేన
பீல்பா ஷ்ரீ	పీల్పా ష్రీ
பீல்வாநீ	పీల్వానీ
பீஹுநா	పీహునా
பீஹூ	పీహూ
புதிகா	పుతికా
புபத	పుపత
புமந	పుమన
புல்கேஷ	పుల్కేష
புல்லந	పుల్లన
புவ்நேந்த்ர	పువ్నేన్త్ర
பூதநாதந	పూతనాతన
பூதேவீ	పూతేవీ
பூபத	పూపత
பூபாலீ	పూపాలీ
பூரதீ	పూరతీ
பூர்ணமாஸீ	పూర్ణమాసీ
பூர்நாகமலா	పూర్నాకమలా
பூர்நாந	పూర్నాన
பூர்வஂஸ	పూర్వంస
பூர்வித	పూర్విత
பூலமாலா	పూలమాలా
பூலேஂது	పూలేంతు
பூலோகாநாதாந	పూలోకానాతాన
பேநுஂ	పేనుం
பேரவீ	పేరవీ
பேலுரமீ	పేలురమీ
பேல்லீ	పేల్లీ
பேஹுலா	పేహులా
பைரவ	పైరవ
பைஸாகீ	పైసాకీ
போஂநந	పోంనన
போஉர்நீமாஂ	పోఉర్నీమాం
போநநீ	పోననీ
போஷீதா	పోషీతా
பௌலோஈநீ	పౌలోఈనీ
பௌலோமீ	పౌలోమీ
ப்ரகல்பா	ప్రకల్పా
ப்ரகல்யா	ప్రకల్యా
ப்ரகாலபா	ప్రకాలపా
ப்ரக்ரீதீ	ప్రక్రీతీ
ப்ரநீதீகா	ప్రనీతీకా
ப்ரபா	ప్రపా
ப்ரபாந	ప్రపాన
ப்ரபாஹரண	ప్రపాహరణ
ப்ரஹார்ஷீநீ	ప్రహార్షీనీ
ப்ராஂஷு	ప్రాంషు
ப்ராக்ரீதீ	ప్రాక్రీతీ
ப்ராக்ஷீ	ప్రాక్షీ
ப்ராணமய	ప్రాణమయ
ப்ராத்ந்ய	ప్రాత్న్య
ப்ராநல	ప్రానల
ப்ரீஜ	ప్రీజ
ப்ரீந்தாவாநீ	ప్రీన్తావానీ
ப்ரீஹதீ	ప్రీహతీ
ப்லேஸ்ஸீ	ప్లేస్సీ
மஂகலா	మంకలా
மஂகாஈ	మంకాఈ
மஂஜு ப்ரஸாத	మంజు ప్రసాత
மஂடித	మంటిత
மஂதர	మంతర
மஂதாகிநீ	మంతాకినీ
மஂத்ரீந	మంత్రీన
மகந	మకన
மகநா	మకనా
மகரஂத	మకరంత
மணிரத்நா	మణిరత్నా
மதிரா	మతిరా
மதுகாரீ	మతుకారీ
மதுதீப	మతుతీప
மதுராநீ	మతురానీ
மதுலந	మతులన
மதுவஂதீ	మతువంతీ
மதேரூ	మతేరూ
மநஜ்யோத	మనజ్యోత
மநிதீபா	మనితీపా
மநிமேகலா	మనిమేకలా
மநீகாரநீ	మనీకారనీ
மநீதீப	మనీతీప
மநீபலந	మనీపలన
மநோமய	మనోమయ
மநோரஂஜநா	మనోరంజనా
மநோரமா	మనోరమా
மந்மத	మన్మత
மந்யு	మన్యు
மம்தா	మమ్తా
மயூர	మయూర
மரேஷ	మరేష
மஹாஜ	మహాజ
மஹாதீ	మహాతీ
மஹாதேஜ	మహాతేజ
மஹாதேஜஸ	మహాతేజస
மஹாத்மா	మహాత్మా
மஹாத்யுதா	మహాత్యుతా
மஹாந்தேஷ	మహాన్తేష
மஹாந்ய	మహాన్య
மஹாபாலா	మహాపాలా
மஹாபுத்தி	మహాపుత్తి
மஹாமாநீ	మహామానీ
மஹாயோகீ	మహాయోకీ
மஹால்யா	మహాల్యా
மஹாவித்யா	మహావిత్యా
மஹிஷா	మహిషా
மஹீபதி	మహీపతి
மஹேஂத்ரா	మహేంత్రా
மஹேக	మహేక
மஹேஷநீ	మహేషనీ
மாஂகா	మాంకా
மாஂதிக	మాంతిక
மாஂநாஷ்யுஂ	మాంనాష్యుం
மாஂநீமாஂரண	మాంనీమాంరణ
மாஂநீமோஜ்ஹீ	మాంనీమోజ్హీ
மாஂநீஷ்கா	మాంనీష్కా
மாஂநுஸரீ	మాంనుసరీ
மாஂநோரீதா	మాంనోరీతా
மாஂந்ஜுநாதா	మాంన్జునాతా
மாஂரீஸ்வாரீ	మాంరీస్వారీ
மாஂர்தஂதா	మాంర్తంతా
மாஂல்லீயா	మాంల్లీయా
மாதவ தாஸ	మాతవ తాస
மாதுஜ	మాతుజ
மாதுவேமந	మాతువేమన
மாத்ருதேவ	మాత్రుతేవ
மாத்ரே	మాత్రే
மாந	మాన
மாநகா	మానకా
மாநதந	మానతన
மாநவ	మానవ
மாநீஏ	మానీఏ
மாந்தாதா	మాన్తాతా
மாந்தாரீ	మాన్తారీ
மாந்வீர	మాన్వీర
மாரகாதம	మారకాతమ
மாருதி	మారుతి
மார்கீத	మార్కీత
மார்ஷக	మార్షక
மால மரகந	మాల మరకన
மாலிநீ	మాలినీ
மாலு	మాలు
மால்லேஷா	మాల్లేషా
மாஹிதா	మాహితా
மாஹீப	మాహీప
மிக்ஷா	మిక్షా
மேத	మేత
மேதிநீ	మేతినీ
மேதுநா	మేతునా
மைத்ரா	మైత్రా
மைத்ரீ	మైత్రీ
மைமத	మైమత
மௌலிகா	మౌలికా
மௌலீஷா	మౌలీషా
யஜநேஷ	యజనేష
யஜுர	యజుర
யஜ்நேஷ	యజ్నేష
யது	యతు
யதுநஂதந	యతునంతన
யதுராஜ	యతురాజ
யவநா	యవనా
யஷராஜ	యషరాజ
யஷஸ்விந	యషస్విన
யஷாஸ்காராம	యషాస్కారామ
யஷு	యషు
யஷோதா	యషోతా
யஷோதேவ	యషోతేవ
யஸ்மீநீ	యస్మీనీ
யாக்நீதா	యాక్నీతా
யாசந	యాచన
யாஜ்நா	యాజ్నా
யாஜ்ஹீநீ	యాజ్హీనీ
யாதவ	యాతవ
யாதாவந	యాతావన
யாதுதாநீ	యాతుతానీ
யார	యార
யாஸ்தீகா	యాస్తీకా
யாஹ்வீ	యాహ్వీ
யுஂகலராஜ	యుంకలరాజ
யுகல	యుకల
யுதாஜீத	యుతాజీత
யுநாய	యునాయ
யுவநாத	యువనాత
யுவராநீ	యువరానీ
யுவாநவ	యువానవ
யேதாஂத	యేతాంత
யேநாக்ஷீ	యేనాక్షీ
யேஷ்வீ	యేష్వీ
யோகதீபா	యోకతీపా
யோகாஷ்ரீ	యోకాష్రీ
யோகீந	యోకీన
யோகீஷ	యోకీష
யோகேஷ்வரந	యోకేష్వరన
யோஜித	యోజిత
யோஜீதா	యోజీతా
யோதீந	యోతీన
யோஷா	యోషా
யோஷாநா	యోషానా
யௌஷா	యౌషా
ரஂகிதா	రంకితా
ரஂகீத	రంకీత
ரஂஜநீ	రంజనీ
ரஂஜீநா	రంజీనా
ரகவா	రకవా
ரகஷ்ந்டா	రకష్న్టా
ரகு	రకు
ரகுரமண	రకురమణ
ரகுவர	రకువర
ரக்தாகமல	రక్తాకమల
ரக்தீமாஂ	రక్తీమాం
ரக்ஷாதீ	రక్షాతీ
ரணஜீ	రణజీ
ரதாஂக	రతాంక
ரத்நாநிதி	రత్నానితి
ரத்நாபலீ	రత్నాపలీ
ரத்நாவலீ	రత్నావలీ
ரந்கௌரவ	రన్కౌరవ
ரந்ஜீக	రన్జీక
ரந்வித	రన్విత
ரமாகாஂத	రమాకాంత
ரமாயா	రమాయా
ரம்பேஷ	రమ్పేష
ரம்யக	రమ్యక
ரவீந்தார	రవీన్తార
ரவ்யஂகீ	రవ్యంకీ
ரஷ்மீல	రష్మీల
ரஸநா	రసనా
ரஸவிஹாரீ	రసవిహారీ
ரஸிக	రసిక
ரஸ்லுஂநீ	రస్లుంనీ
ரஹஸ	రహస
ராகவீ	రాకవీ
ராகிநீ	రాకినీ
ராக்வீநதார	రాక్వీనతార
ராஜ  கிரண	రాజ  కిరణ
ராஜாப்ரதா	రాజాప్రతా
ராஜார்ஷீ	రాజార్షీ
ராஜாவேல	రాజావేల
ராஜாவேலுஂ	రాజావేలుం
ராஜிகா	రాజికా
ராஜீதா	రాజీతా
ராஜ்யலக்ஷ்மீ	రాజ్యలక్ష్మీ
ராதா	రాతా
ராதா வல்லப	రాతా వల్లప
ராதாராநீ	రాతారానీ
ராதிக	రాతిక
ராதிகா	రాతికా
ராத்நாநீதீ	రాత్నానీతీ
ராத்ரி	రాత్రి
ராம  ஸேவக	రామ  సేవక
ராமப்ரீய	రామప్రీయ
ராமாநஂத	రామానంత
ராமிநீ	రామినీ
ராமேஷ்வர	రామేష్వర
ராவநா	రావనా
ராஷி	రాషి
ராஹீந்ய	రాహీన్య
ரிஷ்மிதா	రిష్మితా
ரிஹா	రిహా
ரீகீதா	రీకీతా
ரீக்வீதா	రీక్వీతా
ரீதாநா	రీతానా
ரீதி	రీతి
ரீதூ	రీతూ
ரீத்திதா	రీత్తితా
ரீத்யாஂஷ	రీత్యాంష
ரீநீ	రీనీ
ரீப்யா	రీప్యా
ரீமநா	రీమనా
ரீம்பீ	రీమ్పీ
ரீஷ்மேதா	రీష్మేతా
ரேஜீஷ	రేజీష
ரேணு	రేణు
ரேநுக	రేనుక
ரேநேஷ	రేనేష
ரேந்ஜீநீ	రేన్జీనీ
ரேவா	రేవా
ரேஹாஂஷீ	రేహాంషీ
ரேஹேஈலா	రేహేఈలా
ரைவத	రైవత
ரௌஷந	రౌషన
லகஸித	లకసిత
லக்ஷ்மீ ஷ்ரீநிவாஸ	లక్ష్మీ ష్రీనివాస
லக்ஷ்மீகோபால	లక్ష్మీకోపాల
லக்ஷ்மீநாராயநா	లక్ష్మీనారాయనా
லஜ்ஜா	లజ్జా
லஜ்ஜாகா	లజ్జాకా
லஜ்ஜீதா	లజ్జీతా
லலித	లలిత
லலிதகிஷோரே	లలితకిషోరే
லலிதசஂத்ரா	లలితచంత్రా
லலீதாமபிகா	లలీతామపికా
லலீத்யா	లలీత్యా
லவலீ	లవలీ
லாச்மந	లాచ్మన
லாதாநகீ	లాతానకీ
லாதீகா	లాతీకా
லாதேஷ	లాతేష
லாத்வீகா	లాత్వీకా
லாபந்ய	లాపన్య
லாராந	లారాన
லாரீநா	లారీనా
லாலநா	లాలనా
லாலமணி	లాలమణి
லாவந	లావన
லாவிக	లావిక
லாவீத்ர	లావీత్ర
லாவீஷ	లావీష
லாவ்நாய	లావ్నాయ
லாஸக	లాసక
லாஸ்ய	లాస్య
லீதீகா	లీతీకా
லீநா	లీనా
லீநுஂ	లీనుం
லீந்கபஂடீ	లీన్కపంటీ
லீந்கம	లీన్కమ
லீந்கஸம்ய	లీన్కసమ్య
லீந்கேஸ்வரண	లీన్కేస్వరణ
லீபஷீதா	లీపషీతా
லீபாக்ஷீ	లీపాక్షీ
லீப்ஸீகா	లీప్సీకా
லுகேஷ	లుకేష
லூநீ	లూనీ
லேஈவீநா	లేఈవీనా
லேக	లేక
லேகீஷா	లేకీషా
லேக்ஷாநா	లేక్షానా
லேமாஂ	లేమాం
லேமாஂநா	లేమాంనా
லோகநாயாகீ	లోకనాయాకీ
லோகாஜநாநீ	లోకాజనానీ
லோகாபுஜ்ய	లోకాపుజ్య
லோகேந்தீரண	లోకేన్తీరణ
லோகேஷ்வாரீ	లోకేష్వారీ
லோக்யா	లోక్యా
லோலா	లోలా
லோவ்யம	లోవ్యమ
லோஸீ	లోసీ
லோஹிதாஷ்வா	లోహితాష్వా
லோஹீத	లోహీత
லௌஹித்ய	లౌహిత్య
வஂசித	వంచిత
வஂஷ	వంష
வஂஷிகா	వంషికా
வஂஷீ	వంషీ
வஂஹிஷிகா	వంహిషికా
வக்ரதுஂட	వక్రతుంట
வஜ்ரக்ஷா	వజ్రక్షా
வஜ்ராஜித	వజ్రాజిత
வதநா	వతనా
வத்ஸிந	వత్సిన
வநாநீ	వనానీ
வநித	వనిత
வநிதா	వనితా
வநீத	వనీత
வயுநஂத	వయునంత
வரஜோத்தாமாஂ	వరజోత్తామాం
வரப்ரதா	వరప్రతా
வரரோஹா	వరరోహా
வருநாப்ரியா	వరునాప్రియా
வருந்ய	వరున్య
வருந்ஸாஈ	వరున్సాఈ
வரேஷ	వరేష
வர்ணித	వర్ణిత
வர்ஷ	వర్ష
வர்ஷநேயா	వర్షనేయా
வர்ஷாந	వర్షాన
வர்ஷால	వర్షాల
வர்ஷீதா	వర్షీతా
வர்ஷீல	వర్షీల
வலாக	వలాక
வல்லபா	వల్లపా
வல்லவ	వల్లవ
வஷீகரண	వషీకరణ
வஷீஷ்கா	వషీష్కా
வஸஂதீ	వసంతీ
வஸதிகா	వసతికా
வஸீ	వసీ
வஸுல	వసుల
வஸ்தாவீ	వస్తావీ
வஸ்மீஹா	వస్మీహా
வாகீஷ	వాకీష
வாஜ்ரநாகா	వాజ్రనాకా
வாதஷா	వాతషా
வாதிவேலந	వాతివేలన
வாத்ஸக	వాత్సక
வாநுஂ	వానుం
வாந்யா	వాన్యా
வாமா	వామా
வாரநா	వారనా
வாஸஂதாமாலிகா	వాసంతామాలికా
வாஸுந்தரா	వాసున్తరా
வாஸுமந	వాసుమన
வாஸுமாஂதா	వాసుమాంతా
வாஸுராதா	వాసురాతా
விஜயாஸ்ரீ	విజయాస్రీ
விதாஸ்ரீ	వితాస్రీ
விதுலா	వితులా
வித்யாலக்ஷ்மீ	విత్యాలక్ష్మీ
விநாம்ப்ரா	వినామ్ప్రా
விநாயிகா	వినాయికా
விபாத	విపాత
விமலா	విమలా
விரமாஂநீகாநதா	విరమాంనీకానతా
விராமநீ	విరామనీ
விஹாநா	విహానా
வீஆந	వీఆన
வீநாவாநீ	వీనావానీ
வீர்யவாந	వీర్యవాన
வேக்ஷநா	వేక్షనా
வேணு	వేణు
வேதவித்யா	వేతవిత్యా
வேதவ்ரதா	వేతవ్రతా
வேதாஂக	వేతాంక
வேதாஂகா	వేతాంకా
வேதாந்த	వేతాన్త
வேதார்த	వేతార్త
வேதாஷ்ரீ	వేతాష్రీ
வேதீமாஂ	వేతీమాం
வேத்ரிவால	వేత్రివాల
வேத்ரீவேல	వేత్రీవేల
வேத்வியந	వేత్వియన
வேநிமாதவ	వేనిమాతవ
வேநீ	వేనీ
வேநீஷா	వేనీషా
வேந்காதேஷ்வாரா	వేన్కాతేష్వారా
வேந்மதீ	వేన్మతీ
வேம்பரஸீ	వేమ్పరసీ
வைகுஂட	వైకుంట
வைஜயஂதீ	వైజయంతీ
வைதுர்யா	వైతుర్యా
வைத்யாத	వైత్యాత
வைஷாக	వైషాక
வைஷித	వైషిత
ஷக்திதார்ய	షక్తితార్య
ஸஂகத  தலீவந	సంకత  తలీవన
ஸஂகவீ	సంకవీ
ஸஂகீநீ	సంకీనీ
ஸஂகேத	సంకేత
ஸஂக்ராஂதி	సంక్రాంతి
ஸஂசயீதா	సంచయీతా
ஸஂசாநா	సంచానా
ஸஂசீதீ	సంచీతీ
ஸஂஜய	సంజయ
ஸஂஜாலீ	సంజాలీ
ஸஂஜீவநீ	సంజీవనీ
ஸஂஜீவீ	సంజీవీ
ஸஂஜோலீ	సంజోలీ
ஸஂததா	సంతతా
ஸஂதீதீ	సంతీతీ
ஸஂதீப	సంతీప
ஸஂதோக	సంతోక
ஸஂதோஷீதா	సంతోషీతా
ஸஂரகதா	సంరకతా
ஸஂஸிதா	సంసితా
ஸகா	సకా
ஸகுண	సకుణ
ஸக்ஷண	సక్షణ
ஸசிதா	సచితా
ஸசிதாநஂத விக்ரஹ	సచితానంత విక్రహ
ஸசிநதேவ	సచినతేవ
ஸசீதந	సచీతన
ஸசீநா	సచీనా
ஸசீந்தேஓ	సచీన్తేఓ
ஸதநாந்தம	సతనాన్తమ
ஸதபிஂது	సతపింతు
ஸதிஷ	సతిష
ஸநாவ்ய	సనావ్య
ஸந்நிதி	సన్నితి
ஸபரஂக	సపరంక
ஸபரீநாத	సపరీనాత
ஸப்தாபீ	సప్తాపీ
ஸமக	సమక
ஸமாஂநவீ	సమాంనవీ
ஸமாஜஸ	సమాజస
ஸமீர	సమీర
ஸமீரந	సమీరన
ஸமீரா	సమీరా
ஸமுத்ரா	సముత్రా
ஸம்மோத	సమ్మోత
ஸம்யுஂக்தா	సమ్యుంక్తా
ஸம்ரீத்தீ	సమ్రీత్తీ
ஸரஜா	సరజా
ஸரஸா	సరసా
ஸரிஷா	సరిషా
ஸர்பாநீ	సర్పానీ
ஸலஜ	సలజ
ஸஹரதய	సహరతయ
ஸஹஷ்ரத	సహష్రత
ஸஹஸ்வீநீ	సహస్వీనీ
ஸஹிகா	సహికా
ஸஹீத	సహీత
ஸஹீராம	సహీరామ
ஸஹேஜ	సహేజ
ஸாஂபா	సాంపా
ஸாஇ ஆநஂத	సాఇ ఆనంత
ஸாஇ ராம	సాఇ రామ
ஸாஈ லதா	సాఈ లతా
ஸாஈநாத	సాఈనాత
ஸாஈப்ரதாப	సాఈప్రతాప
ஸாகரிகா	సాకరికా
ஸாக்நீகா	సాక్నీకా
ஸாசீ	సాచీ
ஸாதரீ	సాతరీ
ஸாதவிக	సాతవిక
ஸாநியா	సానియా
ஸாமர	సామర
ஸாமலீ	సామలీ
ஸாயக	సాయక
ஸாரஂகீ	సారంకీ
ஸாவஂத	సావంత
ஸாவித்ரீ	సావిత్రీ
ஸாஹத	సాహత
ஸாஹஸ	సాహస
ஸாஹிதீ	సాహితీ
ஸுப்ரியா	సుప్రియా
ஸைகரா	సైకరా
ஹஂஷல	హంషల
ஹஂஸராஜ	హంసరాజ
ஹயாதீ	హయాతీ
ஹரஜீத	హరజీత
ஹரம்யா	హరమ్యా
ஹரஷீகேஷ	హరషీకేష
ஹரிகரஷ்ண	హరికరష్ణ
ஹரித	హరిత
ஹரிநாராயண	హరినారాయణ
ஹரிந்த்ரநாத	హరిన్త్రనాత
ஹரிப்ரீத	హరిప్రీత
ஹரிமஂதீ	హరిమంతీ
ஹரீதாம	హరీతామ
ஹரீநாதா	హరీనాతా
ஹரீபேஅஸாத	హరీపేఅసాత
ஹரீவல்லப	హరీవల్లప
ஹரீஷ்ரீ	హరీష్రీ
ஹரீஷ்வ	హరీష్వ
ஹரேந்த்ர	హరేన్త్ర
ஹரேஹாந	హరేహాన
ஹர்ஜஸ	హర్జస
ஹர்திக	హర్తిక
ஹர்பீதா	హర్పీతా
ஹர்யக்ஷ	హర్యక్ష
ஹர்ஷதா	హర్షతా
ஹர்ஷாலா	హర్షాలా
ஹர்ஷிகா	హర్షికా
ஹர்ஷீநீ	హర్షీనీ
ஹர்ஷீயா	హర్షీయా
ஹர்ஸிகா	హర్సికా
ஹவிஷ	హవిష
ஹவீந்தா	హవీన్తా
ஹவ்யா	హవ్యా
ஹஸமுக	హసముక
ஹஸித	హసిత
ஹாரிகா	హారికా
ஹாரீஜ	హారీజ
ஹிதீஷீந	హితీషీన
ஹிதைஷ	హితైష
ஹிந்தீ	హిన్తీ
ஹிமாசல	హిమాచల
ஹிமாந	హిమాన
ஹிரேந	హిరేన
ஹிஷால	హిషాల
ஹிஷீதா	హిషీతా
ஹீரா	హీరా
ஹீராந்யாப்பா	హీరాన్యాప్పా
ஹுமீஷா	హుమీషా
ஹும்ஸீகா	హుమ్సీకా
ஹுர்தித்யா	హుర్తిత్యా
ஹுவீஷ்கா	హువీష్కా
ஹுவேந்த்ர	హువేన్త్ర
ஹேஇஅந	హేఇఅన
ஹேதார்த	హేతార్త
ஹேதீநீ	హేతీనీ
ஹேது	హేతు
ஹேநா	హేనా
ஹேமதேவ	హేమతేవ
ஹேமா லாதீ	హేమా లాతీ
ஹேமாஂம்பரீ	హేమాంమ్పరీ
ஹேமாஂவாநீ	హేమాంవానీ
ஹேமாநீ	హేమానీ
ஹேமாவாதிநஂதந	హేమావాతినంతన
ஹேமீத்ரா	హేమీత్రా
ஹேம்க்ரீஷ	హేమ్క్రీష
ஹேரீத	హేరీత
ஹைமாஂ	హైమాం
ஹோநஹார	హోనహార
ஹ்ரீகீந	హ్రీకీన
ஹ்ரீதித	హ్రీతిత
ஹ்ரீஷாப	హ్రీషాప
#
#
# Territory names from CLDR
அஷன்ஷியன் தீவு	అషన్షియన్ తీవు
அன்டோரா	అన్టోరా
ஐக்கிய அரபு எமிரேட்ஸ்	ఐక్కియ అరపు ఎమిరేట్స్
ஆப்கானிஸ்தான்	ఆప్కానిస్తాన్
ஆண்டிகுவா மற்றும் பார்புடா	ఆణ్టికువా మఱ్ఱుమ్ పార్పుటా
அங்குய்லா	అఙ్కుయ్లా
அல்பேனியா	అల్పేనియా
அர்மேனியா	అర్మేనియా
அங்கோலா	అఙ్కోలా
அண்டார்டிகா	అణ్టార్టికా
அர்ஜென்டினா	అర్జెన్టినా
அமெரிக்க சமோவா	అమెరిక్క చమోవా
ஆஸ்திரியா	ఆస్తిరియా
ஆஸ்திரேலியா	ఆస్తిరేలియా
அரூபா	అరూపా
ஆலந்து தீவுகள்	ఆలన్తు తీవుకళ్
அசர்பைஜான்	అచర్పైజాన్
போஸ்னியா &amp; ஹெர்ஸகோவினா	పోస్నియా &amp; హెర్సకోవినా
பார்படோஸ்	పార్పటోస్
பங்களாதேஷ்	పఙ్కళాతేష్
பெல்ஜியம்	పెల్జియమ్
புர்கினா ஃபாஸோ	పుర్కినా ఃపాసో
பல்கேரியா	పల్కేరియా
பஹ்ரைன்	పహ్రైన్
புருண்டி	పురుణ్టి
பெனின்	పెనిన్
செயின்ட் பார்தேலெமி	చెయిన్ట్ పార్తేలెమి
பெர்முடா	పెర్ముటా
புரூனேய்	పురూనేయ్
பொலிவியா	పొలివియా
கரீபியன் நெதர்லாந்து	కరీపియన్ నెతర్లాన్తు
பிரேசில்	పిరేచిల్
பஹாமாஸ்	పహామాస్
பூடான்	పూటాన్
பொவேட் தீவுகள்	పొవేట్ తీవుకళ్
போட்ஸ்வானா	పోట్స్వానా
பெலாரூஸ்	పెలారూస్
பெலிஸ்	పెలిస్
கனடா	కనటా
கோகோஸ் (கீலிங்) தீவுகள்	కోకోస్ (కీలిఙ్) తీవుకళ్
காங்கோ - கின்ஷாசா	కాఙ్కో - కిన్షాచా
காங்கோ (டிஆர்சி)	కాఙ్కో (టిఆర్చి)
மத்திய ஆப்ரிக்கக் குடியரசு	మత్తియ ఆప్రిక్కక్ కుటియరచు
காங்கோ - ப்ராஸாவில்லே	కాఙ్కో - ప్రాసావిల్లే
காங்கோ (குடியரசு)	కాఙ్కో (కుటియరచు)
ஸ்விட்சர்லாந்து	స్విట్చర్లాన్తు
கோட் தி’வாயர்	కోట్ తి’వాయర్
ஐவரி கோஸ்ட்	ఐవరి కోస్ట్
குக் தீவுகள்	కుక్ తీవుకళ్
சிலி	చిలి
கேமரூன்	కేమరూన్
சீனா	చీనా
கொலம்பியா	కొలమ్పియా
கிலிப்பர்டன் தீவு	కిలిప్పర్టన్ తీవు
கோஸ்டாரிகா	కోస్టారికా
கியூபா	కియూపా
கேப் வெர்டே	కేప్ వెర్టే
குராகவ்	కురాకవ్
கிறிஸ்துமஸ் தீவு	కిఱిస్తుమస్ తీవు
சைப்ரஸ்	చైప్రస్
செக் குடியரசு	చెక్ కుటియరచు
ஜெர்மனி	జెర్మని
டியகோ கார்ஷியா	టియకో కార్షియా
ஜிபௌட்டி	జిపౌట్టి
டென்மார்க்	టెన్మార్క్
டொமினிகா	టొమినికా
டொமினிகன் குடியரசு	టొమినికన్ కుటియరచు
அல்ஜீரியா	అల్జీరియా
சியூடா &amp; மெலில்லா	చియూటా &amp; మెలిల్లా
ஈக்வடார்	ఈక్వటార్
எஸ்டோனியா	ఎస్టోనియా
எகிப்து	ఎకిప్తు
மேற்கு சஹாரா	మేఱ్కు చహారా
எரிட்ரியா	ఎరిట్రియా
ஸ்பெயின்	స్పెయిన్
எதியோப்பியா	ఎతియోప్పియా
ஐரோப்பிய யூனியன்	ఐరోప్పియ యూనియన్
பின்லாந்து	పిన్లాన్తు
ஃபிஜி	ఃపిజి
ஃபாக்லாந்து தீவுகள்	ఃపాక్లాన్తు తీవుకళ్
ஃபாக்லாந்து தீவுகள் (இஸ்லாஸ் மால்வினஸ்)	ఃపాక్లాన్తు తీవుకళ్ (ఇస్లాస్ మాల్వినస్)
மைக்ரோனேஷியா	మైక్రోనేషియా
ஃபாரோ தீவுகள்	ఃపారో తీవుకళ్
பிரான்ஸ்	పిరాన్స్
கேபான்	కేపాన్
ஐக்கிய பேரரசு	ఐక్కియ పేరరచు
யூகே	యూకే
கிரனெடா	కిరనెటా
ஜார்ஜியா	జార్జియా
பிரெஞ்சு கயானா	పిరెఞ్చు కయానా
கெர்ன்சி	కెర్న్చి
கானா	కానా
ஜிப்ரால்டர்	జిప్రాల్టర్
கிரீன்லாந்து	కిరీన్లాన్తు
காம்பியா	కామ్పియా
கினியா	కినియా
க்வாதேலோப்	క్వాతేలోప్
ஈக்வடோரியல் கினியா	ఈక్వటోరియల్ కినియా
கிரீஸ்	కిరీస్
தென் ஜியார்ஜியா மற்றும் தென் சான்ட்விச் தீவுகள்	తెన్ జియార్జియా మఱ్ఱుమ్ తెన్ చాన్ట్విచ్ తీవుకళ్
கவுதமாலா	కవుతమాలా
குவாம்	కువామ్
கினியா-பிஸ்ஸாவ்	కినియా-పిస్సావ్
கயானா	కయానా
ஹாங்காங் எஸ்ஏஆர் சீனா	హాఙ్కాఙ్ ఎస్ఏఆర్ చీనా
ஹாங்காங்	హాఙ్కాఙ్
ஹேர்ட் மற்றும் மெக்டொனால்டு தீவுகள்	హేర్ట్ మఱ్ఱుమ్ మెక్టొనాల్టు తీవుకళ్
ஹோண்டூராஸ்	హోణ్టూరాస్
குரேஷியா	కురేషియా
ஹைட்டி	హైట్టి
ஹங்கேரி	హఙ్కేరి
கேனரி தீவுகள்	కేనరి తీవుకళ్
இந்தோனேசியா	ఇన్తోనేచియా
அயர்லாந்து	అయర్లాన్తు
இஸ்ரேல்	ఇస్రేల్
ஐல் ஆஃப் மேன்	ఐల్ ఆఃప్ మేన్
இந்தியா	ఇన్తియా
பிரிட்டிஷ் இந்தியப் பெருங்கடல் பிரதேசம்	పిరిట్టిష్ ఇన్తియప్ పెరుఙ్కటల్ పిరతేచమ్
ஈராக்	ఈరాక్
ஈரான்	ఈరాన్
ஐஸ்லாந்து	ఐస్లాన్తు
இத்தாலி	ఇత్తాలి
ஜெர்சி	జెర్చి
ஜமைகா	జమైకా
ஜோர்டான்	జోర్టాన్
ஜப்பான்	జప్పాన్
கென்யா	కెన్యా
கிர்கிஸ்தான்	కిర్కిస్తాన్
கம்போடியா	కమ్పోటియా
கிரிபடி	కిరిపటి
கோமரோஸ்	కోమరోస్
செயின்ட் கிட்ஸ் &amp; நெவிஸ்	చెయిన్ట్ కిట్స్ &amp; నెవిస్
வட கொரியா	వట కొరియా
தென் கொரியா	తెన్ కొరియా
குவைத்	కువైత్
கெய்மென் தீவுகள்	కెయ్మెన్ తీవుకళ్
கஸகஸ்தான்	కసకస్తాన్
லாவோஸ்	లావోస్
லெபனான்	లెపనాన్
செயின்ட் லூசியா	చెయిన్ట్ లూచియా
லிச்செண்ஸ்டெய்ன்	లిచ్చెణ్స్టెయ్న్
இலங்கை	ఇలఙ్కై
லைபீரியா	లైపీరియా
லெசோதோ	లెచోతో
லிதுவேனியா	లితువేనియా
லக்ஸ்சம்பர்க்	లక్స్చమ్పర్క్
லாட்வியா	లాట్వియా
லிபியா	లిపియా
மொராக்கோ	మొరాక్కో
மொனாக்கோ	మొనాక్కో
மால்டோவா	మాల్టోవా
மான்டேனெக்ரோ	మాన్టేనెక్రో
செயின்ட் மார்ட்டீன்	చెయిన్ట్ మార్ట్టీన్
மடகாஸ்கர்	మటకాస్కర్
மார்ஷல் தீவுகள்	మార్షల్ తీవుకళ్
மாசிடோனியா	మాచిటోనియా
மாசிடோனியா (ஃபைரோம்)	మాచిటోనియా (ఃపైరోమ్)
மாலி	మాలి
மியான்மார் (பர்மா)	మియాన్మార్ (పర్మా)
மங்கோலியா	మఙ్కోలియా
மகாவ் எஸ்ஏஆர் சீனா	మకావ్ ఎస్ఏఆర్ చీనా
மகாவ்	మకావ్
வடக்கு மரியானா தீவுகள்	వటక్కు మరియానా తీవుకళ్
மார்டினிக்	మార్టినిక్
மௌரிடானியா	మౌరిటానియా
மாண்ட்செராட்	మాణ్ట్చెరాట్
மால்டா	మాల్టా
மொரிசியஸ்	మొరిచియస్
மாலத்தீவு	మాలత్తీవు
மலாவி	మలావి
மெக்சிகோ	మెక్చికో
மலேசியா	మలేచియా
மொசாம்பிக்	మొచామ్పిక్
நமீபியா	నమీపియా
நியூ கேலிடோனியா	నియూ కేలిటోనియా
நைஜர்	నైజర్
நார்ஃபோக் தீவுகள்	నార్ఃపోక్ తీవుకళ్
நைஜீரியா	నైజీరియా
நிகரகுவா	నికరకువా
நெதர்லாந்து	నెతర్లాన్తు
நார்வே	నార్వే
நேபாளம்	నేపాళమ్
நௌரு	నౌరు
நியூ	నియూ
நியூசிலாந்து	నియూచిలాన్తు
ஓமன்	ఓమన్
பனாமா	పనామా
பெரு	పెరు
பிரெஞ்சு பாலினேஷியா	పిరెఞ్చు పాలినేషియా
பப்புவா நியூ கினியா	పప్పువా నియూ కినియా
பிலிப்பைன்ஸ்	పిలిప్పైన్స్
பாகிஸ்தான்	పాకిస్తాన్
போலந்து	పోలన్తు
செயின்ட் பியர் &amp; மிக்வேலான்	చెయిన్ట్ పియర్ &amp; మిక్వేలాన్
பிட்கெய்ர்ன் தீவுகள்	పిట్కెయ్ర్న్ తీవుకళ్
பியூர்டோ ரிகோ	పియూర్టో రికో
பாலஸ்தீனிய பிரதேசங்கள்	పాలస్తీనియ పిరతేచఙ్కళ్
பாலஸ்தீனம்	పాలస్తీనమ్
போர்ச்சுக்கல்	పోర్చ్చుక్కల్
பாலோ	పాలో
பராகுவே	పరాకువే
கத்தார்	కత్తార్
வெளிப்புற ஓஷியானியா	వెళిప్పుఱ ఓషియానియా
ரீயூனியன்	రీయూనియన్
ருமேனியா	రుమేనియా
செர்பியா	చెర్పియా
ரஷ்யா	రష్యా
ருவான்டா	రువాన్టా
சவூதி அரேபியா	చవూతి అరేపియా
சாலமன் தீவுகள்	చాలమన్ తీవుకళ్
சீஷெல்ஸ்	చీషెల్స్
சூடான்	చూటాన్
ஸ்வீடன்	స్వీటన్
சிங்கப்பூர்	చిఙ్కప్పూర్
செயின்ட் ஹெலெனா	చెయిన్ట్ హెలెనా
ஸ்லோவேனியா	స్లోవేనియా
ஸ்வல்பார்டு &amp; ஜான் மேயன்	స్వల్పార్టు &amp; జాన్ మేయన్
ஸ்லோவாகியா	స్లోవాకియా
சியாரா லியோன்	చియారా లియోన్
சான் மரினோ	చాన్ మరినో
செனெகல்	చెనెకల్
சோமாலியா	చోమాలియా
சுரினாம்	చురినామ్
தெற்கு சூடான்	తెఱ్కు చూటాన్
சாவ் தோம் &amp; ப்ரின்சிபி	చావ్ తోమ్ &amp; ప్రిన్చిపి
எல் சால்வடார்	ఎల్ చాల్వటార్
சின்ட் மார்டென்	చిన్ట్ మార్టెన్
சிரியா	చిరియా
ஸ்வாஸிலாந்து	స్వాసిలాన్తు
டிரிஸ்டன் டா குன்ஹா	టిరిస్టన్ టా కున్హా
டர்க்ஸ் &amp; கைகோஸ் தீவுகள்	టర్క్స్ &amp; కైకోస్ తీవుకళ్
சாட்	చాట్
பிரெஞ்சு தெற்கு பிரதேசங்கள்	పిరెఞ్చు తెఱ్కు పిరతేచఙ్కళ్
டோகோ	టోకో
தாய்லாந்து	తాయ్లాన్తు
தாஜிகிஸ்தான்	తాజికిస్తాన్
டோகேலோ	టోకేలో
தைமூர்-லெஸ்தே	తైమూర్-లెస్తే
கிழக்கு தைமூர்	కిళక్కు తైమూర్
துர்க்மெனிஸ்தான்	తుర్క్మెనిస్తాన్
டுனிசியா	టునిచియా
டோங்கா	టోఙ్కా
துருக்கி	తురుక్కి
ட்ரினிடாட் &amp; டொபாகோ	ట్రినిటాట్ &amp; టొపాకో
துவாலூ	తువాలూ
தைவான்	తైవాన్
தான்சானியா	తాన్చానియా
உக்ரைன்	ఉక్రైన్
உகாண்டா	ఉకాణ్టా
அமெரிக்கா	అమెరిక్కా
யூஎஸ்	యూఎస్
உருகுவே	ఉరుకువే
உஸ்பெகிஸ்தான்	ఉస్పెకిస్తాన్
வாடிகன் நகரம்	వాటికన్ నకరమ్
செயின்ட் வின்சென்ட் &amp; கிரெனடைன்ஸ்	చెయిన్ట్ విన్చెన్ట్ &amp; కిరెనటైన్స్
வெனிசுலா	వెనిచులా
பிரிட்டீஷ் கன்னித் தீவுகள்	పిరిట్టీష్ కన్నిత్ తీవుకళ్
வியட்நாம்	వియట్నామ్
வனுவாட்டு	వనువాట్టు
வாலிஸ் மற்றும் ஃபுடுனா	వాలిస్ మఱ్ఱుమ్ ఃపుటునా
சமோவா	చమోవా
கொசோவோ	కొచోవో
ஏமன்	ఏమన్
மயோட்	మయోట్
தென் ஆப்பிரிக்கா	తెన్ ఆప్పిరిక్కా
ஜாம்பியா	జామ్పియా
ஜிம்பாப்வே	జిమ్పాప్వే
அறியப்படாத பிரதேசம்	అఱియప్పటాత పిరతేచమ్
