# Baby names
ಅಕಾರ್ಯಸುತಾ	அகார்யஸுதா
ಅಕ್ಶಿತೀ	அக்ஶிதீ
ಅಕ್ಷಥಾ	அக்ஷதா
ಅಕ್ಷೀ	அக்ஷீ
ಅಗ್ನಿಜ್ವಾಳಾ	அக்நிஜ்வாளா
ಅಗ್ರತಾ	அக்ரதா
ಅಘನ್ಯ	அகந்ய
ಅಚ್ಯುತಾನ	அச்யுதாந
ಅಜಸ್ಥಾ	அஜஸ்தா
ಅದವೈಕಾ	அதவைகா
ಅದಾಮ	அதாம
ಅದಿಥಾ	அதிதா
ಅದೀಕ್ಯಾ	அதீக்யா
ಅದೀತೀಯ	அதீதீய
ಅದ್ರಿತಾ	அத்ரிதா
ಅದ್ರಿಯನ	அத்ரியந
ಅದ್ರೀಶ	அத்ரீஶ
ಅದ್ಶಯಾ	அத்ஶயா
ಅಧರ್ಷ	அதர்ஷ
ಅಧಾವನ	அதாவந
ಅಧಿನೀ	அதிநீ
ಅಧ್ಯುತ	அத்யுத
ಅಧ್ರೀತಾ	அத்ரீதா
ಅನಿಯಾ	அநியா
ಅಬೀನಂದಾ	அபீநஂதா
ಅಬೀರಾಮ	அபீராம
ಅಬೀಶ	அபீஶ
ಅಬೀಸೇಶನ	அபீஸேஶந
ಅಬ್ಜಾಯೋನೀ	அப்ஜாயோநீ
ಅಬ್ಬೀರ	அப்பீர
ಅಭರಾಮ	அபராம
ಅಭಿಜನ	அபிஜந
ಅಭಿಜ್ಞಾ	அபிஜ்ஞா
ಅಭಿಜ್ಞಾನ	அபிஜ்ஞாந
ಅಭಿನಾ	அபிநா
ಅಭಿನಿವೇಶ	அபிநிவேஶ
ಅಭಿನುಂ	அபிநுஂ
ಅಭಿಮ	அபிம
ಅಭಿರಾತ	அபிராத
ಅಭಿರುಚಿ	அபிருசி
ಅಭಿರುಪಾ	அபிருபா
ಅಭಿಷೇಕ	அபிஷேக
ಅಭಿಹೀತಾ	அபிஹீதா
ಅಭೀಕರ್ಷ	அபீகர்ஷ
ಅಭೀಜೀಥ	அபீஜீத
ಅಭೀದೀ	அபீதீ
ಅಭೀಧಾ	அபீதா
ಅಭೀಪುಜ	அபீபுஜ
ಅಭೀಶ್ರೇಯ	அபீஶ்ரேய
ಅಭೀಸಿರಾತ	அபீஸிராத
ಅಭ್ಯುದಯ	அப்யுதய
ಅಭ್ರಕಾಸಿನ	அப்ரகாஸிந
ಅಸಿರಾ	அஸிரா
ಅಹಂಕಾರಾ	அஹஂகாரா
ಅಹ್ರ್ಮ್ಶುಲ್ಲಾ	அஹ்ர்ம்ஶுல்லா
ಅಹ್ಲಾದಾಜನನೀ	அஹ்லாதாஜநநீ
ಆಕರ್ಷಕ	ஆகர்ஷக
ಆತಿಶ	ஆதிஶ
ಆದರ್ಶಾ	ஆதர்ஶா
ಆದಿನಾಥ	ஆதிநாத
ಆದಿಪುರುಷ	ஆதிபுருஷ
ಆದ್ಯಾ	ஆத்யா
ಆಧಿರಾ	ஆதிரா
ಆಧಿರಾಇ	ஆதிராஇ
ಆಧೀರೇನ	ஆதீரேந
ಆನಂದತಾ	ஆநஂததா
ಆನಂದಿತ	ஆநஂதித
ಆನೀಕ	ஆநீக
ಆನೀಕಾ	ஆநீகா
ಆಪೇಕ್ಷಾ	ஆபேக்ஷா
ಆಭಾತ	ஆபாத
ಆಯಾಂಶ	ஆயாஂஶ
ಆಯುಷ	ஆயுஷ
ಆಯುಸ	ஆயுஸ
ಆರಾತ್ರಿಕಾ	ஆராத்ரிகா
ಆರಾಥನಾ	ஆராதநா
ಆರಾಧಕ	ஆராதக
ಆರೀವ	ஆரீவ
ಆರುನ್ಯ	ஆருந்ய
ಆರೋಹೀ	ஆரோஹீ
ಆರ್ಜವ	ஆர்ஜவ
ಆರ್ನವ	ஆர்நவ
ಆರ್ಪಿತ	ஆர்பித
ಆರ್ಯಮನ	ஆர்யமந
ಆರ್ಯವೀರ	ஆர்யவீர
ಆಲೋಕಾ	ஆலோகா
ಆವೀಶ	ஆவீஶ
ಆಸರಾ	ஆஸரா
ಆಸ್ಯಾ	ஆஸ்யா
ಆಹಾನ	ஆஹாந
ಆಹ್ನೀಕ	ஆஹ்நீக
ಇಂದುಕಲಾ	இஂதுகலா
ಇಂದುಲಾಲಾ	இஂதுலாலா
ಇತಿಶ್ರೀ	இதிஶ்ரீ
ಇನೀಯನ	இநீயந
ಇನ್ದೀವರ	இந்தீவர
ಇನ್ದುಕಾಂತಾ	இந்துகாஂதா
ಇನ್ದುಜ	இந்துஜ
ಇನ್ದುದಾರ	இந்துதார
ಇನ್ದುಶ್ರೀ	இந்துஶ்ரீ
ಇನ್ದ್ರಕಾಂತಾ	இந்த்ரகாஂதா
ಇನ್ದ್ರಜಿತ	இந்த்ரஜித
ಇನ್ದ್ರದತ್ತ	இந்த்ரதத்த
ಇನ್ದ್ರವದನ	இந்த்ரவதந
ಇನ್ಧು	இந்து
ಇಯಲೀಸಾಈ	இயலீஸாஈ
ಇಯ್ಯಾಪ್ಪನ	இய்யாப்பந
ಇರಾವತೀ	இராவதீ
ಇರೇಶ	இரேஶ
ಇಶೀ	இஶீ
ಇಸಕೀ	இஸகீ
ಇಸೀತಾ	இஸீதா
ಈನ್ದುಸ	ஈந்துஸ
ಈರಾವಾಜ	ஈராவாஜ
ಈಲಾಕ್ಕೀಯಾ	ஈலாக்கீயா
ಈಶಾನಾ	ஈஶாநா
ಈಶುಕ	ஈஶுக
ಈಶ್ತರ	ஈஶ்தர
ಈಶ್ವರದತ್ತ	ஈஶ்வரதத்த
ಈಹಮ	ஈஹம
ಉಜೇಶ	உஜேஶ
ಉಜ್ಜಾನಿನೀ	உஜ்ஜாநிநீ
ಉಜ್ವಳ	உஜ்வள
ಉಜ್ಹಾಲಾ	உஜ்ஹாலா
ಉತ್ಕರ್ಷ	உத்கர்ஷ
ಉತ್ಕರ್ಷಾ	உத்கர்ஷா
ಉತ್ತಮ	உத்தம
ಉತ್ತಿಯಾ	உத்தியா
ಉತ್ಪಲ	உத்பல
ಉತ್ಪಲಾಕ್ಷ	உத்பலாக்ஷ
ಉತ್ಪಲಾಭಾ	உத்பலாபா
ಉದಯಾ	உதயா
ಉದಾರ್ಚೀಸ	உதார்சீஸ
ಉದಾರ್ಶ	உதார்ஶ
ಉದೇಯ	உதேய
ಉದ್ದೀಪ	உத்தீப
ಉಧವ	உதவ
ಉಧ್ಗೀತಾ	உத்கீதா
ಉನ್ಮಾ	உந்மா
ಉಪಂಗ	உபஂக
ಉಪನಂದಾ	உபநஂதா
ಉಪನಾಯಿಕ	உபநாயிக
ಉಪಮನ್ಯು	உபமந்யு
ಉಪಮಾ	உபமா
ಉಪಲ	உபல
ಉಪಾಂಶು	உபாஂஶு
ಉಫ್ತಮ	உப்தம
ಉಮೇದ	உமேத
ಉರವಶೀ	உரவஶீ
ಉರುಗಾಯ	உருகாய
ಉರ್ಜೀತಾ	உர்ஜீதா
ಉರ್ಮಿಲ	உர்மில
ಉರ್ಮಿಲಾ	உர்மிலா
ಉಲಗಾಪ್ಪನ	உலகாப்பந
ಉಲ್ಕಾ	உல்கா
ಉಲ್ಕೇಶ	உல்கேஶ
ಉಲ್ಲಾಸಿತ	உல்லாஸித
ಉಲ್ಲಾಸೀಥಾ	உல்லாஸீதா
ಉಷಾ	உஷா
ಉಷ್ಮಾ	உஷ்மா
ಉಸ್ಲುಂನನ	உஸ்லுஂநந
ಋತಿಕಾ	ரிதிகா
ಏಈರಮ	ஏஈரம
ಏಕತಾ	ஏகதா
ಏಕನ್ಷಾ	ஏகந்ஷா
ಏಕೇಸ್ವಾರ	ஏகேஸ்வார
ಏಕ್ವಿರಾ	ஏக்விரா
ಏಲಾವೇನ್ಧನ	ஏலாவேந்தந
ಏಲೀಲೀ	ஏலீலீ
ಏಲೇಥಿಯಾ	ஏலேதியா
ಏವರಜ	ஏவரஜ
ಏಶಾನಿಕಾ	ஏஶாநிகா
ಏಸ್ವರದೀತ್ಯ	ஏஸ்வரதீத்ய
ಏಹೀತ	ஏஹீத
ಐನ್ಗೀನೀ	ஐந்கீநீ
ಐಷಾ	ஐஷா
ಓಜಸ್ವಿನೀ	ஓஜஸ்விநீ
ಓಜಸ್ವೀ	ஓஜஸ்வீ
ಓಜಸ್ವೀತಾ	ஓஜஸ்வீதா
ಓನೀರ	ஓநீர
ಓಮಕಾರ	ஓமகார
ಓಮಕಾರೀ	ஓமகாரீ
ಓಮನಾ	ஓமநா
ಓರಿಓನ	ஓரிஓந
ಓವೀನ	ஓவீந
ಓಶೀನ	ஓஶீந
ಔಶಿಗ	ஔஶிக
ಕಂಠ	கஂட
ಕಂಠನ	கஂடந
ಕಟರೀನಾ	கடரீநா
ಕತಾನ	கதாந
ಕತಾವ್ಯಾ	கதாவ்யா
ಕಥ್ಯನೀ	கத்யநீ
ಕನಕ	கநக
ಕನಕಾಬತೀ	கநகாபதீ
ಕನೀಜಾ	கநீஜா
ಕನ್ವಕ	கந்வக
ಕಪಾಲಿನೀ	கபாலிநீ
ಕಪೀಲೇಶ	கபீலேஶ
ಕಮಲಕಾಂತ	கமலகாஂத
ಕಮಲನಾಥ	கமலநாத
ಕಮಲಾ ಸಮಭಾವ	கமலா ஸமபாவ
ಕಮಲಾಕ್ಷೀ	கமலாக்ஷீ
ಕಯಾಲ್ವೀಝ್ಹೀ	கயால்வீச்ஹீ
ಕಯೋಶ	கயோஶ
ಕರನ	கரந
ಕರಾಲಾ	கராலா
ಕರುನಾಕರ	கருநாகர
ಕರ್ತೀಗಾ	கர்தீகா
ಕರ್ತೀಶಾ	கர்தீஶா
ಕಲರನೀ	கலரநீ
ಕಲಹನ	கலஹந
ಕಲಾಧರ	கலாதர
ಕಲಾಪಕ	கலாபக
ಕಲಾಪಿನೀ	கலாபிநீ
ಕಲಾಸಾವೇರೀ	கலாஸாவேரீ
ಕಲ್ಪಕ	கல்பக
ಕಲ್ಪಿತಾ	கல்பிதா
ಕಲ್ಪೇಶ	கல்பேஶ
ಕವನೀ	கவநீ
ಕವಿತ	கவித
ಕಶ್ವೀ	கஶ்வீ
ಕಸ್ತುರ	கஸ்துர
ಕಾಂಚನಾ	காஂசநா
ಕಾಂವ	காஂவ
ಕಾದಮ್ಬಿನೀ	காதம்பிநீ
ಕಾನನಬಾಲಾ	காநநபாலா
ಕಾನಾಕಾದರೀ	காநாகாதரீ
ಕಾನೀತಾ	காநீதா
ಕಾನೀನ	காநீந
ಕಾನೀಶ್ಕಾರ	காநீஶ்கார
ಕಾನುಶೀ	காநுஶீ
ಕಾನ್ಚಾನಾಧ್ವಾಜಾ	காந்சாநாத்வாஜா
ಕಾಮಮಾಂ	காமமாஂ
ಕಾಮಾ	காமா
ಕಾಮೇರೀನಾ	காமேரீநா
ಕಾಮೇಶ್ವರೀ	காமேஶ்வரீ
ಕಾಯಲವಿಲೀ	காயலவிலீ
ಕಾರುಣ್ಯ	காருண்ய
ಕಾರುಣ್ಯ ಪ್ರಕಾಶ	காருண்ய ப்ரகாஶ
ಕಾರೂಕಾ	காரூகா
ಕಾರ್ತಿಕೇಯನ	கார்திகேயந
ಕಾರ್ತೇಕೇಯಾ	கார்தேகேயா
ಕಾಲಿದಾಸ	காலிதாஸ
ಕಾಲಿಮೋಹನ	காலிமோஹந
ಕಾವ್ಯನ	காவ்யந
ಕಾವ್ಯಶ್ರೀ	காவ்யஶ்ரீ
ಕಾವ್ಯಸ್ರೀ	காவ்யஸ்ரீ
ಕಾಷ್ಠ	காஷ்ட
ಕಿಂಜಲ	கிஂஜல
ಕೀಅರಾ	கீஅரா
ಕೇತನ	கேதந
ಕೇಯಾ	கேயா
ಕೇಲಾಕಾ	கேலாகா
ಕೇವಲ	கேவல
ಕೇಶೀ	கேஶீ
ಕೇಸರೀಸುತ	கேஸரீஸுத
ಕೇಸವಾ	கேஸவா
ಕೇಸವಾರಾಜ	கேஸவாராஜ
ಕೈರವ	கைரவ
ಕೈಲಾಶಅಧಿಪತಿ	கைலாஶஅதிபதி
ಕೌಶಿಕಾ	கௌஶிகா
ಕೌಸುಧೀ	கௌஸுதீ
ಕೌಸ್ತುಭೀ	கௌஸ்துபீ
ಖಗೇನ್ದ್ರ	ககேந்த்ர
ಖನಕ	கநக
ಖನಿಕಾ	கநிகா
ಖಾಜಿತ	காஜித
ಖುಜಾರಾ	குஜாரா
ಖುಶ್ಬೂ	குஶ்பூ
ಗಂಗಜ	கஂகஜ
ಗಂಧರ್ವವಿದ್ಯಾ	கஂதர்வவித்யா
ಗಜಗಾಮಿನೀ	கஜகாமிநீ
ಗಜಪತಿ	கஜபதி
ಗಜರಾಜ	கஜராஜ
ಗಜಾಧರ	கஜாதர
ಗಣಕ	கணக
ಗಣಪತ	கணபத
ಗಣಿತಾ	கணிதா
ಗಣ್ಯಾ	கண்யா
ಗತಿತಾ	கதிதா
ಗನಾಕ್ಷೀ	கநாக்ஷீ
ಗನೇಂದ್ರ	கநேஂத்ர
ಗನ್ಗವಾಥೀ	கந்கவாதீ
ಗರವೀ	கரவீ
ಗರಿಮಾ	கரிமா
ಗರ್ಜನ	கர்ஜந
ಗರ್ವಿತ	கர்வித
ಗರ್ವಿತಾ	கர்விதா
ಗಹನಾ	கஹநா
ಗಾಥಾ	காதா
ಗಾವ್ಯಾ	காவ்யா
ಗಿರಾ	கிரா
ಗಿರಿಕ	கிரிக
ಗಿರಿಜಾನಂದನ	கிரிஜாநஂதந
ಗಿರ್ವಾನ	கிர்வாந
ಗೀರೀಚಂದ್ರ	கீரீசஂத்ர
ಗೀರ್ವೇನ	கீர்வேந
ಗೀಸೇಲೇ	கீஸேலே
ಗುನವಂತೀ	குநவஂதீ
ಗುನಾರತ್ನಾ	குநாரத்நா
ಗುನಾವತೀ	குநாவதீ
ಗುನಾಸೇಕರಣ	குநாஸேகரண
ಗುನೀತ	குநீத
ಗುನ್ಜೀತಾ	குந்ஜீதா
ಗುನ್ದಾಪಾ	குந்தாபா
ಗುನ್ರೇಖಾ	குந்ரேகா
ಗುರುದೂತ್ತ	குருதூத்த
ಗುರುಬಚನ	குருபசந
ಗುರುರಾಜ	குருராஜ
ಗುಲಜಾರೀಲಾಲ	குலஜாரீலால
ಗುಲಮೋಹರ	குலமோஹர
ಗುಲ್ಜನ	குல்ஜந
ಗುಹಾನ	குஹாந
ಗೇಶನಾ	கேஶநா
ಗೋಕೀಲಾ	கோகீலா
ಗೋತಮ	கோதம
ಗೋಮಾಂಥೀ	கோமாஂதீ
ಗೋಮ್ಯಾಸರೀ	கோம்யாஸரீ
ಗೋವಿಂದಾ	கோவிஂதா
ಗೋವಿನ್ದೀ	கோவிந்தீ
ಗೋವೀನೇಶ	கோவீநேஶ
ಘನಾವೀ	கநாவீ
ಚಂಚಾರೀಕ	சஂசாரீக
ಚಂಡಮುಂಡವಿನಾಶಿನೀ	சஂடமுஂடவிநாஶிநீ
ಚಂದನಾ	சஂதநா
ಚಂದಸರೀ	சஂதஸரீ
ಚಂದ್ರಕಂತೀ	சஂத்ரகஂதீ
ಚಂದ್ರಕಾಂತ	சஂத்ரகாஂத
ಚಂದ್ರಕೀ	சஂத்ரகீ
ಚಂದ್ರಕೀರ್ತೀ	சஂத்ரகீர்தீ
ಚಂದ್ರಚುರ	சஂத்ரசுர
ಚಂದ್ರಥಾ	சஂத்ரதா
ಚಂದ್ರನ್ಶುಂ	சஂத்ரந்ஶுஂ
ಚಂದ್ರಮುಖೀ	சஂத்ரமுகீ
ಚಂದ್ರರಾಜ	சஂத்ரராஜ
ಚಂದ್ರಲೇಕ್ಷಾ	சஂத்ரலேக்ஷா
ಚಂದ್ರಿಮಾ	சஂத்ரிமா
ಚಂದ್ರು	சஂத்ரு
ಚಂಧು	சஂது
ಚಕೋರೀ	சகோரீ
ಚಕ್ರಾಹೀಂ	சக்ராஹீஂ
ಚಕ್ಷಸ	சக்ஷஸ
ಚತುರ್ಬಹಾವೇ	சதுர்பஹாவே
ಚನ್ದ್ರಜ್ಯೋತಿ	சந்த்ரஜ்யோதி
ಚನ್ದ್ರವದನ	சந்த்ரவதந
ಚನ್ದ್ರಸಹೋದಾರೀ	சந்த்ரஸஹோதாரீ
ಚರುಲಾ	சருலா
ಚಾತುರ್ಯ	சாதுர்ய
ಚಾನಾಸ್ಯಾ	சாநாஸ்யா
ಚಾನ್ದಿನೀ	சாந்திநீ
ಚಾನ್ನಕ್ಕಾ	சாந்நக்கா
ಚಾಯನಾ	சாயநா
ಚಾರುದತ್ತ	சாருதத்த
ಚಾರುಪ್ರಭಾ	சாருப்ரபா
ಚಾರ್ವೀ	சார்வீ
ಚಿಂತ್ಯಾ	சிஂத்யா
ಚಿತಾಯು	சிதாயு
ಚಿತ್ತರಂಜನೀ	சித்தரஂஜநீ
ಚಿತ್ತಸ್ವರೂಪ	சித்தஸ்வரூப
ಚಿತ್ತೇಶ	சித்தேஶ
ಚಿತ್ರಂಶ	சித்ரஂஶ
ಚಿತ್ರಕುನ್ಧಾಲಾ	சித்ரகுந்தாலா
ಚಿತ್ರಬಾನಾ	சித்ரபாநா
ಚಿತ್ರಾದೇವೀ	சித்ராதேவீ
ಚಿತ್ರಾನೀ	சித்ராநீ
ಚಿತ್ರೀನೀ	சித்ரீநீ
ಚಿದಂಬರಮ	சிதஂபரம
ಚಿದಾನಂದಾ	சிதாநஂதா
ಚಿನಾರ	சிநார
ಚೀನ್ಕಲ	சீந்கல
ಚೀನ್ನಾಮಾಂಸ್ತೀಕಾ	சீந்நாமாஂஸ்தீகா
ಚೀನ್ನೀಃ	சீந்நீஃ
ಚೇತಕ	சேதக
ಚೇತನ್ದೀಪ	சேதந்தீப
ಚೈತ್ರಯೇಶ	சைத்ரயேஶ
ಚೋಲನ	சோலந
ಛೋಟು	சோடு
ಜಗತವೀರ	ஜகதவீர
ಜಗದಬಂದು	ஜகதபஂது
ಜಗ್ವೀರ	ஜக்வீர
ಜನತಾ	ஜநதா
ಜನೀಶಾ	ஜநீஶா
ಜನ್ಮೇಶ	ஜந்மேஶ
ಜಪೇಶ	ஜபேஶ
ಜಪ್ತೇಶ	ஜப்தேஶ
ಜಬಿನೇ	ஜபிநே
ಜಮಾಂದಾಗ್ನ್ಯ ಮಹಾದಾರ್ಪಾ	ஜமாஂதாக்ந்ய மஹாதார்பா
ಜಯ ಪ್ರಕಾಶ	ஜய ப்ரகாஶ
ಜಯಂತಾ	ஜயஂதா
ಜಯಚಂದ	ஜயசஂத
ಜಯಪ್ರಭಾ	ஜயப்ரபா
ಜಯಾ ಕುಮಾರೀ	ஜயா குமாரீ
ಜಯಾಕೀರ್ಥೀ	ஜயாகீர்தீ
ಜಯಾಸಂಕರ	ஜயாஸஂகர
ಜಯೀನ	ஜயீந
ಜಯೇನ್ದ್ರ	ஜயேந்த்ர
ಜಯ್ಮೀನೀ	ஜய்மீநீ
ಜಲಜ	ஜலஜ
ಜಲದ	ஜலத
ಜಲಧೀಜಾ	ஜலதீஜா
ಜಲಾರ್ಕ	ஜலார்க
ಜಲ್ಪೂರ್ನಾ	ஜல்பூர்நா
ಜವಾಹರೀ	ஜவாஹரீ
ಜಶವಂತ	ஜஶவஂத
ಜಶೋದಾ	ஜஶோதா
ಜಶ್ಮೀನಾ	ஜஶ்மீநா
ಜಸಜೀತ	ஜஸஜீத
ಜಸಬೀರ	ஜஸபீர
ಜಸಮಿತ	ஜஸமித
ಜಸರಾಜ	ஜஸராஜ
ಜಸವೀರ	ஜஸவீர
ಜಸೀಮಾ	ஜஸீமா
ಜಸ್ಕೀರಿತ	ஜஸ்கீரித
ಜಸ್ಮಿಕಾ	ஜஸ்மிகா
ಜಸ್ಮೀಥ್ಯಾ	ஜஸ்மீத்யா
ಜಹನಕ	ஜஹநக
ಜಾಂಸೀ	ஜாஂஸீ
ಜಾಗ	ஜாக
ಜಾಗವೀ	ஜாகவீ
ಜಾಗೃತಿ	ஜாக்ரிதி
ಜಾನಕೀಭೂಷಣ	ஜாநகீபூஷண
ಜಾನಕೀರಮನ	ஜாநகீரமந
ಜಾನಾ	ஜாநா
ಜಾನ್ವೀ	ஜாந்வீ
ಜಾಪಕ	ஜாபக
ಜಾಹೀ	ஜாஹீ
ಜಿಜ್ಞಾಸಾ	ஜிஜ்ஞாஸா
ಜಿತೇನ್ದ್ರಿಯ	ஜிதேந்த்ரிய
ಜಿಶ್ನು	ஜிஶ்நு
ಜೀಗೇನ	ஜீகேந
ಜೀಜ್ಞಾಶಾ	ஜீஜ்ஞாஶா
ಜೀತನ	ஜீதந
ಜೀತಾಕಮ	ஜீதாகம
ಜೀತಾವಾರಆಶಯೇ	ஜீதாவாரஆஶயே
ಜೀನ್ದಾಲ	ஜீந்தால
ಜೀಯಾಂಶೀ	ஜீயாஂஶீ
ಜೀವೀ	ஜீவீ
ಜೀಶನಾ	ஜீஶநா
ಜೇನ್ನಯ	ஜேந்நய
ಜೇಯಾನ್ದ್ರಣ	ஜேயாந்த்ரண
ಜೇರ್ರೀಷ	ஜேர்ரீஷ
ಜೇರ್ಶೀಕಾ	ஜேர்ஶீகா
ಜೈಚಾನ್ದ್ರಣ	ஜைசாந்த்ரண
ಜೈನ	ஜைந
ಜೈಸಲ	ஜைஸல
ಜೈಹಾಸೀನೀ	ஜைஹாஸீநீ
ಜೋಸ್ಯಾ	ஜோஸ்யா
ಜ್ಞಾನದೇವ	ஜ்ஞாநதேவ
ಜ್ಞಾನಾ	ஜ்ஞாநா
ಜ್ಞಾನಾಲ	ஜ்ஞாநால
ಜ್ಞಾನೇಶ್ವರೀ	ஜ்ஞாநேஶ்வரீ
ಜ್ಯೋತಿರ್ಮೋಯೀ	ஜ்யோதிர்மோயீ
ಜ್ಯೋತಿಷಮತಿ	ஜ்யோதிஷமதி
ಜ್ಯೋಥೀರ್ಮಾಈ	ஜ்யோதீர்மாஈ
ಜ್ಹಂಕರ	ஜ்ஹஂகர
ಜ್ಹಿಲ	ஜ்ஹில
ಝರಲ	சரல
ಝವಿಯನ	சவியந
ಝಾರಾ	சாரா
ಝೀಣೀ	சீணீ
ಝೇನೀತ	சேநீத
ಝೇನೀಶಾ	சேநீஶா
ಝ್ಯನಾ	ச்யநா
ಟಿಮ್ಮೀ	டிம்மீ
ಠುಮಕೀ	டுமகீ
ಠುಮರೀ	டுமரீ
ಡಿಮ್ಪೀ	டிம்பீ
ತಂಗವೇಲ	தஂகவேல
ತಂತ್ರ	தஂத்ர
ತಂಸೀ	தஂஸீ
ತಕ್ಶೀಲ	தக்ஶீல
ತಜಜ್ಞ	தஜஜ்ஞ
ತಜಸರೀ	தஜஸரீ
ತತ್ವಗ್ಯಾನಾಪ್ರದ	தத்வக்யாநாப்ரத
ತನವೀರ	தநவீர
ತನಾವ	தநாவ
ತನೇಶ	தநேஶ
ತನ್ವಿಕಾ	தந்விகா
ತನ್ವೀಶ್ರೀ	தந்வீஶ்ரீ
ತಪಸ	தபஸ
ತಪಸ್ವೀ	தபஸ்வீ
ತಮಸ	தமஸ
ತಮಾಯಾನ್ಥ್ಯ	தமாயாந்த்ய
ತಮಾಸ್ವೀ	தமாஸ்வீ
ತಮಿಲಾ	தமிலா
ತಮೇಶ	தமேஶ
ತರಂಗಿನೀ	தரஂகிநீ
ತರಲ	தரல
ತರಸ್ವೀನ	தரஸ்வீந
ತರಿತ	தரித
ತರುಶೀ	தருஶீ
ತಲ್ಲೀ	தல்லீ
ತಶಾ	தஶா
ತಾಕ್ಸ್ವೀಹ	தாக்ஸ்வீஹ
ತಾನಾಸೀ	தாநாஸீ
ತಾನ್ಹಿತಾ	தாந்ஹிதா
ತಾಮಾಂಶ್ರೀ	தாமாஂஶ்ரீ
ತಾಮಾಸ್ವಿನೀ	தாமாஸ்விநீ
ತಾಮಿಲಸೇಲ್ವೀ	தாமிலஸேல்வீ
ತಾಯೀನ	தாயீந
ತಾರಾಕ್ಷ	தாராக்ஷ
ತಾರಾಚಂದ	தாராசஂத
ತಾರಾನೀಸೇನ	தாராநீஸேந
ತಾರೀಶೀ	தாரீஶீ
ತಾಲಿನ	தாலிந
ತಾವಾಸ್ಯ	தாவாஸ்ய
ತಿತಲೀ	திதலீ
ತಿಲಕ	திலக
ತಿಸ್ಯಾ	திஸ்யா
ತೀಅನಾ	தீஅநா
ತೀಯಶಾ	தீயஶா
ತೀಯಸ	தீயஸ
ತುನಾವಾ	துநாவா
ತುರಾನ್ಯು	துராந்யு
ತುಲಜಾ	துலஜா
ತುಲಸಾ	துலஸா
ತುಲೀ	துலீ
ತುಲೀಪ	துலீப
ತುಷಾರ	துஷார
ತುಷಿತ	துஷித
ತುಷ್ಟಿ	துஷ்டி
ತೇಗವಿರ	தேகவிர
ತೇಜಸೀ	தேஜஸீ
ತೇಜಸ್ವೀ	தேஜஸ்வீ
ತೇಜಸ್ವೀನ	தேஜஸ்வீந
ತೇಜೀ	தேஜீ
ತೇಜುಲ	தேஜுல
ತೇಜೇನದರ	தேஜேநதர
ತೇಜೇಶ	தேஜேஶ
ತೇವಾನ	தேவாந
ತೇಸಶ	தேஸஶ
ತೋಮಾಂಲೀ	தோமாஂலீ
ತೋಯಾಜ	தோயாஜ
ತೋಶೀ	தோஶீ
ತೋಶೀನ	தோஶீந
ತೌಲೀಕ	தௌலீக
ತ್ರಂಬಕ	த்ரஂபக
ತ್ರಿಂಬಿಕಾ	த்ரிஂபிகா
ತ್ರಿಕಾಯಾ	த்ரிகாயா
ತ್ರಿಜಲ	த்ரிஜல
ತ್ರಿಪುತಾ	த்ரிபுதா
ತ್ರಿಪುರಸುಂದರೀ	த்ரிபுரஸுஂதரீ
ತ್ರಿಪುರಾರೀ	த்ரிபுராரீ
ತ್ರಿಪ್ತಾ	த்ரிப்தா
ತ್ರಿಲೋಕೇಶ	த்ரிலோகேஶ
ತ್ರಿವಿಕ್ರಮ	த்ரிவிக்ரம
ತ್ರಿವೇಣೀ	த்ரிவேணீ
ತ್ರಿಶಲಾನಾ	த்ரிஶலாநா
ತ್ರಿಶಾಲಾ	த்ரிஶாலா
ತ್ರಿಶುಲಿನೀ	த்ரிஶுலிநீ
ತ್ರೀನೇಶ	த்ரீநேஶ
ತ್ರೀಮ್ಬೀಕಾ	த்ரீம்பீகா
ತ್ರೀಲೋಚನನ	த்ரீலோசநந
ತ್ರೀವೀದ	த்ரீவீத
ತ್ರೀಸವಾ	த்ரீஸவா
ಥಂಗಾ	தஂகா
ಥಾನೀಶ್ಕಾ	தாநீஶ்கா
ಥಾನುಂಶಾ	தாநுஂஶா
ಥಾರ್ಶೀನೀ	தார்ஶீநீ
ಥಾರ್ಸೀನ	தார்ஸீந
ದಂದಾಪಾನೀ	தஂதாபாநீ
ದಕ್ಶಾಜಾ	தக்ஶாஜா
ದಕ್ಷೀ	தக்ஷீ
ದಯಾಕರ	தயாகர
ದಯಾನಿತಾ	தயாநிதா
ದಯಾಲನ	தயாலந
ದರಹಾಸ	தரஹாஸ
ದರಿದ್ರಾ ಧಾವ್ಸೀನೀ	தரித்ரா தாவ்ஸீநீ
ದರೀತ್ರೀ	தரீத்ரீ
ದರ್ಮೀನೀ	தர்மீநீ
ದರ್ಸೀಕಾ	தர்ஸீகா
ದವೇ	தவே
ದಶಾ	தஶா
ದಶಾಗ್ರೀವಾ ಶೀರೋಹರಾ	தஶாக்ரீவா ஶீரோஹரா
ದಾನ್ಸೀಕಾ	தாந்ஸீகா
ದಾಮಾ	தாமா
ದಾರುಕಾ	தாருகா
ದಾಶಾರತೀ	தாஶாரதீ
ದಿಕ್ಶಾನ್ಯ	திக்ஶாந்ய
ದಿಕ್ಶೀಕಾ	திக்ஶீகா
ದಿನ ದಯಾಲ	திந தயால
ದಿಪಂಶೀ	திபஂஶீ
ದಿಪೇಂದರ	திபேஂதர
ದಿಪೇನ	திபேந
ದೀಪ್ತಿಕಾನಾ	தீப்திகாநா
ದೀಪ್ತಿಮೋಯ	தீப்திமோய
ದೇನೀಷ	தேநீஷ
ದೇಬಸ್ಮಿತಾ	தேபஸ்மிதா
ದೇಬೋಪ್ರಿಯಾ	தேபோப்ரியா
ದೇಬೋಸ್ಮಿತಾ	தேபோஸ்மிதா
ದೇಬ್ಜಾನೀ	தேப்ஜாநீ
ದೇಮ್ಧೇನ್ದ್ರ	தேம்தேந்த்ர
ದೇಯ್ದಿಪ್ಯಾ	தேய்திப்யா
ದೇಲೀನಾ	தேலீநா
ದೇವ ನರೇನ	தேவ நரேந
ದೇವದೀಪ	தேவதீப
ದೇವನಾಥನ	தேவநாதந
ದೇವಪದ	தேவபத
ದೇವರತ	தேவரத
ದೇವರಾಜ	தேவராஜ
ದೇವರಾಜನ	தேவராஜந
ದೇವಲ	தேவல
ದೇವಾಂಶು	தேவாஂஶு
ದೇವಾರಹಾಲ್ಲೀ	தேவாரஹால்லீ
ದೇವಾಶ್ರೀ	தேவாஶ்ரீ
ದೇವೀ	தேவீ
ದೇವ್ಬ್ರತಾ	தேவ்ப்ரதா
ದೇವ್ಮುಕೀಲ	தேவ்முகீல
ದೇವ್ಯೋಶಾ	தேவ்யோஶா
ದೇಶಿಕ	தேஶிக
ದೈತ್ಯ ಸಾಈ	தைத்ய ஸாஈ
ದೈನಾ	தைநா
ದೈವಂಶ	தைவஂஶ
ದ್ಯುತಿ	த்யுதி
ಧನಶಿಕಾ	தநஶிகா
ಧನ್ವಿಕಾ	தந்விகா
ಧರಿಯಾ	தரியா
ಧರ್ಮ	தர்ம
ಧರ್ಮಜಾ	தர்மஜா
ಧರ್ಮದಿತ್ಯ	தர்மதித்ய
ಧಾತ್ರೀ	தாத்ரீ
ಧಾನ	தாந
ಧಾನೀತ	தாநீத
ಧಾನೀಶಾ	தாநீஶா
ಧಾಮೀನೀ	தாமீநீ
ಧಾಮೋಧಾರ	தாமோதார
ಧಾವಿತ	தாவித
ಧಿತಿ	திதி
ಧೀಯಾನ	தீயாந
ಧುಹಿತಾ	துஹிதா
ಧೃತಿ	த்ரிதி
ಧೈರ್ಯ್ಯಾ	தைர்ய்யா
ಧ್ರೀಶೀಕಾ	த்ரீஶீகா
ಧ್ರೀಶ್ತೀಕಾ	த்ரீஶ்தீகா
ಧ್ರುವಿಕಾ	த்ருவிகா
ಧ್ವೀಜಾ	த்வீஜா
ನಂದಕುಮಾರ	நஂதகுமார
ನಕುಲ	நகுல
ನಕ್ಷತ್ರಾ	நக்ஷத்ரா
ನಚಿಕೇತಾ	நசிகேதா
ನತಾಲೀ	நதாலீ
ನಬರೂಣ	நபரூண
ನಭೋಜ	நபோஜ
ನಮ್ರಹ	நம்ரஹ
ನಲಿನ	நலிந
ನವಮ	நவம
ನವರಾತನಾ	நவராதநா
ನವಾಲನ	நவாலந
ನವೇಂದು	நவேஂது
ನಾಕುಶ	நாகுஶ
ನಾಗಧವಾನೀ	நாகதவாநீ
ನಾಗರತನಾ	நாகரதநா
ನಾಗಿನೀ	நாகிநீ
ನಾಗೇನ್ದ್ರ	நாகேந்த்ர
ನಾದಿಯಾ	நாதியா
ನಾಧಾ	நாதா
ನಾಧೀನೀ	நாதீநீ
ನಾನ್ತೀನೀ	நாந்தீநீ
ನಾಬಹ	நாபஹ
ನಾಭೀನತ	நாபீநத
ನಾಮೀಶಾ	நாமீஶா
ನಾಯತ	நாயத
ನಾರಾಯಾಣಾ	நாராயாணா
ನಾರ್ಮಾಂಥಾ	நார்மாஂதா
ನಾರ್ಸೀಮುಲುಂ	நார்ஸீமுலுஂ
ನಾಲಾನೀಲ	நாலாநீல
ನಾಲಾವೇನ್ಭಾ	நாலாவேந்பா
ನಾವಾಪ್ರಿಯನ	நாவாப்ரியந
ನಾವಾಮಾಂಲ್ಲೀ	நாவாமாஂல்லீ
ನಾವೀಶಾ	நாவீஶா
ನಾವ್ಯಶ್ರೀ	நாவ்யஶ்ரீ
ನಾವ್ಯಸರೀ	நாவ்யஸரீ
ನಾವ್ಯಾ	நாவ்யா
ನಾಹುಲ	நாஹுல
ನಿಕೀನ	நிகீந
ನಿಖಾರ	நிகார
ನಿಖಿಲೇಶ	நிகிலேஶ
ನಿದೇಶ	நிதேஶ
ನಿಧ್ಯಾಥೀ	நித்யாதீ
ನಿಭಯ	நிபய
ನಿರಜಾ	நிரஜா
ನಿರ್ಜಲಾ	நிர்ஜலா
ನಿಶಾ	நிஶா
ನಿಶಿಥಿನೀ	நிஶிதிநீ
ನಿಹಾರಿಕಾ	நிஹாரிகா
ನೀಕಮ	நீகம
ನೀಕಾನ್ದರ್ಯ	நீகாந்தர்ய
ನೀಕೀಲ	நீகீல
ನೀಕುಂಜ	நீகுஂஜ
ನೀಕುಲ	நீகுல
ನೀಚೀತಾ	நீசீதா
ನೀಜಾ	நீஜா
ನೀಡೀ	நீடீ
ನೀತಾ	நீதா
ನೀದೀಶ	நீதீஶ
ನೀನಾ	நீநா
ನೀನ್ನ್ಯ	நீந்ந்ய
ನೀಭೀಶ	நீபீஶ
ನೀರುಧೀ	நீருதீ
ನೀರೇಕ್ಷಾ	நீரேக்ஷா
ನೀಲ	நீல
ನೀಲ ಕಾಂತಾ	நீல காஂதா
ನೀಲ ಮಾಧವ	நீல மாதவ
ನೀಲಂಜನಾ	நீலஂஜநா
ನೀಲಕಮಾಲಾ	நீலகமாலா
ನೀಲದೇವೀ	நீலதேவீ
ನೀಲಯ	நீலய
ನೀಲಾಂಜನ	நீலாஂஜந
ನೀಲಾಮ್ಬೇರ	நீலாம்பேர
ನೀಲೋರ್ಮ್ಯ	நீலோர்ம்ய
ನೀಲ್ಸಾ	நீல்ஸா
ನೀಶಾಲೀ	நீஶாலீ
ನೀಷ್ಟಾ	நீஷ்டா
ನೀಸಿತೀನೀ	நீஸிதீநீ
ನೀಸ್ಚೀಥಾ	நீஸ்சீதா
ನೀಹಮ	நீஹம
ನೀಹಾರಿಕಾ	நீஹாரிகா
ನೀಹೀಥಾ	நீஹீதா
ನೀಹೀರಾ	நீஹீரா
ನೇಮಾ	நேமா
ನೇಮಾಂಲೀ	நேமாஂலீ
ನೇಹಾರಿಕಾ	நேஹாரிகா
ನೈತಿ	நைதி
ನೈರೀತೀ	நைரீதீ
ನೈವೇದ	நைவேத
ನೈಷೀ	நைஷீ
ನೌಬಹಾರ	நௌபஹார
ಪಂಕಜ಼ಾ	பஂகஜா
ಪಂಖೀ	பஂகீ
ಪಂಚಮ	பஂசம
ಪಂಚಾಲೀ	பஂசாலீ
ಪಂಥ	பஂத
ಪಂಧಾರೀ	பஂதாரீ
ಪಣ-ಗೇಶ	பண-கேஶ
ಪತಾಲಾ	பதாலா
ಪತ್ರಲಿಕಾ	பத்ரலிகா
ಪದಮಾವತೀ	பதமாவதீ
ಪದ್ಮಬಂಧೂ	பத்மபஂதூ
ಪದ್ಮಹಸ್ತಾ	பத்மஹஸ்தா
ಪದ್ಮಾಂನಾಭಾ ಪ್ರಿಯಾ	பத்மாஂநாபா ப்ரியா
ಪನೀಶ್ಕಾ	பநீஶ்கா
ಪನ್ಕಾಜಮ	பந்காஜம
ಪನ್ದಾಲಾವಾಸನ	பந்தாலாவாஸந
ಪಪಮ್ಮಾಂ	பபம்மாஂ
ಪರಮಂದಾ	பரமஂதா
ಪರಮಪುರುಷ	பரமபுருஷ
ಪರಮಹಂಸ	பரமஹஂஸ
ಪರಮಾ	பரமா
ಪರಮೇಶ್ವರೀ	பரமேஶ்வரீ
ಪರಮ್ವಾರ್ದಾನ	பரம்வார்தாந
ಪರವೀನ	பரவீந
ಪರಾಯಂತ್ರ	பராயஂத்ர
ಪರಾಶ	பராஶ
ಪರಿಕ್ಷಿತ	பரிக்ஷித
ಪರಿಣೀತಾ	பரிணீதா
ಪರಿತಾ	பரிதா
ಪರಿತುಷ್ಟಿ	பரிதுஷ்டி
ಪರಿಷ್ಕಾರ	பரிஷ்கார
ಪರಿಹಾ	பரிஹா
ಪರೀಮೀತ	பரீமீத
ಪರು	பரு
ಪರ್ಣವ	பர்ணவ
ಪರ್ಣಿಕಾ	பர்ணிகா
ಪರ್ನಾಭಾ	பர்நாபா
ಪರ್ವತ	பர்வத
ಪರ್ವತೀಪ್ರಿತ	பர்வதீப்ரித
ಪರ್ವತೇಶ್ವರ	பர்வதேஶ்வர
ಪರ್ವನ	பர்வந
ಪಲಾನೀಚಾಮ್ಯ	பலாநீசாம்ய
ಪಲಾಶೀನೀ	பலாஶீநீ
ಪವನ	பவந
ಪವೀಥಾ	பவீதா
ಪಾಂಖಡೀ	பாஂகடீ
ಪಾಂಚಾಲೀ	பாஂசாலீ
ಪಾಂಡುರಂಗ	பாஂடுரஂக
ಪಾಓಲಾ	பாஓலா
ಪಾರಸ	பாரஸ
ಪಾರಾ	பாரா
ಪಾರ್ತೀಬನ	பார்தீபந
ಪಾರ್ಥಾಪ್ರತಿಮ	பார்தாப்ரதிம
ಪಾರ್ಥಿಕ	பார்திக
ಪಾರ್ವತೀ	பார்வதீ
ಪಾರ್ವಾಥೀ	பார்வாதீ
ಪಾಲ	பால
ಪಾಲನೀವೇಲ	பாலநீவேல
ಪಾಲೀನ	பாலீந
ಪಾವಾನಾ	பாவாநா
ಪಾವಾನೀ	பாவாநீ
ಪಾಸೀ	பாஸீ
ಪಿಂಗಲ	பிஂகல
ಪಿಂಗಲಾ	பிஂகலா
ಪಿತಾವಾಸನೇ	பிதாவாஸநே
ಪಿವಾಲ	பிவால
ಪೀಉಶಾ	பீஉஶா
ಪೀತೋಬಾಶ	பீதோபாஶ
ಪೀನ್ಕೇಶ	பீந்கேஶ
ಪೀರನೀಥಾ	பீரநீதா
ಪುರ್ನೀಮಾಂ	புர்நீமாஂ
ಪೂಜನ	பூஜந
ಪೂಜಾ	பூஜா
ಪೂನಿಶ	பூநிஶ
ಪೂರಬ	பூரப
ಪೂರ್ವಗಂಗಾ	பூர்வகஂகா
ಪೂರ್ವಜ	பூர்வஜ
ಪೂರ್ವಾ	பூர்வா
ಪೇಮಲ	பேமல
ಪೌಶಾಲೀ	பௌஶாலீ
ಪ್ರಗನ್ಯಾ	ப்ரகந்யா
ಪ್ರಗಿತ	ப்ரகித
ಪ್ರಚೀತೀ	ப்ரசீதீ
ಪ್ರಜೀಶಾ	ப்ரஜீஶா
ಪ್ರದಿಪಾ	ப்ரதிபா
ಪ್ರದೀಪ್ತಾ	ப்ரதீப்தா
ಪ್ರನಾವಾಶ್ರೀ	ப்ரநாவாஶ்ரீ
ಪ್ರನಿತಾ	ப்ரநிதா
ಪ್ರನೀಕಾ	ப்ரநீகா
ಪ್ರಭಂಜನ	ப்ரபஂஜந
ಪ್ರಭಾಕರ	ப்ரபாகர
ಪ್ರಭಾದಾ	ப்ரபாதா
ಪ್ರಮಿಕಾ	ப்ரமிகா
ಪ್ರಹಾರ್ಶೀನೀ	ப்ரஹார்ஶீநீ
ಪ್ರಹಾಸಾ	ப்ரஹாஸா
ಪ್ರಾನಲ	ப்ராநல
ಫಣೀಶ	பணீஶ
ಫ಼ಾಲ್ಗುನ	பால்குந
ಫುಲ್ಲಾರಾ	புல்லாரா
ಬಂದನಾ	பஂதநா
ಬಂಧೀನೀ	பஂதீநீ
ಬಂಸೀಲಾಲ	பஂஸீலால
ಬಖ್ತಾವರ	பக்தாவர
ಬಗ್ಯಾರಾಜ	பக்யாராஜ
ಬನಬಿಹಾರೀ	பநபிஹாரீ
ಬರ್ಷಾ	பர்ஷா
ಬಲರಾಮ	பலராம
ಬಲವಾನ	பலவாந
ಬಲಾದೀತ್ಯ	பலாதீத்ய
ಬವೀಶ್ಯಸರೀ	பவீஶ்யஸரீ
ಬಹವಾಸ್ಯ	பஹவாஸ்ய
ಬಹುಲಾ	பஹுலா
ಬಹುಲೇಯನ	பஹுலேயந
ಬಾಂಕೇ ಬಿಹಾರೀ	பாஂகே பிஹாரீ
ಬಾಜೀನಾಥ	பாஜீநாத
ಬಾನೀ	பாநீ
ಬಾಪು	பாபு
ಬಾಲಗೋಪಾಲ	பாலகோபால
ಬಾಲಚಂದ್ರಾ	பாலசஂத்ரா
ಬಾಲನಾಥ	பாலநாத
ಬಾಲಾಜೀ	பாலாஜீ
ಬಾಲಾರವೀ	பாலாரவீ
ಬಿಂದುಮಾಲಿನೀ	பிஂதுமாலிநீ
ಬಿಂದೂಸರ	பிஂதூஸர
ಬಿಜೋಯ	பிஜோய
ಬಿನೋದ	பிநோத
ಬಿಪಾಶಾ	பிபாஶா
ಬಿಮ್ಬಾ	பிம்பா
ಬಿರಂಚೀ	பிரஂசீ
ಬಿಲ್ವಾ	பில்வா
ಬೀದಯುಂತ	பீதயுஂத
ಬೀನೋದೀನೀ	பீநோதீநீ
ಬೀನ್ಕಾಲ	பீந்கால
ಬೀಭು	பீபு
ಬೀರಾತ	பீராத
ಬುದ್ಧ	புத்த
ಬುದ್ಧಿ	புத்தி
ಬೇನುಂ	பேநுஂ
ಬೇನ್ನೀ	பேந்நீ
ಬೇನ್ಶಿಕ	பேந்ஶிக
ಬೇಲುರಮೀ	பேலுரமீ
ಬೈರ	பைர
ಬೈಸಾಖೀ	பைஸாகீ
ಬೋನಾಸರೀ	போநாஸரீ
ಬ್ರಹ್ಮಾವತೀ	ப்ரஹ்மாவதீ
ಬ್ರೀಜಲ	ப்ரீஜல
ಬ್ರೀನ್ದಾವಾನೀ	ப்ரீந்தாவாநீ
ಬ್ಲೇಸ್ಸೀ	ப்லேஸ்ஸீ
ಭಕ್ತಿ	பக்தி
ಭಗವತೀ	பகவதீ
ಭದ್ರಕ	பத்ரக
ಭದ್ರಕ್ಷ	பத்ரக்ஷ
ಭದ್ರಾ	பத்ரா
ಭದ್ರೀಶಾ	பத்ரீஶா
ಭವಾನಿದಾಸ	பவாநிதாஸ
ಭವಿಷ್ಯಾ	பவிஷ்யா
ಭವೀಶ	பவீஶ
ಭವ್ಯ	பவ்ய
ಭಾಗವಾಥ	பாகவாத
ಭಾಗಿರತ	பாகிரத
ಭಾಗ್ಯವತೀ	பாக்யவதீ
ಭಾಗ್ಯಶ್ರೀ	பாக்யஶ்ரீ
ಭಾಗ್ಯಾ	பாக்யா
ಭಾತ್ರಶ್ರೀ	பாத்ரஶ்ரீ
ಭಾದ್ರಿಕಾ	பாத்ரிகா
ಭಾನುಜ	பாநுஜ
ಭಾನುದಾಸ	பாநுதாஸ
ಭಾನುಪ್ರಿಯಾ	பாநுப்ரியா
ಭಾರನೀಧಾರ	பாரநீதார
ಭಾರೂಕ	பாரூக
ಭಾರ್ತಿಹಾರೀ	பார்திஹாரீ
ಭಾವತೀ	பாவதீ
ಭಾವಾಥಾರೀನೀ	பாவாதாரீநீ
ಭಾವಾಪ್ರಿಯಾ	பாவாப்ரியா
ಭಾವಿಕ	பாவிக
ಭಾವಿತಾ	பாவிதா
ಭಾವೀಶಾ	பாவீஶா
ಭಾವ್ಯಶ್ರೀ	பாவ்யஶ்ரீ
ಭಾಶ್ವೀನೀ	பாஶ்வீநீ
ಭಾಸ್ಕರಣ	பாஸ்கரண
ಭಾಸ್ಕೇರ	பாஸ்கேர
ಭಿಮಾಂಬಾಲಾ	பிமாஂபாலா
ಭೀಮ	பீம
ಭೀಷಮ	பீஷம
ಭೀಷ್ಮ	பீஷ்ம
ಭುವಿಕ	புவிக
ಭೂತೇಶ್ವರ	பூதேஶ்வர
ಭೂಪಾಲ	பூபால
ಭೂಪಾಲೀ	பூபாலீ
ಭೂಪೇನ	பூபேந
ಭೂಮತ	பூமத
ಭೂಮಿಕಾ	பூமிகா
ಭೇರವೀ	பேரவீ
ಭೇರೇಶ	பேரேஶ
ಭೋಲಾನಾಥ	போலாநாத
ಭ್ರೀಜ	ப்ரீஜ
ಮಂಜುಶ್ರೀ	மஂஜுஶ்ரீ
ಮಂತವ್ಯ	மஂதவ்ய
ಮಂದಾರ	மஂதார
ಮಂದಿನ	மஂதிந
ಮಂದೀಪಾ	மஂதீபா
ಮಂಶಾ	மஂஶா
ಮಕರ	மகர
ಮಣಿಕಾಂತ	மணிகாஂத
ಮಣಿಮಾಲಾ	மணிமாலா
ಮಣಿಶಂಕರ	மணிஶஂகர
ಮದುರಾ	மதுரா
ಮಧುಜಾ	மதுஜா
ಮಧುರಾನೀ	மதுராநீ
ಮಧುಲಿಕಾ	மதுலிகா
ಮಧುಶಾ	மதுஶா
ಮನನಶ	மநநஶ
ಮನಸ್ವೀ	மநஸ்வீ
ಮನಹರ	மநஹர
ಮನಾಗೋಬೀನದಾ	மநாகோபீநதா
ಮನಾಲೀ	மநாலீ
ಮನಿಕುನ್ತಾಲಾ	மநிகுந்தாலா
ಮನಿರಾಮ	மநிராம
ಮನಿಶಿಕಾ	மநிஶிகா
ಮನೀದೀಪ	மநீதீப
ಮನೀಬಲನ	மநீபலந
ಮನೀಷಾ	மநீஷா
ಮನೋಜವಾಯಾ	மநோஜவாயா
ಮನೋರಥ	மநோரத
ಮನೋಹರಣ	மநோஹரண
ಮನ್ನನ	மந்நந
ಮನ್ವೀರ	மந்வீர
ಮರಲಾ	மரலா
ಮಲಯಾ	மலயா
ಮಲಿಕಾ	மலிகா
ಮಲೀಂಗಾ	மலீஂகா
ಮಲ್ಕಾ	மல்கா
ಮಹಂತ	மஹஂத
ಮಹಾಕಾಲ	மஹாகால
ಮಹಾಗಂಗಾ	மஹாகஂகா
ಮಹಾತ್ಮಾ	மஹாத்மா
ಮಹಾತ್ರೂ	மஹாத்ரூ
ಮಹಾನ್ಯ	மஹாந்ய
ಮಹಾಬಲಾ	மஹாபலா
ಮಹಾಬಾಲಾ	மஹாபாலா
ಮಹಾಬುದ್ಧಿ	மஹாபுத்தி
ಮಹಾಲಕ್ಷ್ಮೀ	மஹாலக்ஷ்மீ
ಮಹಿರಂಶ	மஹிரஂஶ
ಮಹೀಧೇರ	மஹீதேர
ಮಹುಬಾಲಾ	மஹுபாலா
ಮಾಂಧುಘನೇ	மாஂதுகநே
ಮಾಂಧುವೇಮಾನ	மாஂதுவேமாந
ಮಾಂನಾಶ್ಯುಂ	மாஂநாஶ்யுஂ
ಮಾಂನುರಾಈ	மாஂநுராஈ
ಮಾಂನೋತ	மாஂநோத
ಮಾಂಮೋನ	மாஂமோந
ಮಾಇಲ	மாஇல
ಮಾಗತ	மாகத
ಮಾಗಧೀ	மாகதீ
ಮಾತನ	மாதந
ಮಾಧವನ	மாதவந
ಮಾಧುಜ	மாதுஜ
ಮಾಧುರೀ	மாதுரீ
ಮಾಧುರ್ಯ	மாதுர்ய
ಮಾನಸ್ವೀತಾ	மாநஸ்வீதா
ಮಾನ್ಮಾತನ	மாந்மாதந
ಮಾನ್ವಿತ	மாந்வித
ಮಾಯರಾ	மாயரா
ಮಾರೀರಾಜ	மாரீராஜ
ಮಾರುತ	மாருத
ಮಾರೂತ	மாரூத
ಮಾರ್ಗಶೀ	மார்கஶீ
ಮಾಲವ	மாலவ
ಮಾಲಾರ್ಕೋಡೀ	மாலார்கோடீ
ಮಾಲ್ಲೇಶಾ	மால்லேஶா
ಮಾಹಿತ	மாஹித
ಮೇಧೀನೀ	மேதீநீ
ಯಂಶ	யஂஶ
ಯಜನ	யஜந
ಯಜುಸ	யஜுஸ
ಯದುನಂದನ	யதுநஂதந
ಯಶಸ್ವಿನೀ	யஶஸ்விநீ
ಯಶಾಲ	யஶால
ಯಶುಸ	யஶுஸ
ಯಶೋದಾಗರ್ಬಾ ಸಮ್ಭೂತಾ	யஶோதாகர்பா ஸம்பூதா
ಯಶ್ಯಾಸ್ಸರೀ	யஶ்யாஸ்ஸரீ
ಯಶ್ವಾರ್ಧಾನಾ	யஶ்வார்தாநா
ಯಾಗ್ನೀಥಾ	யாக்நீதா
ಯಾದ್ನ್ಯೇಶ	யாத்ந்யேஶ
ಯಾಮಾಜೀತ	யாமாஜீத
ಯಾಲೀನೀ	யாலீநீ
ಯಾಲೀಸಾಈ	யாலீஸாஈ
ಯಾಶೀನೀ	யாஶீநீ
ಯಾಶ್ವನ	யாஶ்வந
ಯುಕ್ತಾತಮಾಂ	யுக்தாதமாஂ
ಯುಗಲ	யுகல
ಯುಗಾಂಕ	யுகாஂக
ಯುಗಾನ್ಧರ	யுகாந்தர
ಯುಗ್ಮ	யுக்ம
ಯುಥಿಕಾ	யுதிகா
ಯುಧಾವ	யுதாவ
ಯುಧ್ಧ	யுத்த
ಯುವಾಕ್ಷೀ	யுவாக்ஷீ
ಯುವಾನೀ	யுவாநீ
ಯುವೀ	யுவீ
ಯುವೀನ	யுவீந
ಯುಸು	யுஸு
ಯೇಶಾಸ್ವೀ	யேஶாஸ்வீ
ಯೇಶ್ವೀ	யேஶ்வீ
ಯೇಸ್ವಂಠ	யேஸ்வஂட
ಯೋಗದಾ	யோகதா
ಯೋಗಲಕ್ಷ್ಮೀ	யோகலக்ஷ்மீ
ಯೋಗಾ	யோகா
ಯೋಗೀ ಶ್ರೀ	யோகீ ஶ்ரீ
ಯೋಗೀಸಾಇ	யோகீஸாஇ
ಯೋಗ್ದೀಪ	யோக்தீப
ಯೋಗ್ರಾಮ	யோக்ராம
ಯೋನಿತಾ	யோநிதா
ಯೋಹನ	யோஹந
ರಂಗೀತ	ரஂகீத
ರಂಗೇಶ	ரஂகேஶ
ರಂತೀಕಾ	ரஂதீகா
ರಕ್ತ	ரக்த
ರಕ್ಷಾತೀ	ரக்ஷாதீ
ರಕ್ಷಾನಾ	ரக்ஷாநா
ರಕ್ಷ್ಯ	ரக்ஷ்ய
ರಘುನನ್ದನ	ரகுநந்தந
ರಘುಪತಿ	ரகுபதி
ರಘುಪ್ರಿಯಾ	ரகுப்ரியா
ರಚನಾ	ரசநா
ರಣಜೀ	ரணஜீ
ರಣವಿಜಯ	ரணவிஜய
ರತಿಕಾ	ரதிகா
ರತ್ನಕುಂಡಲ	ரத்நகுஂடல
ರತ್ನಾಲೀ	ரத்நாலீ
ರತ್ನೇಶ	ரத்நேஶ
ರಥನಾ	ரதநா
ರನಾಮೀತಾ	ரநாமீதா
ರನ್ಯ	ரந்ய
ರಮಾ  ದೇವೀ	ரமா  தேவீ
ರಮಾಕಾಂತ	ரமாகாஂத
ರಮಿಲಾ	ரமிலா
ರಮೋಲಾ	ரமோலா
ರವಿಕೀರ್ತೀ	ரவிகீர்தீ
ರವಿಚಂದ್ರ	ரவிசஂத்ர
ರವಿಜ	ரவிஜ
ರವಿತಾ	ரவிதா
ರವಿನಾ	ரவிநா
ರವಿಶಂಕರ	ரவிஶஂகர
ರವೀಂದ್ರ	ரவீஂத்ர
ರಶೀಕಾ	ரஶீகா
ರಶ್ಮೀ	ரஶ்மீ
ರಶ್ಮೀಸ್ರಯಾ	ரஶ்மீஸ்ரயா
ರಸರಾಜ	ரஸராஜ
ರಸಿಕಾ	ரஸிகா
ರಾಗಾ	ராகா
ರಾಗಾವೀ	ராகாவீ
ರಾಗಾವೀನೋದೀನೀ	ராகாவீநோதீநீ
ರಾಜಕುಮಾರೀ	ராஜகுமாரீ
ರಾಜನ	ராஜந
ರಾಜಬೀರ	ராஜபீர
ರಾಜವೀ	ராஜவீ
ರಾಜಸೇಕರಣ	ராஜஸேகரண
ರಾಜಾಹಮ್ಸನ	ராஜாஹம்ஸந
ರಾಜೀ	ராஜீ
ರಾಜ್ಕಲಾ	ராஜ்கலா
ರಾಜ್ಬಲಾ	ராஜ்பலா
ರಾತ್ನಾನೀಧೀ	ராத்நாநீதீ
ರಾಧೇಯಾ	ராதேயா
ರಾನಾ	ராநா
ರಾಮಚರಣ	ராமசரண
ರಾಮರಾಜ	ராமராஜ
ರಾಮಸುಂದರ	ராமஸுஂதர
ರಾಮಾದೀಪ	ராமாதீப
ರಾಯಂಶ	ராயஂஶ
ರಾಷೀಪ	ராஷீப
ರಾಸ್ಯಾ	ராஸ்யா
ರಿಶಿಮಾ	ரிஶிமா
ರಿಹಾನ	ரிஹாந
ರೀಅನಾ	ரீஅநா
ರೀತಮಾಂ	ரீதமாஂ
ರೀತ್ಶೀಕಾ	ரீத்ஶீகா
ರೀಥೀಶಾ	ரீதீஶா
ರೀಥ್ವೀ	ரீத்வீ
ರೀದ್ಧೀಮಾಂ	ரீத்தீமாஂ
ರೀನ್ಸೀನ	ரீந்ஸீந
ರೀಮೀ	ரீமீ
ರೀಶಾನೀ	ரீஶாநீ
ರೀಶೋನಾ	ரீஶோநா
ರೀಸ್ಲುಂನಾ	ரீஸ்லுஂநா
ರೂಂಗ / ರಂಗ	ரூஂக / ரஂக
ರೇಡ್ಡೀ	ரேட்டீ
ರೇಥುಶಾನಾ	ரேதுஶாநா
ರೇನುಕ	ரேநுக
ರೇಭಾ	ரேபா
ರೇಮಾಂನೀಕಾ	ரேமாஂநீகா
ರೇಮ್ಯಾ	ரேம்யா
ರೇವಂತ	ரேவஂத
ರೇಶಿಕಾ	ரேஶிகா
ರೇಹಾ	ரேஹா
ರೇಹ್ನುಘಾ	ரேஹ்நுகா
ಲಕೀ	லகீ
ಲಕ್ಷಾಕೀ	லக்ஷாகீ
ಲಕ್ಷಿತಾ	லக்ஷிதா
ಲಕ್ಷ್ಮಣಅಪರಣದಾತಾ	லக்ஷ்மணஅபரணதாதா
ಲಕ್ಷ್ಮೀ	லக்ஷ்மீ
ಲಕ್ಷ್ಮೀ   ನಾರಾಯಣ	லக்ஷ்மீ   நாராயண
ಲಕ್ಷ್ಮೀನ	லக்ஷ்மீந
ಲಖಿತ	லகித
ಲಜ್ಜಕ	லஜ்ஜக
ಲಜ್ಜಾ	லஜ்ஜா
ಲತಾಕಾರಾ	லதாகாரா
ಲಯನಾ	லயநா
ಲಲಿತಾದಿತ್ಯ	லலிதாதித்ய
ಲವಂಗೀ	லவஂகீ
ಲವನಾ	லவநா
ಲವಲೀನ	லவலீந
ಲವಾಮ	லவாம
ಲಾಥಾನಗೀ	லாதாநகீ
ಲಾಬನ್ಯ	லாபந்ய
ಲಾಬುಕೀ	லாபுகீ
ಲಾಭಾ	லாபா
ಲಾರ್ಮಿಕಾ	லார்மிகா
ಲಾಲಸಾ	லாலஸா
ಲಾಲಾತೇಂದು	லாலாதேஂது
ಲಾವನ್ತೀಕಾ	லாவந்தீகா
ಲಾವಾಲಿಕಾ	லாவாலிகா
ಲಾಸ್ಯಾವೀ	லாஸ்யாவீ
ಲಿಖಿತ	லிகித
ಲಿಮಿಯಾ	லிமியா
ಲೀಗ	லீக
ಲೀತೀಶಾ	லீதீஶா
ಲೀನಾಥಾ	லீநாதா
ಲೀನೀತ	லீநீத
ಲೀನ್ಗದೇವಾರುಂ	லீந்கதேவாருஂ
ಲೀನ್ಗರಾಜಾ	லீந்கராஜா
ಲೀನ್ಗೀಃ	லீந்கீஃ
ಲೀಪಿಕಾ	லீபிகா
ಲೀಲಾಮಈ	லீலாமஈ
ಲೀಲಾವತೀ	லீலாவதீ
ಲೀಶಾ	லீஶா
ಲುಕೇಶ	லுகேஶ
ಲುಪೇಶ	லுபேஶ
ಲೇಈಶಾ	லேஈஶா
ಲೇಕ್ಯಾ	லேக்யா
ಲೇಕ್ಷಾನಾ	லேக்ஷாநா
ಲೇಖಕ	லேகக
ಲೇಖೀಶಾ	லேகீஶா
ಲೋಕಪ್ರಕಾಶ	லோகப்ரகாஶ
ಲೋಕಾಕೃತಿ	லோகாக்ரிதி
ಲೋಕಾಜನಾನೀ	லோகாஜநாநீ
ಲೋಕಾಧ್ಯಕ್ಷ	லோகாத்யக்ஷ
ಲೋಕ್ಭುಶನ	லோக்புஶந
ಲೋಕ್ಷೀ	லோக்ஷீ
ಲೋಗಚಾನ್ದ್ರಣ	லோகசாந்த்ரண
ಲೋಗನ	லோகந
ಲೋಗನಾಥನ	லோகநாதந
ಲೋಗೀನೀ	லோகீநீ
ಲೋಗೇಶ	லோகேஶ
ಲೋನಾ	லோநா
ಲೋಮಶ	லோமஶ
ಲೋಮಾಂಕೇಶ	லோமாஂகேஶ
ಲೋಲೀಥ್ಯಾ	லோலீத்யா
ಲೋವೇಯಂಶ	லோவேயஂஶ
ಲೋಶೀನೀ	லோஶீநீ
ಲೋಹೀತಾ	லோஹீதா
ಲೋಹೀತ್ಸರಣ	லோஹீத்ஸரண
ವಂಶಿಕಾ	வஂஶிகா
ವಕ್ರತುನ್ಡಾ	வக்ரதுந்டா
ವಕ್ಷ	வக்ஷ
ವಚನ	வசந
ವತ್ಸಲಾ	வத்ஸலா
ವರಲಕ್ಷ್ಮೀ	வரலக்ஷ்மீ
ವರ್ದಾನೀ	வர்தாநீ
ವರ್ಧಾನೀ	வர்தாநீ
ವರ್ನೀಥಾ	வர்நீதா
ವರ್ಷಾನ	வர்ஷாந
ವಲ್ಲಭೀ	வல்லபீ
ವಶೀತಾ	வஶீதா
ವಸತೀನ	வஸதீந
ವಸಾ	வஸா
ವಸೀಸತಾ	வஸீஸதா
ವಸುಧಾ	வஸுதா
ವಸುಮಿತ್ರ	வஸுமித்ர
ವಸುರೂಪ	வஸுரூப
ವಸುಶ	வஸுஶ
ವಸ್ಥಾವೀ	வஸ்தாவீ
ವಹೀಂ	வஹீஂ
ವಾಕ್ಶಾನಾ	வாக்ஶாநா
ವಾಗ್ಮೀನ	வாக்மீந
ವಾಜ್ರಕ್ಷ	வாஜ்ரக்ஷ
ವಾಜ್ರನಾಖಾ	வாஜ்ரநாகா
ವಾತ್ಸಲ್ರಾಜ	வாத்ஸல்ராஜ
ವಾದಿವೇಲನ	வாதிவேலந
ವಾದಿವೇಲುಂ	வாதிவேலுஂ
ವಾದೀರಾಜ	வாதீராஜ
ವಾನಿಶ್ರೀ	வாநிஶ்ரீ
ವಾನುಜಾ	வாநுஜா
ವಾಮನ	வாமந
ವಾಮಾಂಕ್ಷೀ	வாமாஂக்ஷீ
ವಾಮಿಲ	வாமில
ವಾಮ್ಶೀಥಾ	வாம்ஶீதா
ವಾಯಾ	வாயா
ವಾಯು	வாயு
ವಾಸನ	வாஸந
ವಾಸು	வாஸு
ವಾಸುಮಾಂಥಾ	வாஸுமாஂதா
ವಿಅರ	விஅர
ವಿಕ್ಟೋರಿಯಾ	விக்டோரியா
ವಿಕ್ರಾಂತಿ	விக்ராஂதி
ವಿಜಯಾಲಕ್ಷ್ಮೀ	விஜயாலக்ஷ்மீ
ವಿಜೀತಾ	விஜீதா
ವಿಜುಲ	விஜுல
ವಿದಿಶಾ	விதிஶா
ವಿದ್ವಾಥ	வித்வாத
ವಿನತಿ	விநதி
ವಿನಸ	விநஸ
ವಿನಾ	விநா
ವಿನಾಥೀ	விநாதீ
ವಿನಾಯಿಕಾ	விநாயிகா
ವಿನ್ದ್ಯಾ	விந்த்யா
ವಿಭಾಸ	விபாஸ
ವಿಭೀ	விபீ
ವಿಭೂಷ	விபூஷ
ವಿಮಲಾ	விமலா
ವಿರಬಾಬು	விரபாபு
ವಿಲಾಸಿನೀ	விலாஸிநீ
ವಿಹಾನೀ	விஹாநீ
ವಿಹಾರಿಕಾ	விஹாரிகா
ವೀಅಲಾಶೀನೀ	வீஅலாஶீநீ
ವೇಂಕಟ ಮಾನೀ	வேஂகட மாநீ
ವೇತ್ರೀ	வேத்ரீ
ವೇದನ್ಜಾನಾ	வேதந்ஜாநா
ವೇದಾಂಗ	வேதாஂக
ವೇದಾತ್ಮನೇ	வேதாத்மநே
ವೇದಾಸ್ವರೂಪೀ	வேதாஸ்வரூபீ
ವೇದೀಥಾ	வேதீதா
ವೇದ್ವಿಯನ	வேத்வியந
ವೇಧಾವಲ್ಲೀ	வேதாவல்லீ
ವೇನಮಾಂಥೀ	வேநமாஂதீ
ವೇನಾ	வேநா
ವೇನೀ	வேநீ
ವೇನ್ಕಟಾಗೀರೀ	வேந்கடாகீரீ
ವೇನ್ಕಟೇಶಾ	வேந்கடேஶா
ವೇನ್ಕನಾ	வேந்கநா
ವೇಲ್ಕ್ಯ	வேல்க்ய
ವೇವೇಶಾ	வேவேஶா
ವೈಗಾ	வைகா
ವೈಜಯಂತೀ	வைஜயஂதீ
ವೈಜಯೀ	வைஜயீ
ವೈದಿಕ	வைதிக
ವೈದೀಕಾ	வைதீகா
ವೈಧೇ	வைதே
ವೈಧ್ಯಾತ	வைத்யாத
ಶೈಲೇಶ	ஶைலேஶ
ಸಂಗಮ	ஸஂகம
ಸಂಗೀತಾ	ஸஂகீதா
ಸಂಚಾನಾ	ஸஂசாநா
ಸಂಜಾಣಥೀ	ஸஂஜாணதீ
ಸಂಜೀವ	ஸஂஜீவ
ಸಂಜೀವೀ	ஸஂஜீவீ
ಸಂಜುಕ್ಥಾ	ஸஂஜுக்தா
ಸಂಥೀನೀ	ஸஂதீநீ
ಸಂದೀಪ್ತಾ	ஸஂதீப்தா
ಸಂಧರಾ	ஸஂதரா
ಸಂಪದಾ	ஸஂபதா
ಸಂಮತ	ஸஂமத
ಸಕ್ಥೀದಾರ	ஸக்தீதார
ಸಖಾ	ஸகா
ಸಗ್ನೀಕ	ஸக்நீக
ಸಚ್ಚಿತ	ஸச்சித
ಸಚ್ಚಿದಾನಂದ ವಿಗ್ರಹ	ஸச்சிதாநஂத விக்ரஹ
ಸಜೂ	ஸஜூ
ಸದಗತಾ	ஸதகதா
ಸನಾತನ	ஸநாதந
ಸನಾಥ	ஸநாத
ಸಫ಼ಲಾ	ஸபலா
ಸಫ್ಫರ	ஸப்பர
ಸಬರಿಶ	ஸபரிஶ
ಸಬಿತಾ	ஸபிதா
ಸಮಕ್ಷ	ஸமக்ஷ
ಸಮಜ	ஸமஜ
ಸಮನ್ಯು	ஸமந்யு
ಸಮಬರಣ	ஸமபரண
ಸಮಭಾವನ	ஸமபாவந
ಸಮಾಂನ್ವಿತಾ	ஸமாஂந்விதா
ಸಮಾಂಶ್ರಯ	ஸமாஂஶ்ரய
ಸಮಿಕ	ஸமிக
ಸಮೀರ	ஸமீர
ಸಮೀರಾ	ஸமீரா
ಸಮುದಾಯ	ஸமுதாய
ಸಮುದ್ರಾ	ஸமுத்ரா
ಸಮೇಂದು	ஸமேஂது
ಸಮ್ಪ್ರಸಾದ	ஸம்ப்ரஸாத
ಸಮ್ಪ್ರಿತೀ	ஸம்ப்ரிதீ
ಸಮ್ಬತ	ஸம்பத
ಸಮ್ಮಾದ	ஸம்மாத
ಸಮ್ಯಕ	ஸம்யக
ಸಮ್ಶೀನೀ	ஸம்ஶீநீ
ಸಮ್ಸ್ಕಾರಾ	ஸம்ஸ்காரா
ಸಮ್ಹೀಠಾ	ஸம்ஹீடா
ಸರಜಾ	ஸரஜா
ಸರಿಶಾ	ஸரிஶா
ಸರ್ಗಿನೀ	ஸர்கிநீ
ಸಹಶ್ರದ	ஸஹஶ்ரத
ಸಾಈ ಅರ್ಜುನ	ஸாஈ அர்ஜுந
ಸಾಈ ಶ್ರೀ	ஸாஈ ஶ்ரீ
ಸಾಈ ಸತ್ಪುರುಷಾ	ஸாஈ ஸத்புருஷா
ಸಾಈ ಸುರಿಯಾ	ஸாஈ ஸுரியா
ಸಾತ್ವಿಕ	ஸாத்விக
ಸಾತ್ವಿಕಾ	ஸாத்விகா
ಸಾದರೀ	ஸாதரீ
ಸಾದ್ವಿಥಾ	ஸாத்விதா
ಸಾಧ್ಯ	ஸாத்ய
ಸಾನಾವೀ	ஸாநாவீ
ಸಾಬೀತ್ರೀ	ஸாபீத்ரீ
ಸಾಮಂತ	ஸாமஂத
ಸಾಮೋದ	ஸாமோத
ಸಾಮ್ರೀನ	ஸாம்ரீந
ಸಾಯರಾಮ	ஸாயராம
ಸಾರಂಗೀ	ஸாரஂகீ
ಸಾರಸೀ	ஸாரஸீ
ಸಾರಾನ್ಯ	ஸாராந்ய
ಸಾರಾಹ	ஸாராஹ
ಸಾವಿತ್ರ	ஸாவித்ர
ಸೈಕತ	ஸைகத
ಸೈಜಾಸೀ	ஸைஜாஸீ
ಸೈನಿ	ஸைநி
ಸೈನೀತ್ಯ	ஸைநீத்ய
ಸೈನ್ಧಾವ	ஸைந்தாவ
ಹಂಸಾ	ஹஂஸா
ಹಂಸಿನ	ஹஂஸிந
ಹಂಸ್ಧ್ವಾನೀ	ஹஂஸ்த்வாநீ
ಹಜೇಶ	ஹஜேஶ
ಹನೀತಾ	ஹநீதா
ಹನೀಮಾ	ஹநீமா
ಹನೀಶ್ಕಾ	ஹநீஶ்கா
ಹಮಸಾನಂದೀನೀ	ஹமஸாநஂதீநீ
ಹಯಾತೀ	ஹயாதீ
ಹರನೀಶ	ஹரநீஶ
ಹರಿಅಕ್ಸಾ	ஹரிஅக்ஸா
ಹರಿಕಿಶನ	ஹரிகிஶந
ಹರಿತ	ஹரித
ಹರಿದಾ	ஹரிதா
ಹರಿದಾಸ	ஹரிதாஸ
ಹರಿನ್ದ್ರನಾಥ	ஹரிந்த்ரநாத
ಹರಿಪ್ರಸಾದ	ஹரிப்ரஸாத
ಹರಿವಂಶ	ஹரிவஂஶ
ಹರೀಜ	ஹரீஜ
ಹರೀಥ್ರಾ	ஹரீத்ரா
ಹರೀಧಾಮ	ஹரீதாம
ಹರೀಮಾಂರ್ಕಾತಾಮಾಂರ್ಕತಾ	ஹரீமாஂர்காதாமாஂர்கதா
ಹರೀಶ್ರೀ	ஹரீஶ்ரீ
ಹರೀಸಾಈ	ஹரீஸாஈ
ಹರೇಕೃಷ್ಣ	ஹரேக்ரிஷ்ண
ಹರ್ಕೇಶ	ஹர்கேஶ
ಹರ್ಥೀಕಾ	ஹர்தீகா
ಹರ್ಯಾಕ್ಷಾ	ஹர்யாக்ஷா
ಹರ್ಲೇಯ	ஹர்லேய
ಹರ್ಶಾಶ್ರೀ	ஹர்ஶாஶ்ரீ
ಹರ್ಷವರ್ದನ	ஹர்ஷவர்தந
ಹರ್ಷಿತ	ஹர்ஷித
ಹವೀಹ	ஹவீஹ
ಹಶ್ವರ್ಧನ	ஹஶ்வர்தந
ಹಸಂತ	ஹஸஂத
ಹಾಕೇಶ	ஹாகேஶ
ಹಾರ್ಶೀನೀ	ஹார்ஶீநீ
ಹಾಸಂಥೀ	ஹாஸஂதீ
ಹಿಡಿಂಬಾ	ஹிடிஂபா
ಹಿತಾಂಶು	ஹிதாஂஶு
ಹಿತಾಂಸೀ	ஹிதாஂஸீ
ಹಿತೀ	ஹிதீ
ಹಿತೀಕ್ಷಾ	ஹிதீக்ஷா
ಹಿತೇನ್ದ್ರ	ஹிதேந்த்ர
ಹಿತೈಷೀ	ஹிதைஷீ
ಹಿಥೀಕ್ಸಾ	ஹிதீக்ஸா
ಹಿಮವಂತ	ஹிமவஂத
ಹಿಮಾಂಕ	ஹிமாஂக
ಹಿಮಾಂನಿಶ	ஹிமாஂநிஶ
ಹಿಮಾಂನ್ಗೀನೀ	ஹிமாஂந்கீநீ
ಹಿಮಾಂಸೇಖರ	ஹிமாஂஸேகர
ಹಿಮಾದ್ರೀ	ஹிமாத்ரீ
ಹಿಮಾನ್ಸು	ஹிமாந்ஸு
ಹಿಯಾ	ஹியா
ಹಿಲೀ	ஹிலீ
ಹೀಥಾ	ஹீதா
ಹೀಮೀರ	ஹீமீர
ಹುಮೀಶಾ	ஹுமீஶா
ಹುವೇನ್ದ್ರ	ஹுவேந்த்ர
ಹೇತ	ஹேத
ಹೇತವ	ஹேதவ
ಹೇತಾಂಶೀ	ஹேதாஂஶீ
ಹೇತ್ವಿಕ	ஹேத்விக
ಹೇಥಾನ್ಶ್ರೀ	ஹேதாந்ஶ்ரீ
ಹೇನಾ	ஹேநா
ಹೇನೀತ	ஹேநீத
ಹೇನ್ಸೀ	ஹேந்ஸீ
ಹೇಮ ಲಥಾ	ஹேம லதா
ಹೇಮಚಂದರ	ஹேமசஂதர
ಹೇಮಾಕೇಶ	ஹேமாகேஶ
ಹೇಮೀತಾ	ஹேமீதா
ಹೇಮೀತ್ರಾ	ஹேமீத்ரா
ಹೇಮೀನ	ஹேமீந
ಹೇಮೇಂದ್ರ	ஹேமேஂத்ர
ಹೇರಕ	ஹேரக
ಹೇರೀ	ஹேரீ
ಹೇಲಸಾ	ஹேலஸா
ಹೇಲಾ	ஹேலா
ಹೇಲ್ಲ್ಯ	ஹேல்ல்ய
ಹೋಜನ	ஹோஜந
ಹೋಯಲಾ	ஹோயலா
ಹ್ರೀತೀಕಾ	ஹ்ரீதீகா
ಹ್ರೀದೇಶ	ஹ்ரீதேஶ
ಹ್ರೀದ್ಯೇಸಾ	ஹ்ரீத்யேஸா
ಹ್ರೀಶನ	ஹ்ரீஶந
#
#
# Territory names from CLDR
ಅಸೆನ್ಶನ್ ದ್ವೀಪ	அஸெந்ஶந் த்வீப
ಅಂಡೋರಾ	அஂடோரா
ಸಂಯುಕ್ತ ಅರಬ್ ಎಮಿರೇಟಸ್	ஸஂயுக்த அரப் எமிரேடஸ்
ಅಫಘಾನಿಸ್ಥಾನ್	அபகாநிஸ்தாந்
ಆಂಟಿಗುವಾ ಮತ್ತು ಬರ್ಬುಡಾ	ஆஂடிகுவா மத்து பர்புடா
ಆಂಗುಯಿಲ್ಲಾ	ஆஂகுயில்லா
ಅಲ್ಬೇನಿಯಾ	அல்பேநியா
ಅರ್ಮೇನಿಯಾ	அர்மேநியா
ಅಂಗೋಲಾ	அஂகோலா
ಅಂಟಾರ್ಟಿಕಾ	அஂடார்டிகா
ಅರ್ಜೆಂಟಿನಾ	அர்ஜெஂடிநா
ಅಮೇರಿಕನ್ ಸಮೋವಾ	அமேரிகந் ஸமோவா
ಆಸ್ಟ್ರಿಯಾ	ஆஸ்ட்ரியா
ಆಸ್ಟ್ರೇಲಿಯ	ஆஸ்ட்ரேலிய
ಅರುಬಾ	அருபா
ಆಲ್ಯಾಂಡ್ ದ್ವೀಪಗಳು	ஆல்யாஂட் த்வீபகளு
ಅಜರ್ಬೈಜಾನ್	அஜர்பைஜாந்
ಬೋಸ್ನಿಯಾ ಮತ್ತು ಹರ್ಜೆಗೋವಿನಾ	போஸ்நியா மத்து ஹர்ஜெகோவிநா
ಬಾರ್ಬಡೋಸ್	பார்படோஸ்
ಬಾಂಗ್ಲಾದೇಶ್	பாஂக்லாதேஶ்
ಬೆಲ್ಜಿಯಮ್	பெல்ஜியம்
ಬುರ್ಕಿನಾ ಫಾಸೋ	புர்கிநா பாஸோ
ಬಲ್ಗೇರಿಯಾ	பல்கேரியா
ಬಹರೈನ್	பஹரைந்
ಬುರುಂಡಿ	புருஂடி
ಬೆನಿನ್	பெநிந்
ಸೇಂಟ್ ಬಾರ್ಥೆಲೆಮಿ	ஸேஂட் பார்தெலெமி
ಬರ್ಮುಡಾ	பர்முடா
ಬ್ರೂನಿ	ப்ரூநி
ಬೊಲಿವಿಯಾ	பொலிவியா
ಕೆರೀಬಿಯನ್ ನೆದರ್‌ಲ್ಯಾಂಡ್ಸ್	கெரீபியந் நெதர்‌ல்யாஂட்ஸ்
ಬ್ರೆಜಿಲ್	ப்ரெஜில்
ಬಹಾಮಾಸ್	பஹாமாஸ்
ಭೂತಾನ್	பூதாந்
ಬೋವೆಟ್ ದ್ವೀಪ	போவெட் த்வீப
ಬೋಟ್ಸ್‌ವಾನಾ	போட்ஸ்‌வாநா
ಬೆಲಾರಸ್	பெலாரஸ்
ಬೆಲಿಜ್	பெலிஜ்
ಕೆನಡಾ	கெநடா
ಕೊಕೊಸ್ (ಕೀಲಿಂಗ್) ದ್ವೀಪಗಳು	கொகொஸ் (கீலிஂக்) த்வீபகளு
ಕಾಂಗೋ - ಕಿನ್ಶಾಸಾ	காஂகோ - கிந்ஶாஸா
ಕಾಂಗೋ (DRC)	காஂகோ (DRC)
ಮಧ್ಯ ಆಫ್ರಿಕಾ ಗಣರಾಜ್ಯ	மத்ய ஆப்ரிகா கணராஜ்ய
ಕಾಂಗೋ - ಬ್ರಾಜಾವಿಲ್ಲೇ	காஂகோ - ப்ராஜாவில்லே
ಕಾಂಗೋ (ಗಣರಾಜ್ಯ)	காஂகோ (கணராஜ்ய)
ಸ್ವಿಟ್ಜರ್ಲ್ಯಾಂಡ್	ஸ்விட்ஜர்ல்யாஂட்
ಕೋತ್‌ ದಿವಾರ್‍	கோத்‌ திவார்‍
ಐವರಿ ಕೋಸ್ಟ್	ஐவரி கோஸ்ட்
ಕುಕ್ ದ್ವೀಪಗಳು	குக் த்வீபகளு
ಚಿಲಿ	சிலி
ಕ್ಯಾಮರೋನ್	க்யாமரோந்
ಚೀನಾ	சீநா
ಕೊಲಂಬಿಯಾ	கொலஂபியா
ಕ್ಲಿಪ್ಪರ್‌ಟಾನ್ ದ್ವೀಪಗಳು	க்லிப்பர்‌டாந் த்வீபகளு
ಕೊಸ್ಟಾ ರಿಕಾ	கொஸ்டா ரிகா
ಕ್ಯೂಬಾ	க்யூபா
ಕೇಪ್ ವರ್ಡೆ	கேப் வர்டெ
ಕುರಾಕಾವ್	குராகாவ்
ಕ್ರಿಸ್ಮಸ್ ದ್ವೀಪ	க்ரிஸ்மஸ் த்வீப
ಸೈಪ್ರಸ್	ஸைப்ரஸ்
ಚೆಕ್ ರಿಪಬ್ಲಿಕ್	செக் ரிபப்லிக்
ಜರ್ಮನಿ	ஜர்மநி
ಡೈಗೋ ಗಾರ್ಸಿಯ	டைகோ கார்ஸிய
ಜಿಬೋಟಿ	ஜிபோடி
ಡೆನ್ಮಾರ್ಕ್	டெந்மார்க்
ಡೊಮಿನಿಕಾ	டொமிநிகா
ಡೊಮೆನಿಕನ್ ರಿಪಬ್ಲಿಕ್	டொமெநிகந் ரிபப்லிக்
ಅಲ್ಗೇರಿಯಾ	அல்கேரியா
ಸೆಯುಟಾ ಹಾಗೂ ಮೆಲಿಲ್ಲಾ	ஸெயுடா ஹாகூ மெலில்லா
ಈಕ್ವೆಡಾರ್	ஈக்வெடார்
ಎಸ್ಟೋನಿಯಾ	எஸ்டோநியா
ಈಜಿಪ್ಟ್	ஈஜிப்ட்
ಪಶ್ಚಿಮ ಸಹಾರಾ	பஶ்சிம ஸஹாரா
ಏರಿಟ್ರಿಯಾ	ஏரிட்ரியா
ಸ್ಪೇನ್	ஸ்பேந்
ಇಥಿಯೋಪಿಯಾ	இதியோபியா
ಯುರೋಪಿಯನ್ ಯೂನಿಯನ್	யுரோபியந் யூநியந்
ಫಿನ್‌ಲ್ಯಾಂಡ್	பிந்‌ல்யாஂட்
ಫಿಜಿ	பிஜி
ಫಾಲ್ಕ್‌ಲ್ಯಾಂಡ್ ದ್ವೀಪಗಳು	பால்க்‌ல்யாஂட் த்வீபகளு
ಫಾಲ್ಕ್‌ಲ್ಯಾಂಡ್ ದ್ವೀಪಗಳು (ಇಸ್ಲಾಸ್ ಮಾಲ್ವಿನಸ್)	பால்க்‌ல்யாஂட் த்வீபகளு (இஸ்லாஸ் மால்விநஸ்)
ಮೈಕ್ರೋನೇಶಿಯಾ	மைக்ரோநேஶியா
ಫರೋ ದ್ವೀಪಗಳು	பரோ த்வீபகளு
ಫ್ರಾನ್ಸ್	ப்ராந்ஸ்
ಗೆಬೊನ್	கெபொந்
ಬ್ರಿಟನ್/ಇಂಗ್ಲೆಂಡ್	ப்ரிடந்/இஂக்லெஂட்
ಗ್ರೆನೆಡಾ	க்ரெநெடா
ಜಾರ್ಜಿಯಾ	ஜார்ஜியா
ಫ್ರೆಂಚ್ ಗಯಾನಾ	ப்ரெஂச் கயாநா
ಗುರ್ನ್‌ಸೆ	குர்ந்‌ஸெ
ಘಾನಾ	காநா
ಗಿಬ್ರಾಲ್ಟರ್	கிப்ரால்டர்
ಗ್ರೀನ್‌ಲ್ಯಾಂಡ್	க்ரீந்‌ல்யாஂட்
ಗ್ಯಾಂಬಿಯಾ	க்யாஂபியா
ಗಿನಿ	கிநி
ಗುಡೆಲೋಪ್	குடெலோப்
ಈಕ್ವೆಟೋರಿಯಲ್ ಗಿನಿ	ஈக்வெடோரியல் கிநி
ಗ್ರೀಸ್	க்ரீஸ்
ದಕ್ಷಿಣ ಜಾರ್ಜಿಯಾ ಮತ್ತು ದಕ್ಷಿಣ ಸ್ಯಾಂಡ್‍ವಿಚ್ ದ್ವೀಪಗಳು	தக்ஷிண ஜார்ஜியா மத்து தக்ஷிண ஸ்யாஂட்‍விச் த்வீபகளு
ಗ್ವಾಟೆಮಾಲಾ	க்வாடெமாலா
ಗುಯಾಮ್	குயாம்
ಗಿನಿ-ಬಿಸ್ಸಾವ್	கிநி-பிஸ்ஸாவ்
ಗಯಾನಾ	கயாநா
ಹಾಂಗ್ ಕಾಂಗ್ SAR ಚೈನಾ	ஹாஂக் காஂக் SAR சைநா
ಹಾಂಗ್ ಕಾಂಗ್	ஹாஂக் காஂக்
ಹರ್ಡ್ ದ್ವೀಪ ಮತ್ತು ಮ್ಯಾಕ್‍ಡೊನಾಲ್ಡ್ ದ್ವೀಪಗಳು	ஹர்ட் த்வீப மத்து ம்யாக்‍டொநால்ட் த்வீபகளு
ಹೊಂಡುರಾಸ್	ஹொஂடுராஸ்
ಕ್ರೊಯೇಶಿಯಾ	க்ரொயேஶியா
ಹೈಟಿ	ஹைடி
ಹಂಗಾರಿ	ஹஂகாரி
ಕ್ಯಾನರಿ ದ್ವೀಪಗಳು	க்யாநரி த்வீபகளு
ಇಂಡೋನೇಶಿಯಾ	இஂடோநேஶியா
ಐರ್ಲೆಂಡ್	ஐர்லெஂட்
ಇಸ್ರೇಲ್	இஸ்ரேல்
ಐಲ್ ಆಫ್ ಮ್ಯಾನ್	ஐல் ஆப் ம்யாந்
ಭಾರತ	பாரத
ಬ್ರಿಟೀಶ್ ಇಂಡಿಯನ್ ಮಹಾಸಾಗರ ಪ್ರದೇಶ	ப்ரிடீஶ் இஂடியந் மஹாஸாகர ப்ரதேஶ
ಇರಾಕ್	இராக்
ಇರಾನ್	இராந்
ಐಸ್‌ಲ್ಯಾಂಡ್	ஐஸ்‌ல்யாஂட்
ಇಟಲಿ	இடலி
ಜೆರ್ಸಿ	ஜெர்ஸி
ಜಮೈಕಾ	ஜமைகா
ಜೋರ್ಡಾನ್	ஜோர்டாந்
ಜಪಾನ್	ஜபாந்
ಕೀನ್ಯಾ	கீந்யா
ಕಿರ್ಗಿಸ್ಥಾನ್	கிர்கிஸ்தாந்
ಕಾಂಬೋಡಿಯಾ	காஂபோடியா
ಕಿರಿಬಾತಿ	கிரிபாதி
ಕೊಮೊರೊಸ್	கொமொரொஸ்
ಸೇಂಟ್ ಕಿಟ್ಸ್ ಮತ್ತು ನೆವಿಸ್	ஸேஂட் கிட்ஸ் மத்து நெவிஸ்
ಉತ್ತರ ಕೋರಿಯಾ	உத்தர கோரியா
ದಕ್ಷಿಣ ಕೋರಿಯಾ	தக்ஷிண கோரியா
ಕುವೈತ್	குவைத்
ಕೇಮನ್ ದ್ವೀಪಗಳು	கேமந் த்வீபகளு
ಕಝಾಕಿಸ್ಥಾನ್	கசாகிஸ்தாந்
ಲಾವೋಸ್	லாவோஸ்
ಲೆಬನಾನ್	லெபநாந்
ಸೇಂಟ್ ಲೂಸಿಯಾ	ஸேஂட் லூஸியா
ಲಿಚೆನ್‌ಸ್ಟೈನ್	லிசெந்‌ஸ்டைந்
ಶ್ರೀಲಂಕಾ	ஶ்ரீலஂகா
ಲಿಬೇರಿಯಾ	லிபேரியா
ಲೆಸೊಥೋ	லெஸொதோ
ಲಿಥುವೇನಿಯಾ	லிதுவேநியா
ಲಕ್ಸಂಬರ್ಗ್	லக்ஸஂபர்க்
ಲಾಟ್ವಿಯಾ	லாட்வியா
ಲಿಬಿಯಾ	லிபியா
ಮೊರಾಕ್ಕೊ	மொராக்கொ
ಮೊನಾಕೊ	மொநாகொ
ಮೊಲ್ಡೋವಾ	மொல்டோவா
ಮೊಂಟೆನೆಗ್ರೋ	மொஂடெநெக்ரோ
ಸೇಂಟ್ ಮಾರ್ಟಿನ್	ஸேஂட் மார்டிந்
ಮಡಗಾಸ್ಕರ್	மடகாஸ்கர்
ಮಾರ್ಷಲ್ ದ್ವೀಪಗಳು	மார்ஷல் த்வீபகளு
ಮ್ಯಾಸಿಡೋನಿಯಾ	ம்யாஸிடோநியா
ಮ್ಯಾಸಿಡೋನಿಯ (FYROM)	ம்யாஸிடோநிய (FYROM)
ಮಾಲಿ	மாலி
ಮಯನ್ಮಾರ್ (ಬರ್ಮಾ)	மயந்மார் (பர்மா)
ಮೊಂಗೋಲಿಯಾ	மொஂகோலியா
ಮಖಾವ್ (SAR) ಚೈನಾ	மகாவ் (SAR) சைநா
ಮಖಾವ್	மகாவ்
ಉತ್ತರ ಮರಿಯಾನಾ ದ್ವೀಪಗಳು	உத்தர மரியாநா த்வீபகளு
ಮಾರ್ಟಿನಿಕ್	மார்டிநிக்
ಮಾರಿಟೇನಿಯಾ	மாரிடேநியா
ಮಾಂಟ್‌ಸೆರೇಟ್	மாஂட்‌ஸெரேட்
ಮಾಲ್ಟಾ	மால்டா
ಮಾರಿಶಿಯಸ್	மாரிஶியஸ்
ಮಾಲ್ಡಿವ್ಸ್	மால்டிவ்ஸ்
ಮಲಾವಿ	மலாவி
ಮೆಕ್ಸಿಕೊ	மெக்ஸிகொ
ಮಲೇಶಿಯಾ	மலேஶியா
ಮೊಜಾಂಬಿಕ್	மொஜாஂபிக்
ನಮೀಬಿಯಾ	நமீபியா
ನ್ಯೂ ಕ್ಯಾಲಿಡೋನಿಯಾ	ந்யூ க்யாலிடோநியா
ನೈಜರ್	நைஜர்
ನಾರ್ಫೋಕ್ ದ್ವೀಪ	நார்போக் த்வீப
ನೈಜೀರಿಯಾ	நைஜீரியா
ನಿಕಾರಾಗುವಾ	நிகாராகுவா
ನೆದರ್‌ಲ್ಯಾಂಡ್ಸ್	நெதர்‌ல்யாஂட்ஸ்
ನಾರ್ವೇ	நார்வே
ನೇಪಾಳ	நேபாள
ನೌರು	நௌரு
ನಿಯು	நியு
ನ್ಯೂಜಿಲೆಂಡ್	ந்யூஜிலெஂட்
ಓಮನ್	ஓமந்
ಪನಾಮಾ	பநாமா
ಪೆರು	பெரு
ಫ್ರೆಂಚ್ ಪಾಲಿನೇಷ್ಯಾ	ப்ரெஂச் பாலிநேஷ்யா
ಪಪುವಾ ನ್ಯೂಗಿನಿಯಾ	பபுவா ந்யூகிநியா
ಫಿಲಿಫೈನ್ಸ್	பிலிபைந்ஸ்
ಪಾಕಿಸ್ತಾನ	பாகிஸ்தாந
ಪೋಲ್ಯಾಂಡ್	போல்யாஂட்
ಸೇಂಟ್ ಪಿಯರೆ ಮತ್ತು ಮಿಕೆಲನ್	ஸேஂட் பியரெ மத்து மிகெலந்
ಪಿಟ್‌ಕೈರ್ನ್ ದ್ವೀಪಗಳು	பிட்‌கைர்ந் த்வீபகளு
ಪ್ಯೂರ್ಟೋ ರಿಕೊ	ப்யூர்டோ ரிகொ
ಪ್ಯಾಲೇಸ್ಟೇನಿಯನ್ ಪ್ರದೇಶ	ப்யாலேஸ்டேநியந் ப்ரதேஶ
ಪ್ಯಾಲೆಸ್ಟೇನ್	ப்யாலெஸ்டேந்
ಪೋರ್ಚುಗಲ್	போர்சுகல்
ಪಲಾವು	பலாவு
ಪರಾಗ್ವೇ	பராக்வே
ಖತಾರ್	கதார்
ಔಟ್ ಲೈಯಿಂಗ್ ಓಷಿಯಾನಿಯಾ	ஔட் லையிஂக் ஓஷியாநியா
ರೀಯೂನಿಯನ್	ரீயூநியந்
ರೊಮೇನಿಯಾ	ரொமேநியா
ಸೆರ್ಬಿಯಾ	ஸெர்பியா
ರಷ್ಯಾ	ரஷ்யா
ರುವಾಂಡಾ	ருவாஂடா
ಸೌದಿ ಅರೇಬಿಯಾ	ஸௌதி அரேபியா
ಸೊಲೊಮನ್ ದ್ವೀಪಗಳು	ஸொலொமந் த்வீபகளு
ಸೀಶೆಲ್ಲೆಸ್	ஸீஶெல்லெஸ்
ಸೂಡಾನ್	ஸூடாந்
ಸ್ವೀಡನ್	ஸ்வீடந்
ಸಿಂಗಾಪುರ್	ஸிஂகாபுர்
ಸೇಂಟ್ ಹೆಲೆನಾ	ஸேஂட் ஹெலெநா
ಸ್ಲೋವೇನಿಯಾ	ஸ்லோவேநியா
ಸ್ವಾಲ್ಬಾರ್ಡ್ ಮತ್ತು ಜಾನ್ ಮೆಯನ್	ஸ்வால்பார்ட் மத்து ஜாந் மெயந்
ಸ್ಲೋವೇಕಿಯಾ	ஸ்லோவேகியா
ಸಿಯೆರ್ರಾ ಲಿಯೋನ್	ஸியெர்ரா லியோந்
ಸ್ಯಾನ್ ಮೆರಿನೋ	ஸ்யாந் மெரிநோ
ಸೆನೆಗಲ್	ஸெநெகல்
ಸೊಮಾಲಿಯಾ	ஸொமாலியா
ಸುರಿನಾಮ	ஸுரிநாம
ದಕ್ಷಿಣ ಸೂಡಾನ್	தக்ஷிண ஸூடாந்
ಸಾವೋ ಟೋಮ್ ಮತ್ತು ಪ್ರಿನ್ಸಿಪಿ	ஸாவோ டோம் மத்து ப்ரிந்ஸிபி
ಎಲ್ ಸಾಲ್ವೇಡಾರ್	எல் ஸால்வேடார்
ಸಿಂಟ್ ಮಾರ್ಟೆನ್	ஸிஂட் மார்டெந்
ಸಿರಿಯಾ	ஸிரியா
ಸ್ವಾಜಿಲ್ಯಾಂಡ್	ஸ்வாஜில்யாஂட்
ಟ್ರಿಸ್ತನ್ ಡಾ ಕುನ್ಹಾ	ட்ரிஸ்தந் டா குந்ஹா
ಟರ್ಕ್ಸ್ ಮತ್ತು ಕೈಕೋಸ್ ದ್ವೀಪಗಳು	டர்க்ஸ் மத்து கைகோஸ் த்வீபகளு
ಚಾದ್	சாத்
ಫ್ರೆಂಚ್ ದಕ್ಷಿಣ ಪ್ರದೇಶಗಳು	ப்ரெஂச் தக்ஷிண ப்ரதேஶகளு
ಟೋಗೋ	டோகோ
ಥೈಲ್ಯಾಂಡ್	தைல்யாஂட்
ತಜಾಕಿಸ್ಥಾನ್	தஜாகிஸ்தாந்
ಟೊಕೆಲಾವ್	டொகெலாவ்
ಪೂರ್ವ ತಿಮೋರ್	பூர்வ திமோர்
ಈಸ್ಟ್ ಟಿಮೋರ್	ஈஸ்ட் டிமோர்
ತುರ್ಕ್ಮೇನಿಸ್ಥಾನ್	துர்க்மேநிஸ்தாந்
ಟುನಿಶಿಯಾ	டுநிஶியா
ಟೊಂಗ	டொஂக
ಟರ್ಕಿ	டர்கி
ಟ್ರಿನಿಡಾಡ್ ಮತ್ತು ಟೊಬಾಗೊ	ட்ரிநிடாட் மத்து டொபாகொ
ಟುವಾಲು	டுவாலு
ಥೈವಾನ್	தைவாந்
ತಾಂಜೇನಿಯಾ	தாஂஜேநியா
ಉಕ್ರೈನ್	உக்ரைந்
ಉಗಾಂಡಾ	உகாஂடா
ಅಮೇರಿಕಾ ಸಂಯುಕ್ತ ಸಂಸ್ಥಾನ	அமேரிகா ஸஂயுக்த ஸஂஸ்தாந
ಉರುಗ್ವೇ	உருக்வே
ಉಜ್ಬೇಕಿಸ್ಥಾನ್	உஜ்பேகிஸ்தாந்
ವ್ಯಾಟಿಕನ್	வ்யாடிகந்
ವೆನೆಜುವೆಲಾ	வெநெஜுவெலா
ಬ್ರಿಟಿಷ್ ವರ್ಜಿನ್ ದ್ವೀಪಗಳು	ப்ரிடிஷ் வர்ஜிந் த்வீபகளு
ವಿಯೇಟ್ನಾಮ್	வியேட்நாம்
ವನೌಟು	வநௌடு
ವಾಲಿಸ್ ಮತ್ತು ಫುಟುನಾ	வாலிஸ் மத்து புடுநா
ಸಮೋವಾ	ஸமோவா
ಕೊಸೊವೊ	கொஸொவொ
ಯೆಮನ್	யெமந்
ಮಯೊಟ್ಟೆ	மயொட்டெ
ದಕ್ಷಿಣ ಆಫ್ರಿಕಾ	தக்ஷிண ஆப்ரிகா
ಝಾಂಬಿಯಾ	சாஂபியா
ಜಿಂಬಾಬ್ವೆ	ஜிஂபாப்வெ
ಅಜ್ಞಾತ ಪ್ರದೇಶ	அஜ்ஞாத ப்ரதேஶ
