# Baby names
અંશ	ଅଂଶ
અકન્ગ્ષા	ଅକନ୍ଗ୍ଷା
અકશીની	ଅକଶୀନୀ
અકસરા	ଅକସରା
અકાર્યસુતા	ଅକାର୍ଯସୁତା
અકાલકા	ଅକାଲକା
અકિતા	ଅକିତା
અક્ષધા	ଅକ୍ଷଧା
અક્ષ્યા	ଅକ୍ଷ୍ଯା
અક્સા	ଅକ୍ସା
અગ્નિશિખા	ଅଗ୍ନିଶିଖା
અગ્રીમા	ଅଗ୍ରୀମା
અચલેંદ્ર	ଅଚଲେଂଦ୍ର
અજન્તા	ଅଜନ୍ତା
અજમુખી	ଅଜମୁଖୀ
અજિયા	ଅଜିଯା
અજીતા	ଅଜୀତା
અડ્યાદવૈતા	ଅଡ୍ଯାଦଵୈତା
અદવૈકા	ଅଦଵୈକା
અદિતરાજ	ଅଦିତରାଜ
અદિત્યેશ	ଅଦିତ୍ଯେଶ
અદીતીયા	ଅଦୀତୀଯା
અદીરા	ଅଦୀରା
અદેન્ય	ଅଦେନ୍ଯ
અદ્રિતા	ଅଦ୍ରିତା
અદ્રિતી	ଅଦ୍ରିତୀ
અદ્વય	ଅଦ୍ଵଯ
અદ્વિકા	ଅଦ୍ଵିକା
અદ્વેત	ଅଦ୍ଵେତ
અદ્વૈયા	ଅଦ୍ଵୈଯା
અધીર	ଅଧୀର
અધીરતા	ଅଧୀରତା
અધ્યાત્મ	ଅଧ୍ଯାତ୍ମ
અબિનય	ଅବିନଯ
અબિભવા	ଅବିଭଵା
અબીનાવ	ଅବୀନାଵ
અબીશા	ଅବୀଶା
અબીસેશન	ଅବୀସେଶନ
અબ્બીર	ଅବ୍ବୀର
અભિજાત	ଅଭିଜାତ
અભિજ્ઞાન	ଅଭିଜ୍ଞାନ
અભિનું	ଅଭିନୁଂ
અભિપ્રિથિ	ଅଭିପ୍ରିଥି
અભિમોદા	ଅଭିମୋଦା
અભિરુચિ	ଅଭିରୁଚି
અભિવાદન	ଅଭିଵାଦନ
અભિસુમત	ଅଭିସୁମତ
અભિસોકા	ଅଭିସୋକା
અભીકાંક્ષા	ଅଭୀକାଂକ୍ଷା
અભીચંદ્ર	ଅଭୀଚଂଦ୍ର
અભીજુન	ଅଭୀଜୁନ
અભીધર્મ	ଅଭୀଧର୍ମ
અભીલેશ	ଅଭୀଲେଶ
અભુ	ଅଭୁ
અભ્થા	ଅଭ୍ଥା
અભ્રકાસિન	ଅଭ୍ରକାସିନ
અરધ્યાય	ଅରଧ୍ଯାଯ
અલંકારાપ્રિયા	ଅଲଂକାରାପ୍ରିଯା
અલંક્રિતા	ଅଲଂକ୍ରିତା
અહીના	ଅହୀନା
આંદાલ	ଆଂଦାଲ
આંશી	ଆଂଶୀ
આએઇન્દ્રિ	ଆଏଇନ୍ଦ୍ରି
આકર્ષ	ଆକର୍ଷ
આકાંક્ષ	ଆକାଂକ୍ଷ
આકામ્પન	ଆକାମ୍ପନ
આકાશ	ଆକାଶ
આકાશી	ଆକାଶୀ
આકેશ	ଆକେଶ
આત્મજ	ଆତ୍ମଜ
આત્રયી	ଆତ୍ରଯୀ
આદાવન	ଆଦାଵନ
આદિકવિ	ଆଦିକଵି
આદિકેશ	ଆଦିକେଶ
આદિતિય	ଆଦିତିଯ
આદિત્વ	ଆଦିତ୍ଵ
આદિદેવ	ଆଦିଦେଵ
આદિશ	ଆଦିଶ
આદિશંકર	ଆଦିଶଂକର
આદિસેશ	ଆଦିସେଶ
આદીત્રી	ଆଦୀତ୍ରୀ
આદીલ	ଆଦୀଲ
આદ્યા	ଆଦ୍ଯା
આનંદતા	ଆନଂଦତା
આનાધીતા	ଆନାଧୀତା
આનુષ	ଆନୁଷ
આમાંની	ଆମାଂନୀ
આયાતી	ଆଯାତୀ
આયુધ	ଆଯୁଧ
આરવી	ଆରଵୀ
આરા	ଆରା
આરાડ્યા	ଆରାଡ୍ଯା
આરાધક	ଆରାଧକ
આરાધના	ଆରାଧନା
આરુન્ય	ଆରୁନ୍ଯ
આરુપા	ଆରୁପା
આરોચન	ଆରୋଚନ
આર્થ	ଆର୍ଥ
આર્ય્થ્ય	ଆର୍ଯ୍ଥ୍ଯ
આલય	ଆଲଯ
આલિશા	ଆଲିଶା
આલેઃયા	ଆଲେଃଯା
આલ્યા	ଆଲ୍ଯା
આવાની	ଆଵାନୀ
આવ્યા	ଆଵ୍ଯା
આશાલી	ଆଶାଲୀ
આશીર્વાદ	ଆଶୀର୍ଵାଦ
આસ્યા	ଆସ୍ଯା
આસ્વી	ଆସ୍ଵୀ
આહ્નીક	ଆହ୍ନୀକ
ઇંદિરા	ଇଂଦିରା
ઇંદિવર	ଇଂଦିଵର
ઇંદુલેક્ષ	ଇଂଦୁଲେକ୍ଷ
ઇંદુશેખર	ଇଂଦୁଶେଖର
ઇતિ	ଇତି
ઇતિશ્રી	ଇତିଶ୍ରୀ
ઇદિત્રી	ଇଦିତ୍ରୀ
ઇનકી	ଇନକୀ
ઇન્કિત	ଇନ୍କିତ
ઇન્ગનામ	ଇନ୍ଗନାମ
ઇન્દ્રતેજ	ଇନ୍ଦ୍ରତେଜ
ઇન્દ્રન	ଇନ୍ଦ୍ରନ
ઇન્દ્રેશ	ଇନ୍ଦ୍ରେଶ
ઇભાન	ଇଭାନ
ઇભ્યા	ଇଭ୍ଯା
ઇયેનગર	ଇଯେନଗର
ઇલવરસન	ଇଲଵରସନ
ઇલિસા	ଇଲିସା
ઇવાન	ଇଵାନ
ઇશા	ଇଶା
ઇશાયુ	ଇଶାଯୁ
ઇસાર	ଇସାର
ઇસીરી	ଇସୀରୀ
ઈઝ્રીને	ଈଝ୍ରୀନେ
ઈનિઅવેલન	ଈନିଅଵେଲନ
ઈનિયવન	ଈନିଯଵନ
ઈન્દુસ	ଈନ୍ଦୁସ
ઈરીશ	ଈରୀଶ
ઈલ્વિકા	ଈଲ୍ଵିକା
ઈશાંત	ଈଶାଂତ
ઈશિત	ଈଶିତ
ઈશ્મીતા	ଈଶ୍ମୀତା
ઈશ્વ	ଈଶ୍ଵ
ઈસાઈ	ଈସାଈ
ઉજય	ଉଜଯ
ઉજાગર	ଉଜାଗର
ઉજાસ	ଉଜାସ
ઉજીત્ર	ଉଜୀତ୍ର
ઉજેન્દ્ર	ଉଜେନ୍ଦ୍ର
ઉજ્જાનિની	ଉଜ୍ଜାନିନୀ
ઉજ્જ્વાલા	ଉଜ୍ଜ୍ଵାଲା
ઉત્કર્શ્રાજ	ଉତ୍କର୍ଶ୍ରାଜ
ઉત્કલ	ଉତ୍କଲ
ઉત્કલીતા	ଉତ୍କଲୀତା
ઉત્કશાના	ଉତ୍କଶାନା
ઉત્પત્તિ	ଉତ୍ପତ୍ତି
ઉત્પલ	ଉତ୍ପଲ
ઉત્વિક	ଉତ୍ଵିକ
ઉત્સા	ଉତ୍ସା
ઉથીશા	ଉଥୀଶା
ઉદંત	ଉଦଂତ
ઉદયાચલ	ଉଦଯାଚଲ
ઉદરથી	ଉଦରଥୀ
ઉદાર્શ	ଉଦାର୍ଶ
ઉદેય	ଉଦେଯ
ઉદ્વંશ	ଉଦ୍ଵଂଶ
ઉધાયારની	ଉଧାଯାରନୀ
ઉપજય	ଉପଜଯ
ઉપદા	ଉପଦା
ઉપનાયિક	ଉପନାଯିକ
ઉપાગુપ્તા	ଉପାଗୁପ୍ତା
ઉપેન્દ્રન	ଉପେନ୍ଦ୍ରନ
ઉભય	ଉଭଯ
ઉમાંપુત્ર	ଉମାଂପୁତ୍ର
ઉમાપત્ય	ଉମାପତ୍ଯ
ઉમિકા	ଉମିକା
ઉમેશ	ଉମେଶ
ઉરિશિલ્લા	ଉରିଶିଲ୍ଲା
ઉર્નીક	ଉର୍ନୀକ
ઉર્મિલ	ଉର୍ମିଲ
ઉર્મિલા	ଉର୍ମିଲା
ઉર્મી	ଉର୍ମୀ
ઉર્વીશા	ଉର୍ଵୀଶା
ઉલ્લાસીથા	ଉଲ୍ଲାସୀଥା
ઉસહાસ	ଉସହାସ
ઉસ્લુંનન	ଉସ୍ଲୁଂନନ
ઊર્જિત	ଊର୍ଜିତ
એઇલા	ଏଇଲା
એકદંતન	ଏକଦଂତନ
એકન્ષા	ଏକନ୍ଷା
એકાંશ	ଏକାଂଶ
એકાચક્ર	ଏକାଚକ୍ର
એકાવિરા	ଏକାଵିରା
એકીશ	ଏକୀଶ
એકેસ્વારા	ଏକେସ୍ଵାରା
એક્શીકા	ଏକ୍ଶୀକା
એદોમ	ଏଦୋମ
એપ્શીતા	ଏପ୍ଶୀତା
એલાવારાસન	ଏଲାଵାରାସନ
એલેના	ଏଲେନା
એવાની	ଏଵାନୀ
એવોન	ଏଵୋନ
એશંકા	ଏଶଂକା
એશાન્ય	ଏଶାନ୍ଯ
ઐસીરી	ଐସୀରୀ
ઓજ્જસ્વીન	ଓଜ୍ଜସ୍ଵୀନ
ઓદથી	ଓଦଥୀ
ઓનિશ	ଓନିଶ
ઓનીર	ଓନୀର
ઓન્નેશા	ଓନ୍ନେଶା
ઓબલેશ	ଓବଲେଶ
ઓમપતિ	ଓମପତି
ઓમવતી	ଓମଵତୀ
ઓમિષા	ଓମିଷା
ઓવીએ	ଓଵୀଏ
ઓહા	ଓହା
કંકના	କଂକନା
કંજમ	କଂଜମ
કંઠ	କଂଠ
કંવર	କଂଵର
કતીરેશન	କତୀରେଶନ
કથીર	କଥୀର
કદિતુલા	କଦିତୁଲା
કનક	କନକ
કનીસા	କନୀସା
કનુષ	କନୁଷ
કપિલા	କପିଲା
કમલનયન	କମଲନଯନ
કમલાબંધુ	କମଲାବଂଧୁ
કરબી	କରବୀ
કરીના	କରୀନା
કરીશા	କରୀଶା
કરીસમાં	କରୀସମାଂ
કરુન્યા	କରୁନ୍ଯା
કર્ણ	କର୍ଣ
કર્તીગા	କର୍ତୀଗା
કર્નાપ્રિયા	କର୍ନାପ୍ରିଯା
કર્નીકા	କର୍ନୀକା
કર્નીશ	କର୍ନୀଶ
કલમજીરરન્જિનિ	କଲମଜୀରରନ୍ଜିନି
કલાતર	କଲାତର
કલાપક	କଲାପକ
કલાપ્રિયા	କଲାପ୍ରିଯା
કલૈસેલવી	କଲୈସେଲଵୀ
કલ્પ	କଲ୍ପ
કલ્પેશ	କଲ୍ପେଶ
કવચ	କଵଚ
કવિનયા	କଵିନଯା
કવીપ્રનીતા	କଵୀପ୍ରନୀତା
કશિશ	କଶିଶ
કશ્યપ	କଶ୍ଯପ
કસ્તૂરી	କସ୍ତୂରୀ
કહન	କହନ
કાંવ	କାଂଵ
કાજળ	କାଜଳ
કાત્યયાની	କାତ୍ଯଯାନୀ
કાદમ્બિની	କାଦମ୍ବିନୀ
કાનાસુ	କାନାସୁ
કાન્જીરા	କାନ୍ଜୀରା
કામાખ્યા	କାମାଖ୍ଯା
કામિકા	କାମିକା
કામીક	କାମୀକ
કામેરીના	କାମେରୀନା
કાયંશ	କାଯଂଶ
કાયલવિલી	କାଯଲଵିଲୀ
કારૂકા	କାରୂକା
કાલપી	କାଲପୀ
કાલિંદી	କାଲିଂଦୀ
કાલિરંજન	କାଲିରଂଜନ
કાવ્યંશ	କାଵ୍ଯଂଶ
કાષ્ઠ	କାଷ୍ଠ
કિન્નેરા	କିନ୍ନେରା
કિર્તિત	କିର୍ତିତ
કિશા	କିଶା
કેતવ	କେତଵ
કેતિકા	କେତିକା
કેતીત	କେତୀତ
કેદારનાથ	କେଦାରନାଥ
કેનિષા	କେନିଷା
કેયા	କେଯା
કેયાન	କେଯାନ
કેલ્વીન	କେଲ୍ଵୀନ
કેવલકુમાર	କେଵଲକୁମାର
કેવિકા	କେଵିକା
કેવ્લીના	କେଵ୍ଲୀନା
કેશિકા	କେଶିକା
કેશિન	କେଶିନ
કેશોરી	କେଶୋରୀ
કેસવા	କେସଵା
કૈરવી	କୈରଵୀ
કૈલાશચંદ્ર	କୈଲାଶଚଂଦ୍ର
કૌશિક	କୌଶିକ
કૌશેય	କୌଶେଯ
કૌસ્તુભી	କୌସ୍ତୁଭୀ
ખરાધ્વામ્સીને	ଖରାଧ୍ଵାମ୍ସୀନେ
ખાદીર	ଖାଦୀର
ખાવ્યા	ଖାଵ୍ଯା
ખુશ્બૂ	ଖୁଶ୍ବୂ
ખેજલ	ଖେଜଲ
ગંગા	ଗଂଗା
ગંગિકા	ଗଂଗିକା
ગંગી	ଗଂଗୀ
ગંગેયા	ଗଂଗେଯା
ગંગેશ	ଗଂଗେଶ
ગંદિરા	ଗଂଦିରା
ગંધા	ଗଂଧା
ગંધાર	ଗଂଧାର
ગજપતિ	ଗଜପତି
ગ઼ુનસૂંદરી	ଗ଼ୁନସୂଂଦରୀ
ગાંધામધના	ଗାଂଧାମଧନା
ગાયન	ଗାଯନ
ગાલવ	ଗାଲଵ
ગીતિકા	ଗୀତିକା
ગીતીશા	ଗୀତୀଶା
ગીતેશ	ଗୀତେଶ
ગીત્શ	ଗୀତ୍ଶ
ગીરિષા	ଗୀରିଷା
ગીર્જેશ	ଗୀର୍ଜେଶ
ગીવીથા	ଗୀଵୀଥା
ગીહિતી	ଗୀହିତୀ
ગુણવાથી	ଗୁଣଵାଥୀ
ગુદાકેશ	ଗୁଦାକେଶ
ગુનાક્ષી	ଗୁନାକ୍ଷୀ
ગુનાનીધી	ଗୁନାନୀଧୀ
ગુનિના	ଗୁନିନା
ગુનીત	ଗୁନୀତ
ગુરનામ	ଗୁରନାମ
ગુરીશ	ଗୁରୀଶ
ગુરુશરણ	ଗୁରୁଶରଣ
ગોપાલ કૃષ્ણન	ଗୋପାଲ କୃଷ୍ଣନ
ગોવરી	ଗୋଵରୀ
ગોવ્થમી	ଗୋଵ୍ଥମୀ
ગૌરિકાંત	ଗୌରିକାଂତ
ગૌરેશ	ଗୌରେଶ
ગૌર્યનવી	ଗୌର୍ଯନଵୀ
ગ્યાનવી	ଗ୍ଯାନଵୀ
ગ્રહિત	ଗ୍ରହିତ
ઘટા	ଘଟା
ઘનાનંદ	ଘନାନଂଦ
ઘુંગરૂ	ଘୁଂଗରୂ
ચંચલાદવાલા	ଚଂଚଲାଦଵାଲା
ચંચારી	ଚଂଚାରୀ
ચંચારીક	ଚଂଚାରୀକ
ચંદિકા	ଚଂଦିକା
ચંદ્ર ભાન	ଚଂଦ୍ର ଭାନ
ચંદ્રકિરણ	ଚଂଦ୍ରକିରଣ
ચંદ્રકીર્તી	ଚଂଦ୍ରକୀର୍ତୀ
ચંદ્રબિંદુ	ଚଂଦ୍ରବିଂଦୁ
ચક્રદેવ	ଚକ୍ରଦେଵ
ચક્રિક	ଚକ୍ରିକ
ચન્દ્રવદન	ଚନ୍ଦ୍ରଵଦନ
ચન્દ્રહાસ	ଚନ୍ଦ୍ରହାସ
ચમેલી	ଚମେଲୀ
ચરક	ଚରକ
ચરણજીત	ଚରଣଜୀତ
ચરણરજ	ଚରଣରଜ
ચરિત	ଚରିତ
ચરુલા	ଚରୁଲା
ચસ્મીતા	ଚସ୍ମୀତା
ચાકરીન	ଚାକରୀନ
ચાને	ଚାନେ
ચાન્નક્કા	ଚାନ୍ନକ୍କା
ચાન્નાય	ଚାନ୍ନାଯ
ચારીકા	ଚାରୀକା
ચારુદત્ત	ଚାରୁଦତ୍ତ
ચારુલતા	ଚାରୁଲତା
ચારુશીલા	ଚାରୁଶୀଲା
ચિંટૂ	ଚିଂଟୂ
ચિતહેશ	ଚିତହେଶ
ચિત્કલા	ଚିତ୍କଲା
ચિત્તસ્વરૂપ	ଚିତ୍ତସ୍ଵରୂପ
ચિત્રકુન્દાલા	ଚିତ୍ରକୁନ୍ଦାଲା
ચિત્રલ	ଚିତ୍ରଲ
ચિત્રેશ	ଚିତ୍ରେଶ
ચિદાત્મા	ଚିଦାତ୍ମା
ચિધાત્મા	ଚିଧାତ୍ମା
ચિન્મય	ଚିନ୍ମଯ
ચિર્ત્રંગ	ଚିର୍ତ୍ରଂଗ
ચીન્નીઃ	ଚୀନ୍ନୀଃ
ચેથના	ଚେଥନା
ચેનના	ଚେନନା
ચૈતન	ଚୈତନ
ચૈત્રી	ଚୈତ୍ରୀ
ચોલામિત્ર	ଚୋଲାମିତ୍ର
ચૌનતા	ଚୌନତା
છાયા	ଛାଯା
જગતપાલ	ଜଗତପାଲ
જગદગુરુવે	ଜଗଦଗୁରୁଵେ
જગદીપ	ଜଗଦୀପ
જગન	ଜଗନ
જગિશ	ଜଗିଶ
જગ્ગેર	ଜଗ୍ଗେର
જગ્સના	ଜଗ୍ସନା
જનતા	ଜନତା
જનાદેવ	ଜନାଦେଵ
જનાર્દનન	ଜନାର୍ଦନନ
જનિતા	ଜନିତା
જન્મ	ଜନ୍ମ
જમ્બાવતી	ଜମ୍ବାଵତୀ
જય ગોપાલ	ଜଯ ଗୋପାଲ
જયંતાસેના	ଜଯଂତାସେନା
જયદા	ଜଯଦା
જયન	ଜଯନ
જયમેન	ଜଯମେନ
જયલક્ષ્મી	ଜଯଲକ୍ଷ୍ମୀ
જયલલીથા	ଜଯଲଲୀଥା
જયશેખર	ଜଯଶେଖର
જયહરી	ଜଯହରୀ
જયાકીર્તન	ଜଯାକୀର୍ତନ
જયાપાદમાં	ଜଯାପାଦମାଂ
જયાલક્ષ્મી	ଜଯାଲକ୍ଷ୍ମୀ
જય્મીની	ଜଯ୍ମୀନୀ
જલાગંધા	ଜଲାଗଂଧା
જલાર્ક	ଜଲାର୍କ
જલ્પેશ	ଜଲ୍ପେଶ
જશપાલ	ଜଶପାଲ
જસ્લીના	ଜସ୍ଲୀନା
જસ્વીથા	ଜସ୍ଵୀଥା
જસ્સીચા	ଜସ୍ସୀଚା
જહાંગીર	ଜହାଂଗୀର
જાગ્રત	ଜାଗ୍ରତ
જાગ્રવ	ଜାଗ୍ରଵ
જાઝીમ	ଜାଝୀମ
જાતાવેદાસ	ଜାତାଵେଦାସ
જાનકીરમન	ଜାନକୀରମନ
જાનવી	ଜାନଵୀ
જાનહાન	ଜାନହାନ
જાન્વી	ଜାନ୍ଵୀ
જામીની	ଜାମୀନୀ
જાલેંદ્ર	ଜାଲେଂଦ୍ର
જાહનવી	ଜାହନଵୀ
જિનાભદ્ર	ଜିନାଭଦ୍ର
જિલેશ	ଜିଲେଶ
જિલ્પા	ଜିଲ୍ପା
જીગર	ଜୀଗର
જીતીશ	ଜୀତୀଶ
જીન	ଜୀନ
જીન્શીત	ଜୀନ୍ଶୀତ
જીમૂત	ଜୀମୂତ
જીલવ	ଜୀଲଵ
જીવા	ଜୀଵା
જીવિકા	ଜୀଵିକା
જીવેશ	ଜୀଵେଶ
જીશના	ଜୀଶନା
જીશું	ଜୀଶୁଂ
જુનીતા	ଜୁନୀତା
જેગપ્રીયાન	ଜେଗପ୍ରୀଯାନ
જેતલ	ଜେତଲ
જેનીતા	ଜେନୀତା
જેબીશા	ଜେବୀଶା
જૈચંદ	ଜୈଚଂଦ
જૈચરણ	ଜୈଚରଣ
જૈદેવ	ଜୈଦେଵ
જૈસંકર	ଜୈସଂକର
જૈસ્યા	ଜୈସ୍ଯା
જોયાત્રી	ଜୋଯାତ୍ରୀ
જોવાકી	ଜୋଵାକୀ
જોવિતા	ଜୋଵିତା
જોસ્યા	ଜୋସ୍ଯା
જ્ઞાન	ଜ୍ଞାନ
જ્ઞાનાલ	ଜ୍ଞାନାଲ
જ્યોસ્તના	ଜ୍ଯୋସ୍ତନା
ઝંકાર	ଝଂକାର
ઝરલ	ଝରଲ
ઝાએઈ	ଝାଏଈ
ઝારા	ଝାରା
ઝિનૂક	ଝିନୂକ
ઝુબીન	ଝୁବୀନ
ઝુલિએર	ଝୁଲିଏର
ઝેનીલ	ଝେନୀଲ
ઠરાનીકા	ଠରାନୀକା
ડાલી	ଡାଲୀ
તંગમ	ତଂଗମ
તક્ષક	ତକ୍ଷକ
તથાથાન	ତଥାଥାନ
તનવી	ତନଵୀ
તનવીર	ତନଵୀର
તનિશ્ક	ତନିଶ୍କ
તનુપા	ତନୁପା
તન્નિષ્ઠા	ତନ୍ନିଷ୍ଠା
તન્વી શ્રી	ତନ୍ଵୀ ଶ୍ରୀ
તપસેન્દ્ર	ତପସେନ୍ଦ୍ର
તપસ્વિની	ତପସ୍ଵିନୀ
તમન	ତମନ
તમન્ના	ତମନ୍ନା
તમોનષ	ତମୋନଷ
તયા	ତଯା
તરણ	ତରଣ
તરનીજા	ତରନୀଜା
તરુણી	ତରୁଣୀ
તરુશ્રી	ତରୁଶ୍ରୀ
તરોશ	ତରୋଶ
તશા	ତଶା
તસ્મિ	ତସ୍ମି
તસ્ય	ତସ୍ଯ
તાનક	ତାନକ
તાના	ତାନା
તાની	ତାନୀ
તાનીશતા	ତାନୀଶତା
તાન્વી	ତାନ୍ଵୀ
તાન્વેશા	ତାନ୍ଵେଶା
તામસી	ତାମସୀ
તામીલ્મરણ	ତାମୀଲ୍ମରଣ
તારક	ତାରକ
તારકેશ	ତାରକେଶ
તારકેશ્વર	ତାରକେଶ୍ଵର
તારાનીસેન	ତାରାନୀସେନ
તારોક	ତାରୋକ
તાલંક	ତାଲଂକ
તાલીન	ତାଲୀନ
તાવીનીશ	ତାଵୀନୀଶ
તિક્શીકા	ତିକ୍ଶୀକା
તિજિલ	ତିଜିଲ
તિતિર	ତିତିର
તિનકા	ତିନକା
તિર્થાયાદ	ତିର୍ଥାଯାଦ
તિલકા	ତିଲକା
તિલોત્તમા	ତିଲୋତ୍ତମା
તીમિત	ତୀମିତ
તીમીતા	ତୀମୀତା
તીયાસા	ତୀଯାସା
તીરુગ્નાનમ	ତୀରୁଗ୍ନାନମ
તીરુમેની	ତୀରୁମେନୀ
તીર્થરાજ	ତୀର୍ଥରାଜ
તીશા	ତୀଶା
તુકારામ	ତୁକାରାମ
તુન્ગાર	ତୁନ୍ଗାର
તુલસા	ତୁଲସା
તૃષા	ତୃଷା
તેજસી	ତେଜସୀ
તેજસ્વીતા	ତେଜସ୍ଵୀତା
તેજસ્વીની	ତେଜସ୍ଵୀନୀ
તેજેસ્વીની	ତେଜେସ୍ଵୀନୀ
તેજોભાદ્ર	ତେଜୋଭାଦ୍ର
તેર્ષમ	ତେର୍ଷମ
તેહીહ્યા	ତେହୀହ୍ଯା
તોમોગના	ତୋମୋଗନା
તોશાની	ତୋଶାନୀ
તોશીન	ତୋଶୀନ
તૌરુસ	ତୌରୁସ
ત્રિકાયા	ତ୍ରିକାଯା
ત્રિધાત્રી	ତ୍ରିଧାତ୍ରୀ
ત્રિનાથ	ତ୍ରିନାଥ
ત્રિભુવન	ତ୍ରିଭୁଵନ
ત્રિમૂર્તિ	ତ୍ରିମୂର୍ତି
ત્રિયા	ତ୍ରିଯା
ત્રિવેન્દ્ર	ତ୍ରିଵେନ୍ଦ୍ର
ત્રિશુલાંક	ତ୍ରିଶୁଲାଂକ
ત્રિષર	ତ୍ରିଷର
ત્રીનેશ	ତ୍ରୀନେଶ
ત્રીભુવન	ତ୍ରୀଭୁଵନ
ત્રીલોકાત્માને	ତ୍ରୀଲୋକାତ୍ମାନେ
ત્રીવીક્રમાં	ତ୍ରୀଵୀକ୍ରମାଂ
ત્રીવીદ	ତ୍ରୀଵୀଦ
ત્રેયા	ତ୍ରେଯା
થનીરિકા	ଥନୀରିକା
થાનીકા	ଥାନୀକା
થાનીષા	ଥାନୀଷା
થાનીસરી	ଥାନୀସରୀ
થાન્યસ્રી	ଥାନ୍ଯସ୍ରୀ
થામીલારાસન	ଥାମୀଲାରାସନ
થારન્યા	ଥାରନ୍ଯା
થેન્મોલી	ଥେନ୍ମୋଲୀ
થ્રાયા	ଥ୍ରାଯା
દક્શીકા	ଦକ୍ଶୀକା
દક્ષિત	ଦକ୍ଷିତ
દક્ષેષ	ଦକ୍ଷେଷ
દજ્શી	ଦଜ୍ଶୀ
દધીચિ	ଦଧୀଚି
દયસરા	ଦଯସରା
દયાકર	ଦଯାକର
દયાનીશ્કા	ଦଯାନୀଶ୍କା
દરસાથ	ଦରସାଥ
દરહાસ	ଦରହାସ
દરિદ્રીયાનાશીની	ଦରିଦ୍ରୀଯାନାଶୀନୀ
દર્શિકા	ଦର୍ଶିକା
દર્સીકા	ଦର୍ସୀକା
દલજીત	ଦଲଜୀତ
દલ્શેર	ଦଲ୍ଶେର
દશાગ્રીવા શીરોહરા	ଦଶାଗ୍ରୀଵା ଶୀରୋହରା
દસરાજા	ଦସରାଜା
દસ્માયા	ଦସ୍ମାଯା
દહા	ଦହା
દહાના	ଦହାନା
દાનુષ	ଦାନୁଷ
દારિકા	ଦାରିକା
દિક્ષી	ଦିକ୍ଷୀ
દિપક્ષી	ଦିପକ୍ଷୀ
દિપમ્શું	ଦିପମ୍ଶୁଂ
દિપાશ્રી	ଦିପାଶ୍ରୀ
દિપ્તા	ଦିପ୍ତା
દિશના	ଦିଶନା
દીક્ષિકા	ଦୀକ୍ଷିକା
દીપનકર	ଦୀପନକର
દીપમાળા	ଦୀପମାଳା
દીપાના	ଦୀପାନା
દીપ્તિ	ଦୀପ୍ତି
દેબન્શી	ଦେବନ୍ଶୀ
દેબસ્મિતા	ଦେବସ୍ମିତା
દેબાસીસ	ଦେବାସୀସ
દેબોરહ	ଦେବୋରହ
દેબ્પ્રસાદ	ଦେବ୍ପ୍ରସାଦ
દેવ કુમાર	ଦେଵ କୁମାର
દેવકલી	ଦେଵକଲୀ
દેવકી	ଦେଵକୀ
દેવતા	ଦେଵତା
દેવમતિ	ଦେଵମତି
દેવર્સી	ଦେଵର୍ସୀ
દેવાંગી	ଦେଵାଂଗୀ
દેવાંશ	ଦେଵାଂଶ
દેવાજુતા	ଦେଵାଜୁତା
દેવાદાર્શીની	ଦେଵାଦାର୍ଶୀନୀ
દેવાદીત્યા	ଦେଵାଦୀତ୍ଯା
દેવાદ્યુમના	ଦେଵାଦ୍ଯୁମନା
દેવાનંદન	ଦେଵାନଂଦନ
દેવાપી	ଦେଵାପୀ
દેવાલીના	ଦେଵାଲୀନା
દેવિદાસ	ଦେଵିଦାସ
દેવિના	ଦେଵିନା
દેવીકી	ଦେଵୀକୀ
દેવેન્દ્રનાથ	ଦେଵେନ୍ଦ୍ରନାଥ
દેવેન્દ્રશીકા	ଦେଵେନ୍ଦ୍ରଶୀକା
દેવેશી	ଦେଵେଶୀ
દેવ્યમ	ଦେଵ୍ଯମ
દેવ્યાની	ଦେଵ୍ଯାନୀ
દેવ્વાન્તી	ଦେଵ୍ଵାନ୍ତୀ
દેશવા	ଦେଶଵା
દેશીકા	ଦେଶୀକା
દેસના	ଦେସନା
દેસીકા	ଦେସୀକା
દેહ્ય	ଦେହ୍ଯ
દૈત્ય	ଦୈତ୍ଯ
દૈના	ଦୈନା
દૈપાયન	ଦୈପାଯନ
દૈવી	ଦୈଵୀ
ધક્શીતા	ଧକ୍ଶୀତା
ધક્ષતા	ଧକ୍ଷତା
ધન લક્ષ્મી	ଧନ ଲକ୍ଷ୍ମୀ
ધનધાન્યકી	ଧନଧାନ୍ଯକୀ
ધનશિકા	ଧନଶିକା
ધનિયા	ଧନିଯା
ધનુંર્ધારા	ଧନୁଂର୍ଧାରା
ધમેન્દ્ર	ଧମେନ୍ଦ୍ର
ધરમવીર	ଧରମଵୀର
ધરાસુતા	ଧରାସୁତା
ધર્મઅધ્યક્ષ	ଧର୍ମଅଧ୍ଯକ୍ଷ
ધર્મકીર્તિ	ଧର୍ମକୀର୍ତି
ધર્મીશ્તા	ଧର୍ମୀଶ୍ତା
ધવલ્યા	ଧଵଲ୍ଯା
ધાર્શીકા	ଧାର୍ଶୀକା
ધાવીશી	ଧାଵୀଶୀ
ધિરા	ଧିରା
ધીપ્ત્હા	ଧୀପ୍ତ୍ହା
ધીમાહી	ଧୀମାହୀ
ધૂન	ଧୂନ
ધૈર્ય	ଧୈର୍ଯ
ધ્રીશીકા	ଧ୍ରୀଶୀକା
નંદ	ନଂଦ
નંદકુમાર	ନଂଦକୁମାର
નંદગોપાલ	ନଂଦଗୋପାଲ
નક્શ	ନକ୍ଶ
નક્ષાત્ર	ନକ୍ଷାତ୍ର
નગરજન	ନଗରଜନ
નબ્હિજ	ନବ୍ହିଜ
નમસ્યૂ	ନମସ୍ଯୂ
નમીતા	ନମୀତା
નયાજ	ନଯାଜ
નયાસના	ନଯାସନା
નરીતા	ନରୀତା
નર્મદા	ନର୍ମଦା
નવતેજ	ନଵତେଜ
નવિન	ନଵିନ
નાકીસકા	ନାକୀସକା
નાકુશ	ନାକୁଶ
નાગનાથ	ନାଗନାଥ
નાગાંજલી	ନାଗାଂଜଲୀ
નાગાનંદિની	ନାଗାନଂଦିନୀ
નાગાર્જુન	ନାଗାର୍ଜୁନ
નાગેસ્વારી	ନାଗେସ୍ଵାରୀ
નાટકપ્રિય	ନାଟକପ୍ରିଯ
નાથ	ନାଥ
નાન્દુની	ନାନ୍ଦୁନୀ
નાભિ	ନାଭି
નાયક	ନାଯକ
નાયકી	ନାଯକୀ
નારંગ	ନାରଂଗ
નારન	ନାରନ
નારાયન	ନାରାଯନ
નાર્સપ્પા	ନାର୍ସପ୍ପା
નાવાન્ય	ନାଵାନ୍ଯ
નાવાપ્રિયન	ନାଵାପ୍ରିଯନ
નાશાલ	ନାଶାଲ
નિકેતા	ନିକେତା
નિખાલ	ନିଖାଲ
નિખિલ	ନିଖିଲ
નિધન	ନିଧନ
નિપા	ନିପା
નિબંધના	ନିବଂଧନା
નિમેશ	ନିମେଶ
નિરામઈ	ନିରାମଈ
નિરામયા	ନିରାମଯା
નિરૂપા	ନିରୂପା
નિલિની	ନିଲିନୀ
નિલ્લ	ନିଲ୍ଲ
નિશય	ନିଶଯ
નિશા	ନିଶା
નિશિ	ନିଶି
નિશિકા	ନିଶିକା
નિષ્ણાં	ନିଷ୍ଣାଂ
નિહિત	ନିହିତ
નીકુંજા	ନୀକୁଂଜା
નીકેશ્ય	ନୀକେଶ୍ଯ
નીખેલ	ନୀଖେଲ
નીગી	ନୀଗୀ
નીડી	ନୀଡୀ
નીદિશ	ନୀଦିଶ
નીધા	ନୀଧା
નીપા	ନୀପା
નીપુના	ନୀପୁନା
નીબેદીતા	ନୀବେଦୀତା
નીરજ નયન	ନୀରଜ ନଯନ
નીરુધી	ନୀରୁଧୀ
નીરૈમાંથી	ନୀରୈମାଂଥୀ
નીર્મુકતા	ନୀର୍ମୁକତା
નીલંજન	ନୀଲଂଜନ
નીલાક્ષી	ନୀଲାକ୍ଷୀ
નીલ્પ્રબ્ભા	ନୀଲ୍ପ୍ରବ୍ଭା
નીશીરા	ନୀଶୀରା
નીશોકા	ନୀଶୋକା
નીસ્ચીતા	ନୀସ୍ଚୀତା
નીસ્ચીથા	ନୀସ୍ଚୀଥା
નેકા	ନେକା
નેત્રતાવ	ନେତ୍ରତାଵ
નેમીચંદ	ନେମୀଚଂଦ
નેવી	ନେଵୀ
નેશ્વારી	ନେଶ୍ଵାରୀ
નૈનીશા	ନୈନୀଶା
નૈમિષા	ନୈମିଷା
નૈરુથી	ନୈରୁଥୀ
નૈલીકા	ନୈଲୀକା
નૌરિન	ନୌରିନ
પંકજલોચના	ପଂକଜଲୋଚନା
પંકિત	ପଂକିତ
પંચમી	ପଂଚମୀ
પંડી	ପଂଡୀ
પંથ	ପଂଥ
પક્ષી	ପକ୍ଷୀ
પક્ષીન	ପକ୍ଷୀନ
પઝ્હેની	ପଝ୍ହେନୀ
પણ-ગેશ	ପଣ-ଗେଶ
પત્ર	ପତ୍ର
પત્રલિકા	ପତ୍ରଲିକା
પત્રીક	ପତ୍ରୀକ
પદમાંક્ષ્ય	ପଦମାଂକ୍ଷ୍ଯ
પદમાવતી	ପଦମାଵତୀ
પદ્મ	ପଦ୍ମ
પદ્માકર	ପଦ୍ମାକର
પનિતા	ପନିତା
પન્યશ્રી	ପନ୍ଯଶ୍ରୀ
પયોશ્નીકા	ପଯୋଶ୍ନୀକା
પરમ	ପରମ
પરમિલા	ପରମିଲା
પરવાસૂ	ପରଵାସୂ
પરસમે	ପରସମେ
પરસ્માઈ	ପରସ୍ମାଈ
પરાકાષ	ପରାକାଷ
પરાક્રમ	ପରାକ୍ରମ
પરિચય	ପରିଚଯ
પરિષ	ପରିଷ
પરીસા	ପରୀସା
પર્જન્ય	ପର୍ଜନ୍ଯ
પર્નલ	ପର୍ନଲ
પર્વત	ପର୍ଵତ
પલાશરંજન	ପଲାଶରଂଜନ
પલોમી	ପଲୋମୀ
પલ્લબ	ପଲ୍ଲବ
પલ્લવિની	ପଲ୍ଲଵିନୀ
પલ્લવી	ପଲ୍ଲଵୀ
પવીશ્ના	ପଵୀଶ୍ନା
પહેલ	ପହେଲ
પાઓલા	ପାଓଲା
પાગલાવન	ପାଗଲାଵନ
પાન્દિયન	ପାନ୍ଦିଯନ
પારબ્રહ્મ	ପାରବ୍ରହ୍ମ
પારવાથી	ପାରଵାଥୀ
પારાવ	ପାରାଵ
પાર્થવ	ପାର୍ଥଵ
પાર્થિવ	ପାର୍ଥିଵ
પાર્થીવેન્દ્ર	ପାର୍ଥୀଵେନ୍ଦ୍ର
પાર્વતી નંદન	ପାର୍ଵତୀ ନଂଦନ
પાર્વાથી	ପାର୍ଵାଥୀ
પાવકી	ପାଵକୀ
પાવના	ପାଵନା
પાવાકી	ପାଵାକୀ
પિંગલા	ପିଂଗଲା
પીઅલ્લી	ପୀଅଲ୍ଲୀ
પીતામ્બરા	ପୀତାମ୍ବରା
પીનલ	ପୀନଲ
પીયાશા	ପୀଯାଶା
પીર્નાવ	ପୀର୍ନାଵ
પૂજન	ପୂଜନ
પૂર્ણલલીતા	ପୂର୍ଣଲଲୀତା
પૂર્નાચંદ્રા	ପୂର୍ନାଚଂଦ୍ରା
પૂર્નામદા	ପୂର୍ନାମଦା
પૂર્વ	ପୂର୍ଵ
પૂર્વિકા	ପୂର୍ଵିକା
પૂર્વીજ્હા	ପୂର୍ଵୀଜ୍ହା
પોંનન	ପୋଂନନ
પોઉર્નીમાં	ପୋଉର୍ନୀମାଂ
પોન્થારા	ପୋନ୍ଥାରା
પોરોમાં	ପୋରୋମାଂ
પોષ	ପୋଷ
પૌરવી	ପୌରଵୀ
પ્રંવુતા	ପ୍ରଂଵୁତା
પ્રગતીશા	ପ୍ରଗତୀଶା
પ્રગ્યા	ପ୍ରଗ୍ଯା
પ્રણાલી	ପ୍ରଣାଲୀ
પ્રનાદા	ପ୍ରନାଦା
પ્રન્જા	ପ୍ରନ୍ଜା
પ્રભાકર	ପ୍ରଭାକର
પ્રભાતી	ପ୍ରଭାତୀ
પ્રભારૂપા	ପ୍ରଭାରୂପା
પ્રભાવતી	ପ୍ରଭାଵତୀ
પ્રભ્રીતી	ପ୍ରଭ୍ରୀତୀ
પ્રહાર્શીની	ପ୍ରହାର୍ଶୀନୀ
પ્રહાસા	ପ୍ରହାସା
પ્રાખ્યા	ପ୍ରାଖ୍ଯା
પ્રાણવાપ્રિયા	ପ୍ରାଣଵାପ୍ରିଯା
પ્રાનાદ	ପ୍ରାନାଦ
ફણીશ	ଫଣୀଶ
ફલોની	ଫଲୋନୀ
ફુલ્લન	ଫୁଲ୍ଲନ
ફેની	ଫେନୀ
ફ્લાવીના	ଫ୍ଲାଵୀନା
બત્નાસીદ્ધીકારા	ବତ୍ନାସୀଦ୍ଧୀକାରା
બદરી	ବଦରୀ
બન્દીન	ବନ୍ଦୀନ
બર્હન	ବର୍ହନ
બલામુરુગન	ବଲାମୁରୁଗନ
બલામ્બુ	ବଲାମ୍ବୁ
બલ્લભ	ବଲ୍ଲଭ
બવિયન	ବଵିଯନ
બસંતી	ବସଂତୀ
બસૂધા	ବସୂଧା
બાટલી	ବାଟଲୀ
બાલાજી	ବାଲାଜୀ
બાલારામ	ବାଲାରାମ
બાલેન્દ્ર	ବାଲେନ୍ଦ୍ର
બાહુબલી	ବାହୁବଲୀ
બાહુલ્ય	ବାହୁଲ୍ଯ
બિંકા	ବିଂକା
બિજય	ବିଜଯ
બિધાન	ବିଧାନ
બિનોય	ବିନୋଯ
બિભવાસુ	ବିଭଵାସୁ
બિમલા	ବିମଲା
બિમ્બ	ବିମ୍ବ
બિસાલા	ବିସାଲା
બીકાશ	ବୀକାଶ
બીન્દુસાગર	ବୀନ୍ଦୁସାଗର
બીબોસ્વાન	ବୀବୋସ୍ଵାନ
બીભાકર	ବୀଭାକର
બીલ્વાની	ବୀଲ୍ଵାନୀ
બીલ્વાનીલાયા	ବୀଲ୍ଵାନୀଲାଯା
બુધીપ્રિયા	ବୁଧୀପ୍ରିଯା
બૂમિકા	ବୂମିକା
બૃંદા	ବୃଂଦା
બેનીતા	ବେନୀତା
બૈજયંતી	ବୈଜଯଂତୀ
બૈસાખી	ବୈସାଖୀ
બૌમાંથી	ବୌମାଂଥୀ
બ્રનુચિકા	ବ୍ରନୁଚିକା
બ્રહ્માવતી	ବ୍ରହ୍ମାଵତୀ
બ્રિજબાલા	ବ୍ରିଜବାଲା
ભગત	ଭଗତ
ભગવંત	ଭଗଵଂତ
ભદ્રંગ	ଭଦ୍ରଂଗ
ભદ્રક	ଭଦ୍ରକ
ભદ્રકપિલ	ଭଦ୍ରକପିଲ
ભરાન	ଭରାନ
ભર્તેશ	ଭର୍ତେଶ
ભવન	ଭଵନ
ભવરોગસ્યાભેશાજા	ଭଵରୋଗସ୍ଯାଭେଶାଜା
ભવાની સંકર	ଭଵାନୀ ସଂକର
ભાગીરત	ଭାଗୀରତ
ભાગ્યશબરી	ଭାଗ୍ଯଶବରୀ
ભાગ્યા	ଭାଗ୍ଯା
ભાગ્યેશ	ଭାଗ୍ଯେଶ
ભાનુજ	ଭାନୁଜ
ભાનુપ્રિયા	ଭାନୁପ୍ରିଯା
ભાનુમિત્ર	ଭାନୁମିତ୍ର
ભારતી	ଭାରତୀ
ભારવી	ଭାରଵୀ
ભારુ	ଭାରୁ
ભાર્ગવા	ଭାର୍ଗଵା
ભાવાનીલ	ଭାଵାନୀଲ
ભાવાપ્રિયા	ଭାଵାପ୍ରିଯା
ભાવામોચની	ଭାଵାମୋଚନୀ
ભાવાર્થ	ଭାଵାର୍ଥ
ભાવાલન	ଭାଵାଲନ
ભાવિક	ଭାଵିକ
ભાવિન	ଭାଵିନ
ભાવેશ	ଭାଵେଶ
ભાસુ	ଭାସୁ
ભિમાંવેગ	ଭିମାଂଵେଗ
ભીખી	ଭୀଖୀ
ભીમસેન	ଭୀମସେନ
ભીમાંન્શી	ଭୀମାଂନ୍ଶୀ
ભીલાનગના	ଭୀଲାନଗନା
ભુવૈનીકા	ଭୁଵୈନୀକା
ભૂતપાલા	ଭୂତପାଲା
ભૂપેન્દ્ર	ଭୂପେନ୍ଦ୍ର
ભૂમીશ	ଭୂମୀଶ
ભૃગુ	ଭୃଗୁ
ભેવીન	ଭେଵୀନ
ભેસાજ	ଭେସାଜ
ભોજા	ଭୋଜା
ભોલાનાથ	ଭୋଲାନାଥ
મંગલા	ମଂଗଲା
મંજુ પ્રસાદ	ମଂଜୁ ପ୍ରସାଦ
મંજુનાથ	ମଂଜୁନାଥ
મંજુબાલા	ମଂଜୁବାଲା
મંજૂશા	ମଂଜୂଶା
મંત	ମଂତ
મંત્રના	ମଂତ୍ରନା
મંથિકા	ମଂଥିକା
મકર	ମକର
મણિરત્ના	ମଣିରତ୍ନା
મત્સ્યેંદ્ર	ମତ୍ସ୍ଯେଂଦ୍ର
મદીન	ମଦୀନ
મદુર	ମଦୁର
મધુ સ્મિતા	ମଧୁ ସ୍ମିତା
મધુકાંત	ମଧୁକାଂତ
મધુદીપ	ମଧୁଦୀପ
મધુમાંલી	ମଧୁମାଂଲୀ
મધુમાલતી	ମଧୁମାଲତୀ
મધુલા	ମଧୁଲା
મધુલેખા	ମଧୁଲେଖା
મનનશ	ମନନଶ
મનવિર	ମନଵିର
મનસ્વિન	ମନସ୍ଵିନ
મનસ્વિની	ମନସ୍ଵିନୀ
મનિભૂષણ	ମନିଭୂଷଣ
મનીતા	ମନୀତା
મનીદીપ	ମନୀଦୀପ
મનુજ	ମନୁଜ
મનોથ	ମନୋଥ
મનોભાવ	ମନୋଭାଵ
મન્કુર	ମନ୍କୁର
મયુરીની	ମଯୁରୀନୀ
મરીને	ମରୀନେ
મલયજ	ମଲଯଜ
મલ્લિકા	ମଲ୍ଲିକା
મલ્લિકાર્જુન	ମଲ୍ଲିକାର୍ଜୁନ
મલ્લિગા	ମଲ୍ଲିଗା
મલ્લી	ମଲ୍ଲୀ
મલ્લુ	ମଲ୍ଲୁ
મસરા	ମସରା
મહંથી	ମହଂଥୀ
મહાત્મન	ମହାତ୍ମନ
મહાનંદ	ମହାନଂଦ
મહાપુરુષ	ମହାପୁରୁଷ
મહાબુદ્ધિ	ମହାବୁଦ୍ଧି
મહાર્થ	ମହାର୍ଥ
મહાર્વીન	ମହାର୍ଵୀନ
મહાલીંગ	ମହାଲୀଂଗ
મહાલ્યા	ମହାଲ୍ଯା
મહાશ્રી	ମହାଶ୍ରୀ
મહિપતિ	ମହିପତି
મહીથા	ମହୀଥା
મહેંદ્રા	ମହେଂଦ୍ରା
માંગેશ	ମାଂଗେଶ
માંધુનીકા	ମାଂଧୁନୀକା
માંનાર્પ	ମାଂନାର୍ପ
માંનીક્યા	ମାଂନୀକ୍ଯା
માંનીચ	ମାଂନୀଚ
માંનીવ	ମାଂନୀଵ
માંનુંસ્મીથા	ମାଂନୁଂସ୍ମୀଥା
માંનોત	ମାଂନୋତ
માંન્ગીરી	ମାଂନ୍ଗୀରୀ
માંન્તીકા	ମାଂନ୍ତୀକା
માંન્દામારી	ମାଂନ୍ଦାମାରୀ
માંન્દારિકા	ମାଂନ୍ଦାରିକା
માંલાવાશ્રી	ମାଂଲାଵାଶ୍ରୀ
માતંગા	ମାତଂଗା
માતેઃ	ମାତେଃ
માત્રે	ମାତ୍ରେ
માથુર	ମାଥୁର
માધવ દાસ	ମାଧଵ ଦାସ
માધવિલતા	ମାଧଵିଲତା
માધાન	ମାଧାନ
માધુજ	ମାଧୁଜ
માનજ	ମାନଜ
માનવિત	ମାନଵିତ
માનીન્ત	ମାନୀନ୍ତ
માન્દાવિક	ମାନ୍ଦାଵିକ
મારવી	ମାରଵୀ
મારીરાજ	ମାରୀରାଜ
મારુત	ମାରୁତ
માર્કાન્દાય	ମାର୍କାନ୍ଦାଯ
માર્ગશી	ମାର୍ଗଶୀ
માર્ગી	ମାର୍ଗୀ
માર્દવ	ମାର୍ଦଵ
માર્મિક	ମାର୍ମିକ
માલતી	ମାଲତୀ
માલથી	ମାଲଥୀ
માલારવિલી	ମାଲାରଵିଲୀ
માલારાવન	ମାଲାରାଵନ
માલિની	ମାଲିନୀ
માહિતા	ମାହିତା
મેધાસ્વી	ମେଧାସ୍ଵୀ
મૈથીલ્ય	ମୈଥୀଲ୍ଯ
મૈનાલી	ମୈନାଲୀ
મૈનાવી	ମୈନାଵୀ
મૈમત	ମୈମତ
મૌલિકા	ମୌଲିକା
મૌસુમ	ମୌସୁମ
યજ્નારૂપ	ଯଜ୍ନାରୂପ
યતિકા	ଯତିକା
યદુ	ଯଦୁ
યદુક્રિષ્ના	ଯଦୁକ୍ରିଷ୍ନା
યદુવીર	ଯଦୁଵୀର
યમ્યા	ଯମ୍ଯା
યશિત	ଯଶିତ
યશોધર	ଯଶୋଧର
યશ્દીપ	ଯଶ୍ଦୀପ
યશ્વી	ଯଶ୍ଵୀ
યાઝટ	ଯାଝଟ
યાતિયાસા	ଯାତିଯାସା
યામાજીત	ଯାମାଜୀତ
યાશીકા	ଯାଶୀକା
યાશ્રી	ଯାଶ୍ରୀ
યાસી	ଯାସୀ
યાહ્વી	ଯାହ୍ଵୀ
યીશાઈ	ଯୀଶାଈ
યુકાશ્રી	ଯୁକାଶ୍ରୀ
યુક્ત	ଯୁକ୍ତ
યુગ	ଯୁଗ
યુગંશ	ଯୁଗଂଶ
યુગન	ଯୁଗନ
યુગ્મ	ଯୁଗ୍ମ
યુધાજિત	ଯୁଧାଜିତ
યુધિસઠિર	ଯୁଧିସଠିର
યુનાય	ଯୁନାଯ
યુવંશ	ଯୁଵଂଶ
યુવાની	ଯୁଵାନୀ
યુવિક	ଯୁଵିକ
યૂરા	ଯୂରା
યેધાંત	ଯେଧାଂତ
યેનાક્ષી	ଯେନାକ୍ଷୀ
યોગજ	ଯୋଗଜ
યોગદા	ଯୋଗଦା
યોગના	ଯୋଗନା
યોગાવી	ଯୋଗାଵୀ
યોગી	ଯୋଗୀ
યોગ્યથા	ଯୋଗ୍ଯଥା
યોનેન્દ્ર	ଯୋନେନ୍ଦ୍ର
યૌષા	ଯୌଷା
રંગનાથ	ରଂଗନାଥ
રંતાજ	ରଂତାଜ
રકશ્ન્ડા	ରକଶ୍ନ୍ଡା
રકીશી	ରକୀଶୀ
રક્તકમળ	ରକ୍ତକମଳ
રક્ષ્ય	ରକ୍ଷ୍ଯ
રઘુનાથ	ରଘୁନାଥ
રજીની	ରଜୀନୀ
રતન	ରତନ
રત્ના કુમાર	ରତ୍ନା କୁମାର
રત્નાબલી	ରତ୍ନାବଲୀ
રત્નાવલી	ରତ୍ନାଵଲୀ
રદીતે	ରଦୀତେ
રનક	ରନକ
રનવા	ରନଵା
રનામીતા	ରନାମୀତା
રમિતા	ରମିତା
રમેશ	ରମେଶ
રમ્બેશ	ରମ୍ବେଶ
રમ્યક	ରମ୍ଯକ
રયાપ્પા	ରଯାପ୍ପା
રવિકાંત	ରଵିକାଂତ
રવિકુમાર	ରଵିକୁମାର
રવીતેજા	ରଵୀତେଜା
રવીન	ରଵୀନ
રવીન્ધાર	ରଵୀନ୍ଧାର
રવીશ	ରଵୀଶ
રવેન	ରଵେନ
રશેષ	ରଶେଷ
રશ્મી	ରଶ୍ମୀ
રસવંત	ରସଵଂତ
રહલ	ରହଲ
રહસ્ય	ରହସ୍ଯ
રાકવી	ରାକଵୀ
રાખિ	ରାଖି
રાગાવર્દીની	ରାଗାଵର୍ଦୀନୀ
રાગ્વેદ	ରାଗ୍ଵେଦ
રાજન	ରାଜନ
રાજરમણ	ରାଜରମଣ
રાજલક્ષ્મી	ରାଜଲକ୍ଷ୍ମୀ
રાજસેકરણ	ରାଜସେକରଣ
રાજાન	ରାଜାନ
રાજિંદર	ରାଜିଂଦର
રાજુસ	ରାଜୁସ
રાજેંદ્ર	ରାଜେଂଦ୍ର
રાજેશ્રી	ରାଜେଶ୍ରୀ
રાજ્કલા	ରାଜ୍କଲା
રાજ્યશ્રી	ରାଜ୍ଯଶ୍ରୀ
રાજ્વિકા	ରାଜ୍ଵିକା
રાત્રિ	ରାତ୍ରି
રાધક	ରାଧକ
રાધા	ରାଧା
રાનું	ରାନୁଂ
રામ	ରାମ
રામ  સેવક	ରାମ  ସେଵକ
રામનાથ	ରାମନାଥ
રામરા	ରାମରା
રામસ્વરૂપ	ରାମସ୍ଵରୂପ
રામાંભાદ્રણ	ରାମାଂଭାଦ୍ରଣ
રામાધુતા	ରାମାଧୁତା
રાવના	ରାଵନା
રાસબિહારી	ରାସବିହାରୀ
રિન્કલ	ରିନ୍କଲ
રિસા	ରିସା
રીકાર્નાવ	ରୀକାର୍ନାଵ
રીકીતા	ରୀକୀତା
રીકીશા	ରୀକୀଶା
રીગ્વેદીતા	ରୀଗ୍ଵେଦୀତା
રીથ	ରୀଥ
રીથેકા	ରୀଥେକା
રીધી	ରୀଧୀ
રીનું	ରୀନୁଂ
રીન્સીન	ରୀନ୍ସୀନ
રીમા	ରୀମା
રીશીતા	ରୀଶୀତା
રીહાનના	ରୀହାନନା
રેચિકા	ରେଚିକା
રેનેશ	ରେନେଶ
રેમિથા	ରେମିଥା
રેશમી	ରେଶମୀ
રોનક	ରୋନକ
લકી	ଲକୀ
લક્ષિતા	ଲକ୍ଷିତା
લક્ષ્મી શ્રીનિવાસ	ଲକ୍ଷ୍ମୀ ଶ୍ରୀନିଵାସ
લક્ષ્મીદેવી	ଲକ୍ଷ୍ମୀଦେଵୀ
લક્ષ્મીનાથ	ଲକ୍ଷ୍ମୀନାଥ
લગાન	ଲଗାନ
લજ્જા	ଲଜ୍ଜା
લજ્જાન	ଲଜ୍ଜାନ
લજ્જાવતી	ଲଜ୍ଜାଵତୀ
લતા	ଲତା
લબોની	ଲବୋନୀ
લલિતામોહના	ଲଲିତାମୋହନା
લશિકા	ଲଶିକା
લાઈના	ଲାଈନା
લાકેશ	ଲାକେଶ
લાક્શેતા	ଲାକ୍ଶେତା
લાચ્મન	ଲାଚ୍ମନ
લાતીશ	ଲାତୀଶ
લાધી	ଲାଧୀ
લારીસા	ଲାରୀସା
લાર્મિકા	ଲାର୍ମିକା
લાલીતેશ	ଲାଲୀତେଶ
લાલીત્યા	ଲାଲୀତ୍ଯା
લાલીમા	ଲାଲୀମା
લાવણ્ય	ଲାଵଣ୍ଯ
લાવીશ	ଲାଵୀଶ
લાસીવીન્રાજ	ଲାସୀଵୀନ୍ରାଜ
લાસુશા	ଲାସୁଶା
લિંગાધ્યક્ષ	ଲିଂଗାଧ୍ଯକ୍ଷ
લીકીથ	ଲୀକୀଥ
લીથીકા	ଲୀଥୀକା
લીનું	ଲୀନୁଂ
લીન્નેત	ଲୀନ୍ନେତ
લીમીશા	ଲୀମୀଶା
લીલાધર	ଲୀଲାଧର
લીલાવર્તી	ଲୀଲାଵର୍ତୀ
લીશાંત	ଲୀଶାଂତ
લુંહાન	ଲୁଂହାନ
લુકેશા	ଲୁକେଶା
લૂની	ଲୂନୀ
લેઓરા	ଲେଓରା
લેખિત	ଲେଖିତ
લેના	ଲେନା
લેમ્મીએ	ଲେମ୍ମୀଏ
લોઉકિક	ଲୋଉକିକ
લોકનાથ	ଲୋକନାଥ
લોકનેત્ર	ଲୋକନେତ୍ର
લોકાજિત	ଲୋକାଜିତ
લોકેન્દ્ર	ଲୋକେନ୍ଦ୍ର
લોક્ષી	ଲୋକ୍ଷୀ
લોપેશ	ଲୋପେଶ
લોલા	ଲୋଲା
લોલિતા	ଲୋଲିତା
લોવ્યમ	ଲୋଵ୍ଯମ
લોશીની	ଲୋଶୀନୀ
લોહિની	ଲୋହିନୀ
વંદિત	ଵଂଦିତ
વંશજા	ଵଂଶଜା
વંહી	ଵଂହୀ
વકૃત	ଵକୃତ
વક્ષ	ଵକ୍ଷ
વજરાંગ	ଵଜରାଂଗ
વજ્રબાહૂ	ଵଜ୍ରବାହୂ
વજ્રાકાયા	ଵଜ୍ରାକାଯା
વજ્રિન	ଵଜ୍ରିନ
વજ્રેશ્વરી	ଵଜ୍ରେଶ୍ଵରୀ
વનદેવ	ଵନଦେଵ
વનાની	ଵନାନୀ
વયુનંદ	ଵଯୁନଂଦ
વય્યા	ଵଯ୍ଯା
વરજોત્તામાં	ଵରଜୋତ୍ତାମାଂ
વરદરાજ	ଵରଦରାଜ
વરદાન	ଵରଦାନ
વરપ્રદા	ଵରପ୍ରଦା
વરલક્ષ્મી	ଵରଲକ୍ଷ୍ମୀ
વરિયાસ	ଵରିଯାସ
વર્ધીન	ଵର୍ଧୀନ
વર્શિની	ଵର୍ଶିନୀ
વલાવન	ଵଲାଵନ
વલ્લભ	ଵଲ୍ଲଭ
વશીતા	ଵଶୀତା
વસંતા	ଵସଂତା
વસતીન	ଵସତୀନ
વસવી	ଵସଵୀ
વસુલ	ଵସୁଲ
વાક્પતિ	ଵାକ୍ପତି
વાચસ્પતિ	ଵାଚସ୍ପତି
વાચ્ય	ଵାଚ୍ଯ
વાજ્રહાસ્તા	ଵାଜ୍ରହାସ୍ତା
વાનામાલી	ଵାନାମାଲୀ
વાનાવારાયણ	ଵାନାଵାରାଯଣ
વાનૈપકા-વેરીન્દોન	ଵାନୈପକା-ଵେରୀନ୍ଦୋନ
વામન	ଵାମନ
વામાંનીએ	ଵାମାଂନୀଏ
વાર	ଵାର
વાલકય	ଵାଲକଯ
વાલી	ଵାଲୀ
વાસંતાપ્રભા	ଵାସଂତାପ୍ରଭା
વાસુકી	ଵାସୁକୀ
વાસુમાંથા	ଵାସୁମାଂଥା
વિઅર	ଵିଅର
વિકાસીની	ଵିକାସୀନୀ
વિકાસ્ની	ଵିକାସ୍ନୀ
વિક્ષિત	ଵିକ୍ଷିତ
વિદ્વાથ	ଵିଦ୍ଵାଥ
વિધિ	ଵିଧି
વિનતા	ଵିନତା
વિબુષા	ଵିବୁଷା
વિભાવા	ଵିଭାଵା
વિમલા	ଵିମଲା
વિરબાહુ	ଵିରବାହୁ
વિલાસિની	ଵିଲାସିନୀ
વીક્ષા	ଵୀକ୍ଷା
વીચિકા	ଵୀଚିକା
વીજીલા	ଵୀଜୀଲା
વીની	ଵୀନୀ
વીમા	ଵୀମା
વીરોત્તમ	ଵୀରୋତ୍ତମ
વેક્રાંત	ଵେକ୍ରାଂତ
વેગવાહીની	ଵେଗଵାହୀନୀ
વેણુગોપાલ	ଵେଣୁଗୋପାଲ
વેત્રિવાલ	ଵେତ୍ରିଵାଲ
વેદાંશી	ଵେଦାଂଶୀ
વેદાત્મન	ଵେଦାତ୍ମନ
વેદાત્મને	ଵେଦାତ୍ମନେ
વેદાર્થ	ଵେଦାର୍ଥ
વેદીષ	ଵେଦୀଷ
વેધા	ଵେଧା
વેધાસ	ଵେଧାସ
વેધીકા	ଵେଧୀକା
વેનાહ	ଵେନାହ
વેનીધર	ଵେନୀଧର
વેન્કાત્શીવા	ଵେନ୍କାତ୍ଶୀଵା
વેન્નેલા	ଵେନ୍ନେଲା
વેલુ	ଵେଲୁ
વેવેશા	ଵେଵେଶା
વૈજનાથ	ଵୈଜନାଥ
વૈદાહી	ଵୈଦାହୀ
વૈદ્યનાથ	ଵୈଦ୍ଯନାଥ
વૈધે	ଵୈଧେ
વૈનાવિન	ଵୈନାଵିନ
વૈશાકા	ଵୈଶାକା
વૈશાખી	ଵୈଶାଖୀ
વૈશાલી	ଵୈଶାଲୀ
વૈશ્વિક	ଵୈଶ୍ଵିକ
વૈષ્ણવી	ଵୈଷ୍ଣଵୀ
વૈસાખી	ଵୈସାଖୀ
સંચાલી	ସଂଚାଲୀ
સંજય	ସଂଜଯ
સંજીથા	ସଂଜୀଥା
સંજુકતા	ସଂଜୁକତା
સંતવાના	ସଂତଵାନା
સંદીતી	ସଂଦୀତୀ
સંદીપન	ସଂଦୀପନ
સંભાવના	ସଂଭାଵନା
સંયક્તા	ସଂଯକ୍ତା
સંવિકા	ସଂଵିକା
સંસ્કૃતિ	ସଂସ୍କୃତି
સંસ્કૃતી	ସଂସ୍କୃତୀ
સકલ	ସକଲ
સક્તીવેલ	ସକ୍ତୀଵେଲ
સક્શિક	ସକ୍ଶିକ
સક્શીન્યા	ସକ୍ଶୀନ୍ଯା
સક્ષમ	ସକ୍ଷମ
સચંદ્ર	ସଚଂଦ୍ର
સજૂ	ସଜୂ
સદગુરૂ	ସଦଗୁରୂ
સદબિંદુ	ସଦବିଂଦୁ
સદરુ	ସଦରୁ
સદા શિવમ	ସଦା ଶିଵମ
સદાશિવ	ସଦାଶିଵ
સદિવા	ସଦିଵା
સદ્વિખા	ସଦ୍ଵିଖା
સનવ	ସନଵ
સનીલ	ସନୀଲ
સનેશ	ସନେଶ
સનૈતા	ସନୈତା
સપર્ણા	ସପର୍ଣା
સપુષ્પા	ସପୁଷ୍ପା
સપ્તોર્શી	ସପ୍ତୋର୍ଶୀ
સબરીનાથાન	ସବରୀନାଥାନ
સભ્રાંત	ସଭ୍ରାଂତ
સમન્યુ	ସମନ୍ଯୁ
સમબરણ	ସମବରଣ
સમભ્દ્ધા	ସମଭ୍ଦ୍ଧା
સમય	ସମଯ
સમરવીર	ସମରଵୀର
સમાંર્ધ	ସମାଂର୍ଧ
સમાધાન	ସମାଧାନ
સમિયા	ସମିଯା
સમીક્ક્સા	ସମୀକ୍କ୍ସା
સમીક્ષા	ସମୀକ୍ଷା
સમ્બુદ્ધા	ସମ୍ବୁଦ୍ଧା
સમ્યનાતન	ସମ୍ଯନାତନ
સમ્રીધ	ସମ୍ରୀଧ
સમ્હીઠા	ସମ୍ହୀଠା
સરલા	ସରଲା
સર્જના	ସର୍ଜନା
સહલાદ	ସହଲାଦ
સહસ્ત્રજિત	ସହସ୍ତ୍ରଜିତ
સહસ્વીની	ସହସ୍ଵୀନୀ
સહુરી	ସହୁରୀ
સહૃદય	ସହୃଦଯ
સહેજ	ସହେଜ
સહોજ	ସହୋଜ
સહ્ય	ସହ୍ଯ
સાંદીપની	ସାଂଦୀପନୀ
સાઈ અમર્ત્ય	ସାଈ ଅମର୍ତ୍ଯ
સાઈ કાર્તિક	ସାଈ କାର୍ତିକ
સાઈ દાસ	ସାଈ ଦାସ
સાઈ સુરિયા	ସାଈ ସୁରିଯା
સાતેજ	ସାତେଜ
સાદ્રીશી	ସାଦ୍ରୀଶୀ
સાધકા	ସାଧକା
સાધન	ସାଧନ
સાનંદના	ସାନଂଦନା
સાનવી તારીતા	ସାନଵୀ ତାରୀତା
સાનાવી	ସାନାଵୀ
સાન્વી	ସାନ୍ଵୀ
સાફલ્ય	ସାଫଲ୍ଯ
સાબી	ସାବୀ
સામલી	ସାମଲୀ
સામાન	ସାମାନ
સારંગી	ସାରଂଗୀ
સારસ	ସାରସ
સારાવતી	ସାରାଵତୀ
સાલીની	ସାଲୀନୀ
સાહસ્રપાત	ସାହସ୍ରପାତ
સાહુલ	ସାହୁଲ
સેન્ડી	ସେନ୍ଡୀ
સૈનિ	ସୈନି
સૈનું	ସୈନୁଂ
સૈય્યન	ସୈଯ୍ଯନ
સૈલેન્દ્ર	ସୈଲେନ୍ଦ୍ର
સૈશા	ସୈଶା
હંસરાજ	ହଂସରାଜ
હંસાવાથ્ય	ହଂସାଵାଥ୍ଯ
હંસિન	ହଂସିନ
હંસીની	ହଂସୀନୀ
હઝેલ	ହଝେଲ
હનસીકા	ହନସୀକା
હનાર્વીન	ହନାର୍ଵୀନ
હનુમાન	ହନୁମାନ
હમૃથા	ହମୃଥା
હમ્સિની	ହମ୍ସିନୀ
હરશું	ହରଶୁଂ
હરા	ହରା
હરિઅક્સા	ହରିଅକ୍ସା
હરિકિશન	ହରିକିଶନ
હરિદા	ହରିଦା
હરિનાક્ષી	ହରିନାକ୍ଷୀ
હરિમંતી	ହରିମଂତୀ
હરી	ହରୀ
હરી કિશન	ହରୀ କିଶନ
હરીકરણ	ହରୀକରଣ
હરીદર્પા	ହରୀଦର୍ପା
હરીદાસાપ્રિયા	ହରୀଦାସାପ୍ରିଯା
હરીદીપ	ହରୀଦୀପ
હરીધામ	ହରୀଧାମ
હરીવલ્લભ	ହରୀଵଲ୍ଲଭ
હરીશ્વ	ହରୀଶ୍ଵ
હર્લીના	ହର୍ଲୀନା
હર્શાશ્રી	ହର୍ଶାଶ୍ରୀ
હર્શિક	ହର୍ଶିକ
હર્ષ વીર	ହର୍ଷ ଵୀର
હર્ષિતા	ହର୍ଷିତା
હર્સ્વીતા	ହର୍ସ୍ଵୀତା
હલેય	ହଲେଯ
હવીસા	ହଵୀସା
હશન	ହଶନ
હસીક	ହସୀକ
હસીથા	ହସୀଥା
હસ્મીથા	ହସ୍ମୀଥା
હાકેશ	ହାକେଶ
હાનીકા	ହାନୀକା
હાર્શીની	ହାର୍ଶୀନୀ
હાહન	ହାହନ
હિડિંબા	ହିଡିଂବା
હિતાંશી	ହିତାଂଶୀ
હિતેક્ષા	ହିତେକ୍ଷା
હિતેન્દ્ર	ହିତେନ୍ଦ୍ର
હિનલ	ହିନଲ
હિનેશ	ହିନେଶ
હિમાકાર	ହିମାକାର
હિમાઘ્ના	ହିମାଘ୍ନା
હિમાલ	ହିମାଲ
હિશા	ହିଶା
હિશેતા	ହିଶେତା
હીમીર	ହୀମୀର
હીરકની	ହୀରକନୀ
હીરાન્યાપ્પા	ହୀରାନ୍ଯାପ୍ପା
હીર્નાક્ષી	ହୀର୍ନାକ୍ଷୀ
હીલ્લેય	ହୀଲ୍ଲେଯ
હુમીશા	ହୁମୀଶା
હુમૈલા	ହୁମୈଲା
હેઇઅન	ହେଇଅନ
હેત	ହେତ
હેતની	ହେତନୀ
હેતવ	ହେତଵ
હેત્વિક	ହେତ୍ଵିକ
હેમંત	ହେମଂତ
હેમદેવ	ହେମଦେଵ
હેમલતા	ହେମଲତା
હેમા	ହେମା
હેમાઁગી	ହେମାଁଗୀ
હેમાંગા	ହେମାଂଗା
હેમાકેશ	ହେମାକେଶ
હેમાલા	ହେମାଲା
હેમાલી	ହେମାଲୀ
હેમાવતી	ହେମାଵତୀ
હેમીતા	ହେମୀତା
હેયન	ହେଯନ
હેશીકા	ହେଶୀକା
હોનહાર	ହୋନହାର
હ્રિથિક	ହ୍ରିଥିକ
હ્રીત્વિકા	ହ୍ରୀତ୍ଵିକା
હ્રીદાન	ହ୍ରୀଦାନ
હ્રીવાન	ହ୍ରୀଵାନ
હ્રીશાંત	ହ୍ରୀଶାଂତ
હ્રીશાબ	ହ୍ରୀଶାବ
હ્રીશુલ	ହ୍ରୀଶୁଲ
હ્રુધાઈ	ହ୍ରୁଧାଈ
#
#
# Territory names from CLDR
એસેન્શન આઇલેન્ડ	ଏସେନ୍ଶନ ଆଇଲେନ୍ଡ
ઍંડોરા	ଏଂଡୋରା
યુનાઇટેડ આરબ અમીરાત	ଯୁନାଇଟେଡ ଆରବ ଅମୀରାତ
અફઘાનિસ્તાન	ଅଫଘାନିସ୍ତାନ
એન્ટીગુઆ અને બર્મુડા	ଏନ୍ଟୀଗୁଆ ଅନେ ବର୍ମୁଡା
ઍંગ્વિલા	ଏଂଗ୍ଵିଲା
અલ્બેનિયા	ଅଲ୍ବେନିଯା
આર્મેનિયા	ଆର୍ମେନିଯା
અંગોલા	ଅଂଗୋଲା
એન્ટાર્કટિકા	ଏନ୍ଟାର୍କଟିକା
આર્જેન્ટીના	ଆର୍ଜେନ୍ଟୀନା
અમેરીકન સમોઆ	ଅମେରୀକନ ସମୋଆ
ઑસ્ટ્રિયા	ଓସ୍ଟ୍ରିଯା
ઑસ્ટ્રેલિયા	ଓସ୍ଟ୍ରେଲିଯା
અરુબા	ଅରୁବା
એલેંડ ટાપુઓ	ଏଲେଂଡ ଟାପୁଓ
અઝરબૈજાન	ଅଝରବୈଜାନ
બોસ્નિયા અને હર્ઝેગોવિના	ବୋସ୍ନିଯା ଅନେ ହର୍ଝେଗୋଵିନା
બાર્બાડોસ	ବାର୍ବାଡୋସ
બાંગ્લાદેશ	ବାଂଗ୍ଲାଦେଶ
બેલ્જીયમ	ବେଲ୍ଜୀଯମ
બુર્કિના ફાસો	ବୁର୍କିନା ଫାସୋ
બલ્ગેરિયા	ବଲ୍ଗେରିଯା
બેહરીન	ବେହରୀନ
બુરુંડી	ବୁରୁଂଡୀ
બેનિન	ବେନିନ
સેન્ટ બાર્થેલેમી	ସେନ୍ଟ ବାର୍ଥେଲେମୀ
બર્મુડા	ବର୍ମୁଡା
બ્રુનેઇ	ବ୍ରୁନେଇ
બોલિવિયા	ବୋଲିଵିଯା
કેરેબિયન નેધરલેન્ડ્ઝ	କେରେବିଯନ ନେଧରଲେନ୍ଡ୍ଝ
બ્રાઝિલ	ବ୍ରାଝିଲ
બહામાસ	ବହାମାସ
ભૂટાન	ଭୂଟାନ
બૌવેત આઇલેન્ડ	ବୌଵେତ ଆଇଲେନ୍ଡ
બોત્સ્વાના	ବୋତ୍ସ୍ଵାନା
બેલારુસ	ବେଲାରୁସ
બેલીઝ	ବେଲୀଝ
કેનેડા	କେନେଡା
કોકોઝ (કીલીંગ) આઇલેન્ડ્સ	କୋକୋଝ (କୀଲୀଂଗ) ଆଇଲେନ୍ଡ୍ସ
કોંગો - કિંશાસા	କୋଂଗୋ - କିଂଶାସା
કોંગો (ડીઆરસી)	କୋଂଗୋ (ଡୀଆରସୀ)
સેન્ટ્રલ આફ્રિકન રીપબ્લિક	ସେନ୍ଟ୍ରଲ ଆଫ୍ରିକନ ରୀପବ୍ଲିକ
કોંગો - બ્રાઝાવિલે	କୋଂଗୋ - ବ୍ରାଝାଵିଲେ
કોંગો (પ્રજાસત્તાક)	କୋଂଗୋ (ପ୍ରଜାସତ୍ତାକ)
સ્વિટ્ઝર્લૅન્ડ	ସ୍ଵିଟ୍ଝର୍ଲେନ୍ଡ
કોટ ડી આઇવરી	କୋଟ ଡୀ ଆଇଵରୀ
આઇવરી કોસ્ટ	ଆଇଵରୀ କୋସ୍ଟ
કુક આઇલેન્ડ્સ	କୁକ ଆଇଲେନ୍ଡ୍ସ
ચિલી	ଚିଲୀ
કૅમરૂન	କେମରୂନ
ચીન	ଚୀନ
કોલમ્બિયા	କୋଲମ୍ବିଯା
ક્લિપરટન આઇલેન્ડ	କ୍ଲିପରଟନ ଆଇଲେନ୍ଡ
કોસ્ટા રિકા	କୋସ୍ଟା ରିକା
ક્યુબા	କ୍ଯୁବା
કૅપ વર્ડે	କେପ ଵର୍ଡେ
કુરાકાઓ	କୁରାକାଓ
ક્રિસમસ આઇલેન્ડ	କ୍ରିସମସ ଆଇଲେନ୍ଡ
સાયપ્રસ	ସାଯପ୍ରସ
ચેક રીપબ્લિક	ଚେକ ରୀପବ୍ଲିକ
જર્મની	ଜର୍ମନୀ
ડિએગો ગારસિઆ	ଡିଏଗୋ ଗାରସିଆ
જીબૌટી	ଜୀବୌଟୀ
ડેનમાર્ક	ଡେନମାର୍କ
ડોમિનિકા	ଡୋମିନିକା
ડોમિનિકન રીપબ્લિક	ଡୋମିନିକନ ରୀପବ୍ଲିକ
અલ્જીરિયા	ଅଲ୍ଜୀରିଯା
સ્યુટા અને મેલિલા	ସ୍ଯୁଟା ଅନେ ମେଲିଲା
એક્વાડોર	ଏକ୍ଵାଡୋର
એસ્ટોનિયા	ଏସ୍ଟୋନିଯା
ઇજિપ્ત	ଇଜିପ୍ତ
પશ્ચિમી સહારા	ପଶ୍ଚିମୀ ସହାରା
એરિટ્રિયા	ଏରିଟ୍ରିଯା
સ્પેન	ସ୍ପେନ
ઇથિઓપિયા	ଇଥିଓପିଯା
યુરોપિયન સંઘ	ଯୁରୋପିଯନ ସଂଘ
ફિનલેન્ડ	ଫିନଲେନ୍ଡ
ફીજી	ଫୀଜୀ
ફૉકલેન્ડ ટાપુઓ	ଫୋକଲେନ୍ଡ ଟାପୁଓ
ફૉકલેન્ડ ટાપુઓ (ઇસ્લાસ માલવિનસ)	ଫୋକଲେନ୍ଡ ଟାପୁଓ (ଇସ୍ଲାସ ମାଲଵିନସ)
માઇક્રોનેશિયા	ମାଇକ୍ରୋନେଶିଯା
ફૅરો ટાપુઓ	ଫେରୋ ଟାପୁଓ
ફ્રાંસ	ଫ୍ରାଂସ
ગેબન	ଗେବନ
યુનાઇટેડ કિંગડમ	ଯୁନାଇଟେଡ କିଂଗଡମ
ગ્રેનેડા	ଗ୍ରେନେଡା
જ્યોર્જીયા	ଜ୍ଯୋର୍ଜୀଯା
ફ્રેંચ ગયાના	ଫ୍ରେଂଚ ଗଯାନା
ગ્વેર્નસે	ଗ୍ଵେର୍ନସେ
ઘાના	ଘାନା
જીબ્રાલ્ટર	ଜୀବ୍ରାଲ୍ଟର
ગ્રીનલેન્ડ	ଗ୍ରୀନଲେନ୍ଡ
ગેમ્બિયા	ଗେମ୍ବିଯା
ગિની	ଗିନୀ
ગ્વાડેલોપ	ଗ୍ଵାଡେଲୋପ
ઇક્વેટોરિયલ ગિની	ଇକ୍ଵେଟୋରିଯଲ ଗିନୀ
ગ્રીસ	ଗ୍ରୀସ
દક્ષિણ જ્યોર્જીયા અને દક્ષિણ સેન્ડવિચ આઇલેન્ડ્સ	ଦକ୍ଷିଣ ଜ୍ଯୋର୍ଜୀଯା ଅନେ ଦକ୍ଷିଣ ସେନ୍ଡଵିଚ ଆଇଲେନ୍ଡ୍ସ
ગ્વાટેમાલા	ଗ୍ଵାଟେମାଲା
ગ્વામ	ଗ୍ଵାମ
ગિની-બિસાઉ	ଗିନୀ-ବିସାଉ
ગયાના	ଗଯାନା
હોંગકોંગ SAR ચીન	ହୋଂଗକୋଂଗ SAR ଚୀନ
હોંગ કોંગ	ହୋଂଗ କୋଂଗ
હર્ડ અને મેકડોનાલ્ડ આઇલેન્ડ્સ	ହର୍ଡ ଅନେ ମେକଡୋନାଲ୍ଡ ଆଇଲେନ୍ଡ୍ସ
હોન્ડુરસ	ହୋନ୍ଡୁରସ
ક્રોએશિયા	କ୍ରୋଏଶିଯା
હૈતિ	ହୈତି
હંગેરી	ହଂଗେରୀ
કૅનેરી ટાપુઓ	କେନେରୀ ଟାପୁଓ
ઇન્ડોનેશિયા	ଇନ୍ଡୋନେଶିଯା
આયર્લેન્ડ	ଆଯର୍ଲେନ୍ଡ
ઇઝરાઇલ	ଇଝରାଇଲ
આઈલ ઓફ મૅન	ଆଈଲ ଓଫ ମେନ
ભારત	ଭାରତ
બ્રિટિશ ઇન્ડિયન ઓશન ટેરિટરી	ବ୍ରିଟିଶ ଇନ୍ଡିଯନ ଓଶନ ଟେରିଟରୀ
ઇરાક	ଇରାକ
ઈરાન	ଈରାନ
આઇસલેન્ડ	ଆଇସଲେନ୍ଡ
ઇટાલી	ଇଟାଲୀ
જર્સી	ଜର୍ସୀ
જમૈકા	ଜମୈକା
જોર્ડન	ଜୋର୍ଡନ
જાપાન	ଜାପାନ
કેન્યા	କେନ୍ଯା
કિર્ગિઝ્સ્તાન	କିର୍ଗିଝ୍ସ୍ତାନ
કંબોડિયા	କଂବୋଡିଯା
કિરિબાટી	କିରିବାଟୀ
કોમોરસ	କୋମୋରସ
સેન્ટ કિટ્સ અને નેવિસ	ସେନ୍ଟ କିଟ୍ସ ଅନେ ନେଵିସ
ઉત્તર કોરિયા	ଉତ୍ତର କୋରିଯା
દક્ષિણ કોરિયા	ଦକ୍ଷିଣ କୋରିଯା
કુવૈત	କୁଵୈତ
કેમેન ટાપુઓ	କେମେନ ଟାପୁଓ
કઝાકિસ્તાન	କଝାକିସ୍ତାନ
લાઓસ	ଲାଓସ
લેબનોન	ଲେବନୋନ
સેન્ટ લુસિયા	ସେନ୍ଟ ଲୁସିଯା
લૈચટેંસ્ટેઇન	ଲୈଚଟେଂସ୍ଟେଇନ
શ્રીલંકા	ଶ୍ରୀଲଂକା
લાઇબેરિયા	ଲାଇବେରିଯା
લેસોથો	ଲେସୋଥୋ
લિથુઆનિયા	ଲିଥୁଆନିଯା
લક્ઝમબર્ગ	ଲକ୍ଝମବର୍ଗ
લાત્વિયા	ଲାତ୍ଵିଯା
લિબિયા	ଲିବିଯା
મોરોક્કો	ମୋରୋକ୍କୋ
મોનાકો	ମୋନାକୋ
મોલડોવા	ମୋଲଡୋଵା
મૉન્ટેંનેગ્રો	ମୋନ୍ଟେଂନେଗ୍ରୋ
સેન્ટ માર્ટિન	ସେନ୍ଟ ମାର୍ଟିନ
મેડાગાસ્કર	ମେଡାଗାସ୍କର
માર્શલ આઇલેન્ડ્સ	ମାର୍ଶଲ ଆଇଲେନ୍ଡ୍ସ
મેસેડોનિયા	ମେସେଡୋନିଯା
મેસેડોનિયા (FYROM)	ମେସେଡୋନିଯା (FYROM)
માલી	ମାଲୀ
મ્યાંમાર (બર્મા)	ମ୍ଯାଂମାର (ବର୍ମା)
મંગોલિયા	ମଂଗୋଲିଯା
મકાઉ SAR ચીન	ମକାଉ SAR ଚୀନ
મકાઉ	ମକାଉ
ઉત્તરીય મારિયાના આઇલેન્ડ્સ	ଉତ୍ତରୀଯ ମାରିଯାନା ଆଇଲେନ୍ଡ୍ସ
માર્ટીનીક	ମାର୍ଟୀନୀକ
મૌરિટાનિયા	ମୌରିଟାନିଯା
મોંટસેરાત	ମୋଂଟସେରାତ
માલ્ટા	ମାଲ୍ଟା
મોરિશિયસ	ମୋରିଶିଯସ
માલદિવ્સ	ମାଲଦିଵ୍ସ
માલાવી	ମାଲାଵୀ
મેક્સિકો	ମେକ୍ସିକୋ
મલેશિયા	ମଲେଶିଯା
મોઝામ્બિક	ମୋଝାମ୍ବିକ
નામિબિયા	ନାମିବିଯା
ન્યુ સેલેડોનિયા	ନ୍ଯୁ ସେଲେଡୋନିଯା
નાઇજર	ନାଇଜର
નોરફૉક ટાપુ	ନୋରଫୋକ ଟାପୁ
નાઇજીરીયા	ନାଇଜୀରୀଯା
નિકારાગુઆ	ନିକାରାଗୁଆ
નેધરલેન્ડ	ନେଧରଲେନ୍ଡ
નૉર્વે	ନୋର୍ଵେ
નેપાળ	ନେପାଳ
નૌરુ	ନୌରୁ
નીયુ	ନୀଯୁ
ન્યુઝીલેન્ડ	ନ୍ଯୁଝୀଲେନ୍ଡ
ઓમાન	ଓମାନ
પનામા	ପନାମା
પેરુ	ପେରୁ
ફ્રેંચ પોલિનેશિયા	ଫ୍ରେଂଚ ପୋଲିନେଶିଯା
પાપુઆ ન્યૂ ગિની	ପାପୁଆ ନ୍ଯୂ ଗିନୀ
ફિલીપાઇન્સ	ଫିଲୀପାଇନ୍ସ
પાકિસ્તાન	ପାକିସ୍ତାନ
પોલેંડ	ପୋଲେଂଡ
સેન્ટ પિયર અને મીક્વેલન	ସେନ୍ଟ ପିଯର ଅନେ ମୀକ୍ଵେଲନ
પીટકૈર્ન આઇલેન્ડ્સ	ପୀଟକୈର୍ନ ଆଇଲେନ୍ଡ୍ସ
પ્યુઅર્ટો રિકો	ପ୍ଯୁଅର୍ଟୋ ରିକୋ
પેલેસ્ટિનિયન ટેરિટરી	ପେଲେସ୍ଟିନିଯନ ଟେରିଟରୀ
પેલેસ્ટાઇન	ପେଲେସ୍ଟାଇନ
પોર્ટુગલ	ପୋର୍ଟୁଗଲ
પલાઉ	ପଲାଉ
પેરાગ્વે	ପେରାଗ୍ଵେ
કતાર	କତାର
આઉટલાઈન્ગ ઓશનિયા	ଆଉଟଲାଈନ୍ଗ ଓଶନିଯା
રીયુનિયન	ରୀଯୁନିଯନ
રોમાનિયા	ରୋମାନିଯା
સર્બિયા	ସର୍ବିଯା
રશિયા	ରଶିଯା
રવાંડા	ରଵାଂଡା
સાઉદી અરેબિયા	ସାଉଦୀ ଅରେବିଯା
સોલોમન આઇલેન્ડ્સ	ସୋଲୋମନ ଆଇଲେନ୍ଡ୍ସ
સેશેલ્સ	ସେଶେଲ୍ସ
સુદાન	ସୁଦାନ
સ્વીડન	ସ୍ଵୀଡନ
સિંગાપુર	ସିଂଗାପୁର
સેન્ટ હેલેના	ସେନ୍ଟ ହେଲେନା
સ્લોવેનિયા	ସ୍ଲୋଵେନିଯା
સ્વાલબર્ડ અને જેન મેયન	ସ୍ଵାଲବର୍ଡ ଅନେ ଜେନ ମେଯନ
સ્લોવેકિયા	ସ୍ଲୋଵେକିଯା
સીએરા લેઓન	ସୀଏରା ଲେଓନ
સૅન મેરિનો	ସେନ ମେରିନୋ
સેનેગલ	ସେନେଗଲ
સોમાલિયા	ସୋମାଲିଯା
સુરીનામ	ସୁରୀନାମ
દક્ષિણ સુદાન	ଦକ୍ଷିଣ ସୁଦାନ
સાઓ ટૉમ અને પ્રિંસિપે	ସାଓ ଟୋମ ଅନେ ପ୍ରିଂସିପେ
એલ સેલ્વાડોર	ଏଲ ସେଲ୍ଵାଡୋର
સિંટ માર્ટેન	ସିଂଟ ମାର୍ଟେନ
સીરિયા	ସୀରିଯା
સ્વાઝિલેન્ડ	ସ୍ଵାଝିଲେନ୍ଡ
ત્રિસ્તાન દા કુન્હા	ତ୍ରିସ୍ତାନ ଦା କୁନ୍ହା
તુર્ક્સ અને કાઇકોસ ટાપુઓ	ତୁର୍କ୍ସ ଅନେ କାଇକୋସ ଟାପୁଓ
ચાડ	ଚାଡ
ફ્રેંચ સદર્ન ટેરિટરીઝ	ଫ୍ରେଂଚ ସଦର୍ନ ଟେରିଟରୀଝ
ટોગો	ଟୋଗୋ
થાઇલેંડ	ଥାଇଲେଂଡ
તાજીકિસ્તાન	ତାଜୀକିସ୍ତାନ
ટોકેલાઉ	ଟୋକେଲାଉ
તિમોર-લેસ્તે	ତିମୋର-ଲେସ୍ତେ
પૂર્વ તિમોર	ପୂର୍ଵ ତିମୋର
તુર્કમેનિસ્તાન	ତୁର୍କମେନିସ୍ତାନ
ટ્યુનિશિયા	ଟ୍ଯୁନିଶିଯା
ટોંગા	ଟୋଂଗା
તુર્કી	ତୁର୍କୀ
ટ્રિનીદાદ અને ટોબેગો	ଟ୍ରିନୀଦାଦ ଅନେ ଟୋବେଗୋ
તુવાલુ	ତୁଵାଲୁ
તાઇવાન	ତାଇଵାନ
તાંઝાનિયા	ତାଂଝାନିଯା
યુક્રેન	ଯୁକ୍ରେନ
યુગાંડા	ଯୁଗାଂଡା
સંયુક્ત રાજ્ય આઉટલાઇંગ આયલેન્ડ્સ	ସଂଯୁକ୍ତ ରାଜ୍ଯ ଆଉଟଲାଇଂଗ ଆଯଲେନ୍ଡ୍ସ
સંયુકત રાજ્ય અમેરિકા	ସଂଯୁକତ ରାଜ୍ଯ ଅମେରିକା
ઉરુગ્વે	ଉରୁଗ୍ଵେ
ઉઝ્બેકિસ્તાન	ଉଝ୍ବେକିସ୍ତାନ
વેટિકન સિટી	ଵେଟିକନ ସିଟୀ
સેન્ટ વિન્સેટ અને ગ્રેનેડીન્સ	ସେନ୍ଟ ଵିନ୍ସେଟ ଅନେ ଗ୍ରେନେଡୀନ୍ସ
વેનેઝુએલા	ଵେନେଝୁଏଲା
બ્રિટિશ વર્જિન ટાપુઓ	ବ୍ରିଟିଶ ଵର୍ଜିନ ଟାପୁଓ
વિયેતનામ	ଵିଯେତନାମ
વાનુઆતુ	ଵାନୁଆତୁ
વેલીસ અને ફ્યુટુના	ଵେଲୀସ ଅନେ ଫ୍ଯୁଟୁନା
સમોઆ	ସମୋଆ
કોસોવો	କୋସୋଵୋ
યેમેન	ଯେମେନ
મેયોટ	ମେଯୋଟ
દક્ષિણ આફ્રિકા	ଦକ୍ଷିଣ ଆଫ୍ରିକା
ઝામ્બિયા	ଝାମ୍ବିଯା
ઝિમ્બાબ્વે	ଝିମ୍ବାବ୍ଵେ
અજ્ઞાત પ્રદેશ	ଅଜ୍ଞାତ ପ୍ରଦେଶ
