# Baby names
అకుతీ	அகுதீ
అక్సిథీ	அக்ஸிதீ
అచలరాజ	அசலராஜ
అచలా	அசலா
అజగంధా	அஜகஂதா
అజాణీ	அஜாணீ
అజియా	அஜியா
అడ్యాత్రయీ	அட்யாத்ரயீ
అదీక్యా	அதீக்யா
అదృశ	அத்ரிஶ
అదేన్య	அதேந்ய
అద్రిక	அத்ரிக
అద్రీపతి	அத்ரீபதி
అధిక్శీఠా	அதிக்ஶீடா
అబిభవా	அபிபவா
అబీశాఈ	அபீஶாஈ
అబేల	அபேல
అబోఇల	அபோஇல
అబ్జా	அப்ஜா
అబ్ధీ	அப்தீ
అబ్బ్య్నాయ్హా	அப்ப்ய்நாய்ஹா
అభయ	அபய
అభయాన	அபயாந
అభిథా	அபிதா
అభిథి	அபிதி
అభినయ	அபிநய
అభినిత	அபிநித
అభినీత	அபிநீத
అభిమంద	அபிமஂத
అభిమానీ	அபிமாநீ
అభిసోకా	அபிஸோகா
అభిహీతా	அபிஹீதா
అభీచంద్ర	அபீசஂத்ர
అభీనాతా	அபீநாதா
అభీశీక్తా	அபீஶீக்தா
అభీసుమత	அபீஸுமத
అభ్జిత	அப்ஜித
అభ్యప్సీత	அப்யப்ஸீத
అలకనందా	அலகநஂதா
అశవ	அஶவ
అశునత	அஶுநத
అశ్నేఇల	அஶ்நேஇல
అహేలీ	அஹேலீ
ఆకర్షక	ஆகர்ஷக
ఆచమన	ஆசமந
ఆతమన	ஆதமந
ఆత్మజ	ஆத்மஜ
ఆత్రయీ	ஆத்ரயீ
ఆదరవ	ஆதரவ
ఆదర్శా	ஆதர்ஶா
ఆదర్శీనీ	ஆதர்ஶீநீ
ఆదీప్తా	ஆதீப்தா
ఆధరిత	ஆதரித
ఆధార	ஆதார
ఆధిరా	ஆதிரா
ఆధిరాఇ	ஆதிராஇ
ఆధ్యా	ஆத்யா
ఆనందీ	ஆநஂதீ
ఆనుష	ஆநுஷ
ఆబీర	ஆபீர
ఆభాస	ஆபாஸ
ఆయనా	ஆயநா
ఆరమాన	ஆரமாந
ఆరాడ్యా	ஆராட்யா
ఆరీవ	ஆரீவ
ఆర్కశ	ஆர்கஶ
ఆర్థీ	ஆர்தீ
ఆలాప	ஆலாப
ఆల్యా	ஆல்யா
ఆవీ	ஆவீ
ఆశిమ	ஆஶிம
ఆస్రీతా	ஆஸ்ரீதா
ఆస్లుంనన	ஆஸ்லுஂநந
ఇందుభూషణ	இஂதுபூஷண
ఇందుమతీ	இஂதுமதீ
ఇందుముఖీ	இஂதுமுகீ
ఇందుశేఖర	இஂதுஶேகர
ఇతిశ్రీ	இதிஶ்ரீ
ఇధా	இதா
ఇధికా	இதிகா
ఇన్గనామ	இந்கநாம
ఇన్దారేశ	இந்தாரேஶ
ఇన్దుదార	இந்துதார
ఇన్దుబాలా	இந்துபாலா
ఇన్ద్రాణీ	இந்த்ராணீ
ఇన్ద్రేశ	இந்த்ரேஶ
ఇయురేశ	இயுரேஶ
ఇలా	இலா
ఇలావేనిల	இலாவேநில
ఇలాశ్పస్తీ	இலாஶ்பஸ்தீ
ఇశానికా	இஶாநிகா
ఇశాన్వీ	இஶாந்வீ
ఇష్య	இஷ்ய
ఇస్లేత	இஸ்லேத
ఈచ్ఛా	ஈச்சா
ఈన్దుస	ஈந்துஸ
ఈశాంత	ஈஶாஂத
ఈశానపుత్ర	ஈஶாநபுத்ர
ఉగ్రేశ	உக்ரேஶ
ఉజవణీ	உஜவணீ
ఉజీత్ర	உஜீத்ர
ఉజేశ	உஜேஶ
ఉజ్జమ	உஜ்ஜம
ఉజ్జవాలా	உஜ்ஜவாலா
ఉత్తల	உத்தல
ఉత్పర	உத்பர
ఉత్విక	உத்விக
ఉత్సర్గ	உத்ஸர்க
ఉత్సుక	உத்ஸுக
ఉదయన	உதயந
ఉదయసూరియాఁ	உதயஸூரியாஂ
ఉదేయ	உதேய
ఉద్వాహనీ	உத்வாஹநீ
ఉధ్గీతా	உத்கீதா
ఉపనయ	உபநய
ఉపాసనా	உபாஸநா
ఉమాంపుత్ర	உமாஂபுத்ர
ఉమికా	உமிகா
ఉలగన	உலகந
ఉల్ముక	உல்முக
ఉషాకిరణ	உஷாகிரண
ఋచా	ரிசா
ఏకంశీ	ஏகஂஶீ
ఏకలవ్య	ஏகலவ்ய
ఏకాంత	ஏகாஂத
ఏకాంతా	ஏகாஂதா
ఏకాంతికా	ஏகாஂதிகா
ఏకాత్మా	ஏகாத்மா
ఏకావలీ	ஏகாவலீ
ఏత్తన	ஏத்தந
ఏనక్షీ	ஏநக்ஷீ
ఏరీన	ஏரீந
ఏలామరణ	ஏலாமரண
ఏలావేన్ధన	ஏலாவேந்தந
ఏలుమలాఈ	ஏலுமலாஈ
ఏవాంశీ	ஏவாஂஶீ
ఏశానికా	ஏஶாநிகா
ఓఇశని	ஓஇஶநி
ఓఈశీ	ஓஈஶீ
ఓజస్వీ	ஓஜஸ்வீ
ఓజస్వీతా	ஓஜஸ்வீதா
ఓజ్జస్వీన	ஓஜ்ஜஸ்வீந
ఓప్పిలమణి	ஓப்பிலமணி
ఓమలా	ஓமலா
ఓమాజా	ஓமாஜா
ఓమేసా	ஓமேஸா
ఓమ్దుత్త	ஓம்துத்த
ఓవీఏ	ஓவீஏ
ఓశమాం	ஓஶமாஂ
ఓహస	ஓஹஸ
కంగనా	கஂகநா
కంజ	கஂஜ
కంధన	கஂதந
కంశ	கஂஶ
కజరీ	கஜரீ
కతకీ	கதகீ
కథీర	கதீர
కథ్యనీ	கத்யநீ
కదంబన	கதஂபந
కదంబీ	கதஂபீ
కనక	கநக
కనాహియా	கநாஹியா
కనిక	கநிக
కనిశ్టా	கநிஶ்டா
కనీషా	கநீஷா
కనుష	கநுஷ
కనైయా	கநையா
కన్కేయా	கந்கேயா
కన్తారవ	கந்தாரவ
కన్నన	கந்நந
కన్హైయా	கந்ஹையா
కపిల	கபில
కమసంతక	கமஸஂதக
కమాన	கமாந
కమాలబంధూ	கமாலபஂதூ
కయాల్వీఝ్హీ	கயால்வீச்ஹீ
కరబీ	கரபீ
కరమజీత	கரமஜீத
కరూణా	கரூணா
కర్ణన	கர்ணந
కర్తవయా	கர்தவயா
కలాఈ	கலாஈ
కలానీతీ	கலாநீதீ
కలోల	கலோல
కల్యాణీ	கல்யாணீ
కవి	கவி
కవీన్ద్ర	கவீந்த்ர
కవీప్రనీతా	கவீப்ரநீதா
కవీయాసరీ	கவீயாஸரீ
కవీరాసన	கவீராஸந
కవీషా	கவீஷா
కశీక	கஶீக
కశ్నీ	கஶ்நீ
కశ్మాంలమ	கஶ்மாஂலம
కస్లుంనీరా	கஸ்லுஂநீரா
కహన	கஹந
కహ్లీమాం	கஹ்லீமாஂ
కాంచీ	காஂசீ
కాంతవ	காஂதவ
కాంతా	காஂதா
కాంతామనీ	காஂதாமநீ
కాంతి	காஂதி
కాకలీ	காகலீ
కాక్షీ	காக்ஷீ
కాన్జీరా	காந்ஜீரா
కామేరీనా	காமேரீநா
కారుం	காருஂ
కార్తికేయన	கார்திகேயந
కార్నిక	கார்நிக
కాలిందీ	காலிஂதீ
కాలిత	காலித
కాలిదాస	காலிதாஸ
కాలీ	காலீ
కాలీదాస	காலீதாஸ
కావ్యరజ్సింహ	காவ்யரஜ்ஸிஂஹ
కావ్యా	காவ்யா
కాసనీ	காஸநீ
కిరాత	கிராத
కేంగా	கேஂகா
కేఈశా	கேஈஶா
కేతక	கேதக
కేతవ	கேதவ
కేతాఘనీ	கேதாகநீ
కేనాలీ	கேநாலீ
కేనీత	கேநீத
కేనీల	கேநீல
కేల్వీన	கேல்வீந
కేవ్లీనా	கேவ்லீநா
కేసరీనందన	கேஸரீநஂதந
కేసవ	கேஸவ
కేసవారాజ	கேஸவாராஜ
కైతవ	கைதவ
కైశిక	கைஶிக
కౌర్వాకీ	கௌர்வாகீ
ఖగేశ	ககேஶ
ఖాజిత	காஜித
ఖానామ	காநாம
ఖామారీ	காமாரீ
ఖాశ్వీ	காஶ்வீ
ఖుశీకా	குஶீகா
ఖుశ్మీతా	குஶ்மீதா
ఖైలాశ	கைலாஶ
గంగవార	கஂகவார
గంగోల	கஂகோல
గందిరా	கஂதிரா
గంధారా	கஂதாரா
గగనాసరీ	ககநாஸரீ
గగ్నేశ	கக்நேஶ
గజగామినీ	கஜகாமிநீ
గజరా	கஜரா
గజలక్ష్మీ	கஜலக்ஷ்மீ
గజానన	கஜாநந
గతితా	கதிதா
గత్రికా	கத்ரிகா
గదీన	கதீந
గధాధర	கதாதர
గన్గసీరువన	கந்கஸீருவந
గరిష్ట	கரிஷ்ட
గరుల	கருல
గర్గ	கர்க
గాథా	காதா
గాయక	காயக
గిరీ	கிரீ
గీతా సుహానీ	கீதா ஸுஹாநீ
గీరీచంద్ర	கீரீசஂத்ர
గీరీనాథ	கீரீநாத
గీర్వేన	கீர்வேந
గీశుం	கீஶுஂ
గుదాకేశ	குதாகேஶ
గునవంత	குநவஂத
గునాలన	குநாலந
గునితా	குநிதா
గురశరణ	குரஶரண
గురురాజా	குருராஜா
గృహ్యా	க்ரிஹ்யா
గేహనా	கேஹநா
గోఉరబ	கோஉரப
గోకుల	கோகுல
గోదావరీ	கோதாவரீ
గోపాల	கோபால
గోపీ	கோபீ
గోబీకా	கோபீகா
గోమాంథీ	கோமாஂதீ
గోరల	கோரல
గోవీనేశ	கோவீநேஶ
గోవీన్దారాజ	கோவீந்தாராஜ
గోశీతా	கோஶீதா
గౌరీ	கௌரீ
గ్నాపీకా	க்நாபீகா
గ్రంథిక	க்ரஂதிக
గ్రహిత	க்ரஹித
గ్రీతిక	க்ரீதிக
ఘటా	கடா
ఘనావీ	கநாவீ
ఘోరరుపా	கோரருபா
ఘోశీనీ	கோஶீநீ
ఘోషా	கோஷா
ఘ్యాన	க்யாந
చందక	சஂதக
చందనా లక్ష్మీ	சஂதநா லக்ஷ்மீ
చంద్రకలా	சஂத்ரகலா
చంద్రకాంత	சஂத்ரகாஂத
చంద్రకిశోర	சஂத்ரகிஶோர
చంద్రమాం	சஂத்ரமாஂ
చంద్రమౌలీ	சஂத்ரமௌலீ
చంద్రలేక్షా	சஂத்ரலேக்ஷா
చంద్రహాస	சஂத்ரஹாஸ
చంద్రాయణ	சஂத்ராயண
చక్రిక	சக்ரிக
చక్రికా	சக்ரிகா
చక్రియా	சக்ரியா
చక్షస	சக்ஷஸ
చన్ద్రకేతు	சந்த்ரகேது
చన్ద్రజ్యోతీ	சந்த்ரஜ்யோதீ
చన్నాప్పా	சந்நாப்பா
చరణ  రాజ	சரண  ராஜ
చరణరజ	சரணரஜ
చరీథా	சரீதா
చరులా	சருலா
చరుశీల	சருஶீல
చాతీమాం	சாதீமாஂ
చాతుర్య	சாதுர்ய
చామీనీ	சாமீநீ
చారుతా	சாருதா
చారుహస	சாருஹஸ
చారుహాస	சாருஹாஸ
చాశ్ముమ	சாஶ்மும
చాహనా	சாஹநா
చింతక	சிஂதக
చింతా	சிஂதா
చిత్తప్రసాద	சித்தப்ரஸாத
చిత్రంశీ	சித்ரஂஶீ
చిత్రఅక్షాం	சித்ரஅக்ஷாஂ
చిత్రకూట సమాంశ్రాయా	சித்ரகூட ஸமாஂஶ்ராயா
చిత్రబానా	சித்ரபாநா
చిత్రలేఖా	சித்ரலேகா
చిత్రాంగీ	சித்ராஂகீ
చిత్రాదీప	சித்ராதீப
చిత్రాదేవీ	சித்ராதேவீ
చిత్రీనీ	சித்ரீநீ
చిన్మయానందా	சிந்மயாநஂதா
చిమాయీ	சிமாயீ
చీథాన్యలాథా	சீதாந்யலாதா
చీనీత్య	சீநீத்ய
చీన్నీః	சீந்நீஃ
చీరాన్తానా	சீராந்தாநா
చేతన	சேதந
చేతన్దీప	சேதந்தீப
చేతన్సాఈ	சேதந்ஸாஈ
చేథనా	சேதநா
చేననా	சேநநா
చేరన్రాజ	சேரந்ராஜ
చేరాస్య	சேராஸ்ய
చేష్టా	சேஷ்டா
చైతాలీ	சைதாலீ
చైన	சைந
చైసరణ	சைஸரண
జగజీత	ஜகஜீத
జగతపాల	ஜகதபால
జగనమోహన	ஜகநமோஹந
జగనమోహినీ	ஜகநமோஹிநீ
జగ్రవీ	ஜக்ரவீ
జతన	ஜதந
జతాస్యా	ஜதாஸ்யா
జత్యా	ஜத்யா
జనకనందినీ	ஜநகநஂதிநீ
జనావ	ஜநாவ
జన్మయా	ஜந்மயா
జప్తేశ	ஜப்தேஶ
జమునా	ஜமுநா
జయకిరన	ஜயகிரந
జయప్రభా	ஜயப்ரபா
జయలేన	ஜயலேந
జయాద్రాతా	ஜயாத்ராதா
జయాన్థ్య	ஜயாந்த்ய
జరాసంధా	ஜராஸஂதா
జలధర	ஜலதர
జలస	ஜலஸ
జలార్క	ஜலார்க
జలీతా	ஜலீதா
జవాస	ஜவாஸ
జవాహరీ	ஜவாஹரீ
జశంక	ஜஶஂக
జసల	ஜஸல
జసు	ஜஸு
జసోదా	ஜஸோதா
జస్మీథా	ஜஸ்மீதா
జస్మీథ్యా	ஜஸ்மீத்யா
జస్వందీ	ஜஸ்வஂதீ
జహానవీ	ஜஹாநவீ
జహితా	ஜஹிதா
జహేన్కార	ஜஹேந்கார
జాంసీ	ஜாஂஸீ
జాగృతి	ஜாக்ரிதி
జాగేశ	ஜாகேஶ
జాగ్రతి	ஜாக்ரதி
జాఝీమ	ஜாசீம
జానవీ	ஜாநவீ
జిఅనా	ஜிஅநா
జిగీషా	ஜிகீஷா
జితేన్ద్రియ	ஜிதேந்த்ரிய
జిల్పా	ஜில்பா
జీగాయాంశ	ஜீகாயாஂஶ
జీజీద	ஜீஜீத
జీజేశ	ஜீஜேஶ
జీతాకమ	ஜீதாகம
జీతేశ	ஜீதேஶ
జీనయ	ஜீநய
జీరల	ஜீரல
జీల	ஜீல
జీవజ	ஜீவஜ
జీవానాన్ధామ	ஜீவாநாந்தாம
జీవిథా	ஜீவிதா
జుఈ	ஜுஈ
జూహీ	ஜூஹீ
జేఈనన	ஜேஈநந
జేగన	ஜேகந
జేత్వీక	ஜேத்வீக
జేయాన్ద్రణ	ஜேயாந்த்ரண
జేలక్ష్మీ	ஜேலக்ஷ்மீ
జేశన	ஜேஶந
జేహాన్నాఝ	ஜேஹாந்நாச
జైచంద	ஜைசஂத
జైదిశ	ஜைதிஶ
జైదీశ	ஜைதீஶ
జైదేవ	ஜைதேவ
జైలేణ	ஜைலேண
జ్ఞానవ	ஜ்ஞாநவ
జ్ఞానా	ஜ்ஞாநா
జ్య భగవాన	ஜ்ய பகவாந
జ్యోతిబాలా	ஜ்யோதிபாலா
జ్యోత్సనీ	ஜ்யோத்ஸநீ
జ్హోశీల	ஜ்ஹோஶீல
ఝంకృత	சஂக்ரித
ఝరల	சரல
ఝినూక	சிநூக
ఝియాన	சியாந
ఝేన్శీ	சேந்ஶீ
ఝ్యాననీ	ச்யாநநீ
టీనా	டீநா
ఠాకరశీ	டாகரஶீ
ఠుమకీ	டுமகீ
తంగసామీ	தஂகஸாமீ
తంగామనీ	தஂகாமநீ
తక్షక	தக்ஷக
తనిష	தநிஷ
తనీశా	தநீஶா
తనుం ప్రియా	தநுஂ ப்ரியா
తనుంజాశ్రీ	தநுஂஜாஶ்ரீ
తనుపా	தநுபா
తనుశ్రీ	தநுஶ்ரீ
తన్మయ	தந்மய
తమిరా	தமிரா
తమోఘ్నా	தமோக்நா
తరాశా	தராஶா
తరిత	தரித
తరుణ	தருண
తరునా	தருநா
తరులతా	தருலதா
తరుశ్రీ	தருஶ்ரீ
తర్పనా	தர்பநா
తర్లికా	தர்லிகா
తస్మయ	தஸ்மய
తహేలీ	தஹேலீ
తాక్ష్యా	தாக்ஷ்யா
తానాయ్మీ	தாநாய்மீ
తానికా	தாநிகா
తానీగాఈ	தாநீகாஈ
తానీసకా	தாநீஸகா
తానులీప	தாநுலீப
తానుసియా	தாநுஸியா
తాన్శ్రాయ	தாந்ஶ்ராய
తాప్తీ	தாப்தீ
తామాస్వినీ	தாமாஸ்விநீ
తారకేశ	தாரகேஶ
తారాక్ష	தாராக்ஷ
తారానీసేన	தாராநீஸேந
తారూశ	தாரூஶ
తిమిన	திமிந
తిరు	திரு
తిరుపథీ	திருபதீ
తీననీ	தீநநீ
తీరుమరణ	தீருமரண
తుంష్యతీ	துஂஷ்யதீ
తుక్సా	துக்ஸா
తునావా	துநாவா
తుపమ	துபம
తుర్వీ	துர்வீ
తులసీలతా	துலஸீலதா
తులికా	துலிகா
తులీ	துலீ
తులీనదార	துலீநதார
తుశారా	துஶாரா
తుసరికా	துஸரிகா
తేగవిర	தேகவிர
తేజీ	தேஜீ
తేజేన్ద్ర	தேஜேந்த்ர
తేనుం	தேநுஂ
తేవాన	தேவாந
తోయేశ	தோயேஶ
తోరుం	தோருஂ
తౌతిక	தௌதிக
తౌలీక	தௌலீக
త్రిజగతి	த்ரிஜகதி
త్రినాథ	த்ரிநாத
త్రిలోకేశ	த்ரிலோகேஶ
త్రిలోచనా	த்ரிலோசநா
త్రిశల	த்ரிஶல
త్రిశులినీ	த்ரிஶுலிநீ
త్రిషర	த்ரிஷர
త్రీజోయా	த்ரீஜோயா
త్రీపుర్తి	த்ரீபுர்தி
త్రీయోగ	த்ரீயோக
త్రీవిదా	த்ரீவிதா
త్వరితా	த்வரிதா
థంసీ	தஂஸீ
థయా	தயா
థార్సీన	தார்ஸீந
థీక్శీకా	தீக்ஶீகா
థీనీథా	தீநீதா
థేజల	தேஜல
థ్రీశంఠ	த்ரீஶஂட
దందాపానీ	தஂதாபாநீ
దక్శీన్య	தக்ஶீந்ய
దక్షిత	தக்ஷித
దక్షీణ	தக்ஷீண
దనీలా	தநீலா
దన్యతా	தந்யதா
దయానిధి	தயாநிதி
దరరేన	தரரேந
దరిద్రా ధావ్సీనీ	தரித்ரா தாவ்ஸீநீ
దరిద్రీయానాశీనీ	தரித்ரீயாநாஶீநீ
దర్పిత	தர்பித
దర్మీనీ	தர்மீநீ
దర్మేన్దర	தர்மேந்தர
దర్శనా	தர்ஶநா
దర్శ్వానా	தர்ஶ்வாநா
దలపతి	தலபதி
దలాపథీ	தலாபதீ
దల్శేర	தல்ஶேர
దహా	தஹா
దానాస్వీ	தாநாஸ்வீ
దానీశ	தாநீஶ
దామినీ	தாமிநீ
దారుకా	தாருகா
దిబసరీ	திபஸரீ
దిబ్యా	திப்யா
దివీథా	திவீதா
దిశీతా	திஶீதா
దీక్శీకా	தீக்ஶீகா
దీక్షానా	தீக்ஷாநா
దీపక	தீபக
దీపథీ	தீபதீ
దీపా లక్ష్మీ	தீபா லக்ஷ்மீ
దీపాంశ	தீபாஂஶ
దీపేందు	தீபேஂது
దీప్తిమాన	தீப்திமாந
దేజ	தேஜ
దేబజ్యోతీ	தேபஜ்யோதீ
దేబన్శీ	தேபந்ஶீ
దేబ్ప్రతిమ	தேப்ப்ரதிம
దేబ్ప్రసాద	தேப்ப்ரஸாத
దేయాశీనీ	தேயாஶீநீ
దేవకలీ	தேவகலீ
దేవదత్తా	தேவதத்தா
దేవదర్శన	தேவதர்ஶந
దేవనారాయణ	தேவநாராயண
దేవమతి	தேவமதி
దేవాదార్స	தேவாதார்ஸ
దేవాన్శీ	தேவாந்ஶீ
దేవారహాల్లీ	தேவாரஹால்லீ
దేవారీశీ	தேவாரீஶீ
దేవార్యా	தேவார்யா
దేవాశ్రీ	தேவாஶ்ரீ
దేవాస్మిథా	தேவாஸ்மிதா
దేవినా	தேவிநா
దేవేశీ	தேவேஶீ
దేవేసీ	தேவேஸீ
దేవ్యశీ	தேவ்யஶீ
దేశనీ	தேஶநீ
దేశిక	தேஶிக
దైపాయన	தைபாயந
ధనాశ్రీ	தநாஶ்ரீ
ధనాస్వీ	தநாஸ்வீ
ధనుస	தநுஸ
ధరనీ	தரநீ
ధరమనిష్ఠ	தரமநிஷ்ட
ధరానిశ	தராநிஶ
ధర్మజా	தர்மஜா
ధర్మదాస	தர்மதாஸ
ధర్మదేవ	தர்மதேவ
ధర్శానీ	தர்ஶாநீ
ధర్శీనీ	தர்ஶீநீ
ధర్శీనీకా	தர்ஶீநீகா
ధవల	தவல
ధాన	தாந
ధానశ్రీ	தாநஶ்ரீ
ధానీశ్కా	தாநீஶ்கா
ధామ	தாம
ధామన	தாமந
ధారణా	தாரணா
ధారనా	தாரநா
ధావక	தாவக
ధీక్శీథా	தீக்ஶீதா
ధీయాన	தீயாந
ధీవాశీనీ	தீவாஶீநீ
ధుమావతీ	துமாவதீ
ధూన	தூந
ధృతి	த்ரிதி
ధేయాంశీ	தேயாஂஶீ
ధైర్యశీల	தைர்யஶீல
ధోశీనీ	தோஶீநீ
ధ్రాస్తీ	த்ராஸ்தீ
నంద	நஂத
నందలాల	நஂதலால
నందినీ	நஂதிநீ
నందీఘోష	நஂதீகோஷ
నక్షాత్ర	நக்ஷாத்ர
నగరజన	நகரஜந
నగా మాంల్లేస్వారీ	நகா மாஂல்லேஸ்வாரீ
నచికేతాస	நசிகேதாஸ
నటరాజన	நடராஜந
నభా	நபா
నభాన్యు	நபாந்யு
నభోజ	நபோஜ
నమ్రతా	நம்ரதா
నరేన	நரேந
నరేన్దేర	நரேந்தேர
నర్తానా	நர்தாநா
నర్మద	நர்மத
నర్మదా	நர்மதா
నలినా	நலிநா
నలేశ	நலேஶ
నవకార	நவகார
నవరాజ	நவராஜ
నవితా	நவிதா
నాగదాతా	நாகதாதா
నాగనాథ	நாகநாத
నాగరాజు	நாகராஜு
నాగేశ్వర	நாகேஶ்வர
నాతాభైరవీ	நாதாபைரவீ
నాతేసన	நாதேஸந
నాధీనీ	நாதீநீ
నాన్నాన	நாந்நாந
నామదేవ	நாமதேவ
నామాంనారాయనీ	நாமாஂநாராயநீ
నామాంశీ	நாமாஂஶீ
నామీశా	நாமீஶா
నారన	நாரந
నారాయన	நாராயந
నారీనే	நாரீநே
నావేతా	நாவேதா
నాహర	நாஹர
నికేతా	நிகேதா
నిఖార	நிகார
నిఖాల	நிகால
నితల	நிதல
నిదాన	நிதாந
నిధ్యానా	நித்யாநா
నినాద	நிநாத
నిమల	நிமல
నిమేశ	நிமேஶ
నిరంజనీ	நிரஂஜநீ
నిరాంత	நிராஂத
నిరాధార	நிராதார
నిర్మళా	நிர்மளா
నిలారూనా	நிலாரூநா
నిలావోలీ	நிலாவோலீ
నిలీన	நிலீந
నిశ్కా	நிஶ்கா
నిష్ణాం	நிஷ்ணாஂ
నీకశ	நீகஶ
నీకాన్దర్య	நீகாந்தர்ய
నీకాశా	நீகாஶா
నీకుంజా	நீகுஂஜா
నీక్కుం	நீக்குஂ
నీఖేల	நீகேல
నీగీ	நீகீ
నీచికా	நீசிகா
నీధాన	நீதாந
నీనీశా	நீநீஶா
నీపునా	நீபுநா
నీబోధీతా	நீபோதீதா
నీభా	நீபா
నీమ్రిత	நீம்ரித
నీరాలీ	நீராலீ
నీల కాంతా	நீல காஂதா
నీలనీ	நீலநீ
నీలమణి	நீலமணி
నీలాంజనా	நீலாஂஜநா
నీలాబ్జా	நீலாப்ஜா
నీలామ్బరీ	நீலாம்பரீ
నీలేశ	நீலேஶ
నీవ	நீவ
నీశ్రుతా	நீஶ்ருதா
నీసమాం	நீஸமாஂ
నీహన	நீஹந
నేదుమాన	நேதுமாந
నేమీ	நேமீ
నేమీశా	நேமீஶா
నైంశీ	நைஂஶீ
నైజా	நைஜா
నైమాథ	நைமாத
నైషా	நைஷா
పంచావక్త్ర	பஂசாவக்த்ர
పంధారీ	பஂதாரீ
పద్మనాభ	பத்மநாப
పద్మనాభా	பத்மநாபா
పద్మరేఖా	பத்மரேகா
పద్మల	பத்மல
పద్మలోచన	பத்மலோசந
పద్మాంనాభాన	பத்மாஂநாபாந
పద్మాంనేత్ర	பத்மாஂநேத்ர
పద్మాకలీ	பத்மாகலீ
పద్మాక్షీ	பத்மாக்ஷீ
పద్మామ	பத்மாம
పద్మారాజ	பத்மாராஜ
పనితా	பநிதா
పన్కీల	பந்கீல
పన్కోజ	பந்கோஜ
పన్యశ్రీ	பந்யஶ்ரீ
పమ్బా	பம்பா
పరణావీ	பரணாவீ
పరబ్రహ్మనా	பரப்ரஹ்மநா
పరమ-హంస	பரம-ஹஂஸ
పరమేశ్వరీ	பரமேஶ்வரீ
పరసమే	பரஸமே
పరాగ	பராக
పరాన్జయ	பராந்ஜய
పరామితా	பராமிதா
పరిణీతా	பரிணீதா
పరీశుధ	பரீஶுத
పరు	பரு
పరుశీ	பருஶீ
పర్తిక	பர்திக
పర్వతీప్రిత	பர்வதீப்ரித
పలానీచామ్య	பலாநீசாம்ய
పలాశకుసూమ	பலாஶகுஸூம
పల్లవిత	பல்லவித
పళవా	பளவா
పవనసుత	பவநஸுத
పవీథా	பவீதா
పవీన	பவீந
పవీశ	பவீஶ
పవీశీకా	பவீஶீகா
పాండురంగ	பாஂடுரஂக
పాగలావన	பாகலாவந
పాటవ	பாடவ
పాణినీ	பாணிநீ
పానీక	பாநீக
పాయోధర	பாயோதர
పారమితా	பாரமிதா
పారవాథీ	பாரவாதீ
పారిజాత	பாரிஜாத
పార్థే	பார்தே
పావకీ	பாவகீ
పావలీన	பாவலீந
పావానా	பாவாநா
పింగా	பிஂகா
పినాకిన	பிநாகிந
పీఅల్లీ	பீஅல்லீ
పీయుశా	பீயுஶா
పీరనీథా	பீரநீதா
పీహూ	பீஹூ
పూజా	பூஜா
పూజిత	பூஜித
పూనిశ	பூநிஶ
పూర్వికా	பூர்விகா
పూర్వీ	பூர்வீ
పేమల	பேமல
పోంనన	போஂநந
పోగులా	போகுலா
పోన్మాంలా	போந்மாஂலா
పోరోమాం	போரோமாஂ
పౌలోమీ	பௌலோமீ
ప్రకారనా	ப்ரகாரநா
ప్రగ్నీకా	ப்ரக்நீகா
ప్రచీతా	ப்ரசீதா
ప్రనాయా	ப்ரநாயா
ప్రనావ్యా	ப்ரநாவ்யா
ప్రబంజన	ப்ரபஂஜந
ప్రబకరణ	ப்ரபகரண
ప్రభావ	ப்ரபாவ
ప్రమ్లాతా	ப்ரம்லாதா
ప్రహాసా	ப்ரஹாஸா
ప్రాగీ	ப்ராகீ
ప్రాచికా	ப்ராசிகா
ప్రాణ	ப்ராண
ప్రానక	ப்ராநக
ప్రానల	ப்ராநல
ప్రాశా	ப்ராஶா
ఫనిన్ద్రనాథ	பநிந்த்ரநாத
ఫాల్గున	பால்குந
ఫాల్గునీ	பால்குநீ
ఫాల్యా	பால்யா
ఫుతికా	புதிகா
ఫూలమాలా	பூலமாலா
ఫూలేందు	பூலேஂது
ఫేనిల	பேநில
బటుక	படுக
బద్రీ	பத்ரீ
బద్రీనాథ	பத்ரீநாத
బనవారీ	பநவாரீ
బన్శిక	பந்ஶிக
బన్హీ	பந்ஹீ
బబితా	பபிதா
బరన	பரந
బరసాత	பரஸாத
బరిద	பரித
బరున	பருந
బలదేవ	பலதேவ
బలప్రదా	பலப்ரதா
బలరామ	பலராம
బలవీర	பலவீர
బల్మానీ	பல்மாநீ
బవిశ్యా	பவிஶ்யா
బాంకేబిహారీ	பாஂகேபிஹாரீ
బాంసురీ	பாஂஸுரீ
బాల కృష్ణ	பால க்ரிஷ்ண
బాలక్రిష్నా	பாலக்ரிஷ்நா
బాలా	பாலா
బాలారాజ	பாலாராஜ
బాలారామ	பாலாராம
బాలాశంకర	பாலாஶஂகர
బాళ గణపతి	பாள கணபதி
బావరీ	பாவரீ
బావీన	பாவீந
బిందియా	பிஂதியா
బినీతా	பிநீதா
బిమల	பிமல
బిమలా	பிமலா
బిల్వా	பில்வா
బీనాతా	பீநாதா
బీన్కాల	பீந்கால
బీన్దేశ్వర	பீந்தேஶ்வர
బీన్నీకేర	பீந்நீகேர
బీప్రా	பீப்ரா
బీసలతా	பீஸலதா
బుధీప్రియా	புதீப்ரியா
బేకురీ	பேகுரீ
బేథినా	பேதிநா
బేలావార్ధానా	பேலாவார்தாநா
బ్రహ్మావతీ	ப்ரஹ்மாவதீ
బ్రీన్ధా	ப்ரீந்தா
భక్తావాత్సలా	பக்தாவாத்ஸலா
భక్తి	பக்தி
భగదిత్య	பகதித்ய
భద్రీశా	பத்ரீஶா
భవాద	பவாத
భవ్య శ్రీ	பவ்ய ஶ்ரீ
భాగవాథ్య	பாகவாத்ய
భాగేశ	பாகேஶ
భాగ్యా	பாக்யா
భానీశ	பாநீஶ
భాన్ధవీ	பாந்தவீ
భాలేంద్ర	பாலேஂத்ர
భావ	பாவ
భావిన	பாவிந
భావేశ్వారీ	பாவேஶ்வாரீ
భావ్నీశ	பாவ்நீஶ
భావ్యశ్రీ	பாவ்யஶ்ரீ
భాశ్వీనీ	பாஶ்வீநீ
భాస్వన	பாஸ்வந
భాస్వాథ	பாஸ்வாத
భిమేశ	பிமேஶ
భీఖీ	பீகீ
భీమా	பீமா
భీలానగనా	பீலாநகநா
భీష్మ	பீஷ்ம
భువనేశ్వరీ	புவநேஶ்வரீ
భువన్పతీ	புவந்பதீ
భువేశ	புவேஶ
భూతేశ్వర	பூதேஶ்வர
భూపేన్ద్ర	பூபேந்த்ர
భూమత	பூமத
భూమిక	பூமிக
భూమీజా	பூமீஜா
భోజరాజా	போஜராஜா
భ్రమర	ப்ரமர
భ్రిథీ	ப்ரிதீ
మంగలమూర్తి	மஂகலமூர்தி
మంజుల	மஂஜுல
మంజులా	மஂஜுலா
మందాకినీ	மஂதாகிநீ
మందాక్రాంతా	மஂதாக்ராஂதா
మణిశంకర	மணிஶஂகர
మదిర	மதிர
మదేశ	மதேஶ
మద్వాన	மத்வாந
మధుప	மதுப
మధుపాల	மதுபால
మధురానీ	மதுராநீ
మధులా	மதுலா
మధుశా	மதுஶா
మధుసూదన	மதுஸூதந
మనన	மநந
మనప	மநப
మనమోహన	மநமோஹந
మనస్విన	மநஸ்விந
మనాగోబీనదా	மநாகோபீநதா
మనీమ	மநீம
మనోమయ	மநோமய
మనోహర	மநோஹர
మనోహరణ	மநோஹரண
మన్మాయీ	மந்மாயீ
మన్విత	மந்வித
మన్వీర	மந்வீர
మల్లేశ	மல்லேஶ
మశీనీ	மஶீநீ
మహాయోగీన	மஹாயோகீந
మహారావణమర్దానా	மஹாராவணமர்தாநா
మహాలీన్గమ	மஹாலீந்கம
మహింద్రా	மஹிஂத்ரா
మహీథా	மஹீதா
మహేర	மஹேர
మహేశీ	மஹேஶீ
మహేశ్వర	மஹேஶ்வர
మాంగలీ	மாஂகலீ
మాంగేశ్వారీ	மாஂகேஶ்வாரீ
మాందవ	மாஂதவ
మాంన్గ్గౌర్దీ	மாஂந்க்கௌர்தீ
మాంన్జీరీ	மாஂந்ஜீரீ
మాంన్దారికా	மாஂந்தாரிகா
మాంన్వితా	மாஂந்விதா
మాంరుతాత్మాజా	மாஂருதாத்மாஜா
మాతంగీ	மாதஂகீ
మాతన	மாதந
మాధవిలతా	மாதவிலதா
మాధుకేశ	மாதுகேஶ
మాధుర్య	மாதுர்ய
మానధన	மாநதந
మానీక్యా	மாநீக்யா
మాన్యసరీ	மாந்யஸரீ
మాయుఖీ	மாயுகீ
మారూత	மாரூத
మార్గీన	மார்கீந
మార్తండ	மார்தஂட
మాలారవిలీ	மாலாரவிலீ
మాసమాం	மாஸமாஂ
మీనల	மீநல
మైత్రా	மைத்ரா
మైనాలీ	மைநாலீ
మైనావీ	மைநாவீ
మైరవా	மைரவா
మౌలీశా	மௌலீஶா
యక్ష	யக்ஷ
యజత	யஜத
యజుర్వ	யஜுர்வ
యతావన	யதாவந
యత్నేశ	யத்நேஶ
యదు	யது
యదుక్రిష్నా	யதுக்ரிஷ்நா
యదునందన	யதுநஂதந
యవనా	யவநா
యశవర్ధన	யஶவர்தந
యశికా	யஶிகா
యశ్వీ	யஶ்வீ
యశ్శ్రీ	யஶ்ஶ்ரீ
యాజ్నా	யாஜ்நா
యాతన	யாதந
యాతనా	யாதநா
యాత్నీక	யாத்நீக
యాత్వికా	யாத்விகா
యాదమమాం	யாதமமாஂ
యాదీతా	யாதீதா
యాద్నేశ	யாத்நேஶ
యామికా	யாமிகா
యాశీకా	யாஶீகா
యాసస్వీ	யாஸஸ்வீ
యుంగేన్దర	யுஂகேந்தர
యుగన్తీకా	யுகந்தீகா
యుగా	யுகா
యుగీన	யுகீந
యుధావ	யுதாவ
యుధీష్ఠీర	யுதீஷ்டீர
యుధ్ధ	யுத்த
యుయుత్సు	யுயுத்ஸு
యువతీ	யுவதீ
యువాసరీ	யுவாஸரீ
యుసు	யுஸு
యూరా	யூரா
యేక్షిత	யேக்ஷித
యేఘరాజ	யேகராஜ
యేశాస్వీనీ	யேஶாஸ்வீநீ
యేశ్మిత	யேஶ்மித
యేస్వంఠ	யேஸ்வஂட
యోగధీపా	யோகதீபா
యోగలక్ష్మీ	யோகலக்ஷ்மீ
యోగా	யோகா
యోగాజా	யோகாஜா
యోగానంద	யோகாநஂத
యోగీ	யோகீ
యోగేశ్వర	யோகேஶ்வர
యోగ్నవీ	யோக்நவீ
యోజనా	யோஜநா
యోనితా	யோநிதா
యోనేన్ద్ర	யோநேந்த்ர
యోషిత	யோஷித
యోసనా	யோஸநா
యోహ్శీనీ	யோஹ்ஶீநீ
రంగప్రసాత	ரஂகப்ரஸாத
రంగరాజన	ரஂகராஜந
రంగీత	ரஂகீத
రంజన	ரஂஜந
రంజినీ	ரஂஜிநீ
రంహ	ரஂஹ
రక్త	ரக்த
రక్తకమళ	ரக்தகமள
రక్తీమాం	ரக்தீமாஂ
రక్షాద	ரக்ஷாத
రక్షావనరసంగథీనే	ரக்ஷாவநரஸஂகதீநே
రగవార్శీనీ	ரகவார்ஶீநீ
రగిశ	ரகிஶ
రగునాన్తన	ரகுநாந்தந
రజనీ	ரஜநீ
రజిత	ரஜித
రజినిపతి	ரஜிநிபதி
రజీనీ	ரஜீநீ
రజీబ	ரஜீப
రజోఅబా	ரஜோஅபா
రణబీర	ரணபீர
రతనమ	ரதநம
రత్నాలీ	ரத்நாலீ
రత్నావలీ	ரத்நாவலீ
రత్న్ప్రీయా	ரத்ந்ப்ரீயா
రథనా	ரதநா
రదీతే	ரதீதே
రబేక	ரபேக
రమాంలీన్గమ	ரமாஂலீந்கம
రమాంవితా	ரமாஂவிதா
రమేశ్వరీ	ரமேஶ்வரீ
రర్నా	ரர்நா
రవి కాన్త	ரவி காந்த
రవిజ	ரவிஜ
రవిన్శు	ரவிந்ஶு
రవిశంకర	ரவிஶஂகர
రవిశరణ	ரவிஶரண
రవీకిరణ	ரவீகிரண
రవీచక్ర	ரவீசக்ர
రవీతేజా	ரவீதேஜா
రవీయంకీ	ரவீயஂகீ
రవేన	ரவேந
రశీల	ரஶீல
రశేష	ரஶேஷ
రశ్వంత	ரஶ்வஂத
రసికా	ரஸிகா
రాగ్వీనదార	ராக்வீநதார
రాజ  కిరణ	ராஜ  கிரண
రాజతిలక	ராஜதிலக
రాజనాథ	ராஜநாத
రాజన్య	ராஜந்ய
రాజమ	ராஜம
రాజవంత	ராஜவஂத
రాజసేకరణ	ராஜஸேகரண
రాజహంసా	ராஜஹஂஸா
రాజాథీ	ராஜாதீ
రాజూ	ராஜூ
రాజేంద్రమోహన	ராஜேஂத்ரமோஹந
రాజేశ	ராஜேஶ
రాజ్వార్దన	ராஜ்வார்தந
రాధనా	ராதநா
రాధేయ	ராதேய
రాధ్యా	ராத்யா
రాబేన	ராபேந
రామ  సేవక	ராம  ஸேவக
రామచంద్ర	ராமசஂத்ர
రామదాస	ராமதாஸ
రామనాథ	ராமநாத
రామనారాయణ	ராமநாராயண
రామమోహన	ராமமோஹந
రావణ	ராவண
రావలీ	ராவலீ
రాశిమ	ராஶிம
రాష్పల	ராஷ்பல
రాహనీ	ராஹநீ
రాహుల	ராஹுல
రినీ	ரிநீ
రియా	ரியா
రీఅనా	ரீஅநா
రీతోమాం	ரீதோமாஂ
రీథానా	ரீதாநா
రీథీశా	ரீதீஶா
రీథేకా	ரீதேகா
రీథ్వీ	ரீத்வீ
రీధుశనీ	ரீதுஶநீ
రీపాంశీ	ரீபாஂஶீ
రీశీప్రియా	ரீஶீப்ரியா
రీశుం	ரீஶுஂ
రేఖా	ரேகா
రేచల	ரேசல
రేణు	ரேணு
రేశమ	ரேஶம
రేశ్వింద	ரேஶ்விஂத
రౌశన	ரௌஶந
ర్హియా	ர்ஹியா
ల వేశ	ல வேஶ
లక్షన్య	லக்ஷந்ய
లక్ష్మణ	லக்ஷ்மண
లక్ష్మీదేవీ	லக்ஷ்மீதேவீ
లగాన	லகாந
లజ్జా	லஜ்ஜா
లజ్జాన	லஜ்ஜாந
లతికా	லதிகா
లశీతా	லஶீதா
లాడలీ	லாடலீ
లాథీకా	லாதீகா
లాభా	லாபா
లామ్బోధార	லாம்போதார
లాయక	லாயக
లారా	லாரா
లాలాతక్షా	லாலாதக்ஷா
లావణ్య	லாவண்ய
లావానయ	லாவாநய
లావీత్ర	லாவீத்ர
లావీశ	லாவீஶ
లాస్రీథా	லாஸ்ரீதா
లిబ్నీ	லிப்நீ
లియన	லியந
లీకీలేశ	லீகீலேஶ
లీక్సీథా	லீக்ஸீதா
లీగ	லீக
లీన్సీ	லீந்ஸீ
లీపికా	லீபிகா
లీషణ	லீஷண
లుకేశ	லுகேஶ
లేఈవీనా	லேஈவீநா
లేఖ	லேக
లేఖిత	லேகித
లేథీకా	லேதீகா
లేమార	லேமார
లోఉకిక	லோஉகிக
లోఉక్యీనీ	லோஉக்யீநீ
లోకరంజన	லோகரஂஜந
లోకాపుజ్య	லோகாபுஜ்ய
లోక్యా	லோக்யா
లోమశ	லோமஶ
లోలా	லோலா
లోవ్యమ	லோவ்யம
లోశానా	லோஶாநா
లోహీతాక్ష	லோஹீதாக்ஷ
వంచిత	வஂசித
వంచితా	வஂசிதா
వంశజా	வஂஶஜா
వక్తి	வக்தி
వచన	வசந
వజ్రబాహూ	வஜ்ரபாஹூ
వజ్రాకాయా	வஜ்ராகாயா
వజ్రాజిత	வஜ்ராஜித
వనజా	வநஜா
వనినీ	வநிநீ
వనియా	வநியா
వనీత	வநீத
వన్ధానా	வந்தாநா
వయుజత	வயுஜத
వయ్శీనీ	வய்ஶீநீ
వరదావీనాయకా	வரதாவீநாயகா
వరహీ	வரஹீ
వరిన	வரிந
వరియాస	வரியாஸ
వరునాగురుం	வருநாகுருஂ
వరునాప్రియా	வருநாப்ரியா
వరునేశ	வருநேஶ
వరేణ్య	வரேண்ய
వరేన్ద్ర	வரேந்த்ர
వరేసీఖ	வரேஸீக
వర్చస	வர்சஸ
వర్ణికా	வர்ணிகா
వర్ధమాన	வர்தமாந
వర్ధానీ	வர்தாநீ
వర్నీశా	வர்நீஶா
వర్శనేయా	வர்ஶநேயா
వర్శాల	வர்ஶால
వర్శీద	வர்ஶீத
వర్ష	வர்ஷ
వర్షీత	வர்ஷீத
వర్షేనీ	வர்ஷேநீ
వలాక	வலாக
వశీకరణ	வஶீகரண
వశీతా	வஶீதா
వసవీ	வஸவீ
వసుదేవన	வஸுதேவந
వాకుల	வாகுல
వాచాస్య	வாசாஸ்ய
వాత్సల్య	வாத்ஸல்ய
వాత్సల్రాజ	வாத்ஸல்ராஜ
వాదిశ	வாதிஶ
వానాజక్ష	வாநாஜக்ஷ
వానిఏ	வாநிஏ
వానుం	வாநுஂ
వాన్శుల	வாந்ஶுல
వాన్సీకా	வாந்ஸீகா
వామిల	வாமில
వామీకా	வாமீகா
వామ్నాయీ	வாம்நாயீ
వామ్శీథా	வாம்ஶீதா
వామ్సిధార	வாம்ஸிதார
వాయున	வாயுந
వాయునా	வாயுநா
వారుణీ	வாருணீ
వారునీ	வாருநீ
వాల్లాకీ	வால்லாகீ
వాసన్తీ	வாஸந்தீ
వాసుశ్రీ	வாஸுஶ்ரீ
వాహీలా	வாஹீலா
వికీశా	விகீஶா
విక్నేస్వారీ	விக்நேஸ்வாரீ
విజైతా	விஜைதா
విదీకా	விதீகா
విదుషీ	விதுஷீ
విద్యాలక్ష్మీ	வித்யாலக்ஷ்மீ
వినతి	விநதி
వినాపానీ	விநாபாநீ
వినావాదీనీ	விநாவாதீநீ
విన్ధుజా	விந்துஜா
విభాంశు	விபாஂஶு
విభాత్సుం	விபாத்ஸுஂ
విభావ	விபாவ
విభావాసు	விபாவாஸு
విభిశానా ప్రతీశ్త్తాత్రే	விபிஶாநா ப்ரதீஶ்த்தாத்ரே
విరాజు	விராஜு
విరాస్వామ్య	விராஸ்வாம்ய
విలాసితా	விலாஸிதா
విహారికా	விஹாரிகா
వీక్షా	வீக்ஷா
వీణాధారీ	வீணாதாரீ
వీహా	வீஹா
వేక్శనా	வேக்ஶநா
వేద ఆర్యన	வேத ஆர்யந
వేదవల్లీ	வேதவல்லீ
వేదవ్రతా	வேதவ்ரதா
వేదీష	வேதீஷ
వేనీధర	வேநீதர
వేనుం గోపాల	வேநுஂ கோபால
వేనుమాధవ	வேநுமாதவ
వేన్కాత్రమణ	வேந்காத்ரமண
వేన్కాత్శీవా	வேந்காத்ஶீவா
వేర్నీకా	வேர்நீகா
వైకుంఠ నాథ	வைகுஂட நாத
వైజయీ	வைஜயீ
వైదిక	வைதிக
వైద్యుంత	வைத்யுஂத
వైధవీక	வைதவீக
వైధాఈ	வைதாஈ
వైనావీ	வைநாவீ
శక్తిధార్య	ஶக்திதார்ய
సంకీతా	ஸஂகீதா
సంగత	ஸஂகத
సంగ్రామ	ஸஂக்ராம
సంచాయా	ஸஂசாயா
సంచాలీ	ஸஂசாலீ
సంజన	ஸஂஜந
సంజయా	ஸஂஜயா
సంజితా	ஸஂஜிதா
సంజీతీ	ஸஂஜீதீ
సంజీథా	ஸஂஜீதா
సంతయానీ	ஸஂதயாநீ
సందతా	ஸஂததா
సందీప	ஸஂதீப
సందీపన	ஸஂதீபந
సందీపేన	ஸஂதீபேந
సంబిత	ஸஂபித
సంయోగితా	ஸஂயோகிதா
సంవిధా	ஸஂவிதா
సంహిత	ஸஂஹித
సంహితా	ஸஂஹிதா
సఈ దిపక	ஸஈ திபக
సకలేశ్వర	ஸகலேஶ்வர
సకుంజ	ஸகுஂஜ
సకేశ	ஸகேஶ
సగుణ	ஸகுண
సగునా	ஸகுநா
సచంద్ర	ஸசஂத்ர
సచ్చిత	ஸச்சித
సచ్చిదానందా	ஸச்சிதாநஂதா
సదా	ஸதா
సదా శివమ	ஸதா ஶிவம
సదానంద	ஸதாநஂத
సదాశివ	ஸதாஶிவ
సద్గుణ	ஸத்குண
సనత	ஸநத
సనల	ஸநல
సనాతనా	ஸநாதநா
సనావ్య	ஸநாவ்ய
సనీత	ஸநீத
సన్థీమాంథీ	ஸந்தீமாஂதீ
సన్నిధి	ஸந்நிதி
సపనా దేవీ	ஸபநா தேவீ
సప్తోమీ	ஸப்தோமீ
సబ్రేశ	ஸப்ரேஶ
సమరేందు	ஸமரேஂது
సమర్థ	ஸமர்த
సమవర్త	ஸமவர்த
సమాంర్ధ	ஸமாஂர்த
సమితా	ஸமிதா
సమీన	ஸமீந
సమీరన	ஸமீரந
సమీసా	ஸமீஸா
సముదాయ	ஸமுதாய
సమృద్ధి	ஸம்ரித்தி
సమ్ప్రీతీ	ஸம்ப்ரீதீ
సమ్ప్రీయా	ஸம்ப்ரீயா
సమ్ముద	ஸம்முத
సమ్రీధా	ஸம்ரீதா
సమ్వీథ	ஸம்வீத
సరసతీ	ஸரஸதீ
సరస్వతీ	ஸரஸ்வதீ
సరీగా	ஸரீகா
సర్బానీ	ஸர்பாநீ
సహస్త్రజిత	ஸஹஸ்த்ரஜித
సహ్తోష	ஸஹ்தோஷ
సాఈ కార్తిక	ஸாஈ கார்திக
సాఈ కుమారీ	ஸாஈ குமாரீ
సాఈ జీవధరా	ஸாஈ ஜீவதரா
సాఈ వాణీ	ஸாஈ வாணீ
సాఈ శ్రీ	ஸாஈ ஶ்ரீ
సాకేథా	ஸாகேதா
సాక్షీన	ஸாக்ஷீந
సాత్విక	ஸாத்விக
సాధవ	ஸாதவ
సానందనా	ஸாநஂதநா
సాబరీఏశ	ஸாபரீஏஶ
సామిల	ஸாமில
సాయన	ஸாயந
సారణీ	ஸாரணீ
సాలేనా	ஸாலேநா
సాహస్రాంజలి	ஸாஹஸ்ராஂஜலி
సైచారణ	ஸைசாரண
సైనా	ஸைநா
సైలేశ్వర	ஸைலேஶ்வர
సైశా	ஸைஶா
హంశల	ஹஂஶல
హక్ష	ஹக்ஷ
హటీశ	ஹடீஶ
హనసీకా	ஹநஸீகா
హనార్వీన	ஹநார்வீந
హనిశ	ஹநிஶ
హన్శీతా	ஹந்ஶீதா
హమసాదీపికా	ஹமஸாதீபிகா
హమీర	ஹமீர
హమ్సలేఖా	ஹம்ஸலேகா
హయాగ్రివ	ஹயாக்ரிவ
హయాతీ	ஹயாதீ
హరమ్యా	ஹரம்யா
హరిఅక్సా	ஹரிஅக்ஸா
హరికా	ஹரிகா
హరిగోపాల	ஹரிகோபால
హరిత	ஹரித
హరిదాస	ஹரிதாஸ
హరిన	ஹரிந
హరినా	ஹரிநா
హరినాక్షీ	ஹரிநாக்ஷீ
హరియాన	ஹரியாந
హరిశంకర	ஹரிஶஂகர
హరిహర పుత్ర	ஹரிஹர புத்ர
హరీ నారాయణ	ஹரீ நாராயண
హర్యక్ష	ஹர்யக்ஷ
హర్యాక్షా	ஹர்யாக்ஷா
హర్ష	ஹர்ஷ
హర్షవర్దన	ஹர்ஷவர்தந
హర్షిత	ஹர்ஷித
హర్స్వీతా	ஹர்ஸ்வீதா
హవన	ஹவந
హవీసా	ஹவீஸா
హసీనా	ஹஸீநா
హసుం	ஹஸுஂ
హార్శీనీ	ஹார்ஶீநீ
హావీషా	ஹாவீஷா
హితాంశీ	ஹிதாஂஶீ
హితాంశు	ஹிதாஂஶு
హిన్దవీ	ஹிந்தவீ
హిన్ధావీ	ஹிந்தாவீ
హిమంత రాజ	ஹிமஂத ராஜ
హిమాంవార్శీకా	ஹிமாஂவார்ஶீகா
హిమాంసేఖర	ஹிமாஂஸேகர
హిమాన	ஹிமாந
హిమావత	ஹிமாவத
హిమీశా	ஹிமீஶா
హిరణ	ஹிரண
హిరుధాయా	ஹிருதாயா
హిశేతా	ஹிஶேதா
హీతా	ஹீதா
హీమాంవాథీ	ஹீமாஂவாதீ
హీరకనీ	ஹீரகநீ
హృషీకేశ	ஹ்ரிஷீகேஶ
హేఇఅన	ஹேஇஅந
హేనీల	ஹேநீல
హేమ	ஹேம
హేమ లథా	ஹேம லதா
హేమకాంతా	ஹேமகாஂதா
హేమచంద్రా	ஹேமசஂத்ரா
హేమన	ஹேமந
హేమా	ஹேமா
హేమాంతి	ஹேமாஂதி
హేమీతా	ஹேமீதா
హేమ్నందన	ஹேம்நஂதந
హైమాం	ஹைமாஂ
హోనేయ్షా	ஹோநேய்ஷா
హ్రదయ	ஹ்ரதய
హ్రిదయఆంశు	ஹ்ரிதயஆஂஶு
హ్రీథీకా	ஹ்ரீதீகா
హ్రీయాన	ஹ்ரீயாந
హ్రీశా	ஹ்ரீஶா
హ్రీషిత	ஹ்ரீஷித
#
#
# Territory names from CLDR
ఎసెషన్ దీవి	எஸெஷந் தீவி
అండొర్రా	அஂடொர்ரா
యునైటెడ్ అరబ్ ఎమిరేట్స్	யுநைடெட் அரப் எமிரேட்ஸ்
ఆఫ్ఘనిస్తాన్	ஆப்கநிஸ்தாந்
ఆంటిగ్వా మరియు బార్బుడా	ஆஂடிக்வா மரியு பார்புடா
ఆంగవిల్లా	ஆஂகவில்லா
అల్బేనియా	அல்பேநியா
ఆర్మేనియా	ஆர்மேநியா
అంగోలా	அஂகோலா
అంటార్కటికా	அஂடார்கடிகா
అర్జెంటీనా	அர்ஜெஂடீநா
అమెరికన్ సమోవా	அமெரிகந் ஸமோவா
ఆస్ట్రియా	ஆஸ்ட்ரியா
ఆస్ట్రేలియా	ஆஸ்ட்ரேலியா
అరుబా	அருபா
ఆలేండ్ దీవులు	ஆலேஂட் தீவுலு
అజర్బైజాన్	அஜர்பைஜாந்
బోస్నియా మరియు హెర్జెగొవీనా	போஸ்நியா மரியு ஹெர்ஜெகொவீநா
బార్బడోస్	பார்படோஸ்
బంగ్లాదేశ్	பஂக்லாதேஶ்
బెల్జియం	பெல்ஜியஂ
బుర్కినా ఫాసో	புர்கிநா பாஸோ
బల్గేరియా	பல்கேரியா
బహ్రెయిన్	பஹ்ரெயிந்
బురుండి	புருஂடி
బెనిన్	பெநிந்
సెంట్ బర్తేలెమీ	ஸெஂட் பர்தேலெமீ
బెర్ముడా	பெர்முடா
బ్రూనై	ப்ரூநை
బొలీవియా	பொலீவியா
కరీబియన్ నెదర్లాండ్స్	கரீபியந் நெதர்லாஂட்ஸ்
బ్రెజిల్	ப்ரெஜில்
బహామాస్	பஹாமாஸ்
భూటాన్	பூடாந்
బొవెట్ దీవి	பொவெட் தீவி
బోట్స్వానా	போட்ஸ்வாநா
బెలారస్	பெலாரஸ்
బెలిజ్	பெலிஜ்
కెనడా	கெநடா
కోకోస్ (కీలింగ్) దీవులు	கோகோஸ் (கீலிஂக்) தீவுலு
కాంగో- కిన్షాసా	காஂகோ- கிந்ஷாஸா
కాంగో (DRC)	காஂகோ (DRC)
సెంట్రల్ ఆఫ్రికన్ రిపబ్లిక్	ஸெஂட்ரல் ஆப்ரிகந் ரிபப்லிக்
కాంగో- బ్రాజావిల్లి	காஂகோ- ப்ராஜாவில்லி
కాంగో (రిపబ్లిక్)	காஂகோ (ரிபப்லிக்)
స్విట్జర్లాండ్	ஸ்விட்ஜர்லாஂட்
ఐవరీ కోస్ట్	ஐவரீ கோஸ்ட்
కుక్ దీవులు	குக் தீவுலு
చిలీ	சிலீ
కామెరూన్	காமெரூந்
చైనా	சைநா
కొలంబియా	கொலஂபியா
క్లిప్పర్టన్ దీవి	க்லிப்பர்டந் தீவி
కోస్టా రికా	கோஸ்டா ரிகா
క్యూబా	க்யூபா
కేప్ వెర్డే	கேப் வெர்டே
కురాకవో	குராகவோ
క్రిస్మస్ దీవి	க்ரிஸ்மஸ் தீவி
సైప్రస్	ஸைப்ரஸ்
చెక్ రిపబ్లిక్	செக் ரிபப்லிக்
జర్మనీ	ஜர்மநீ
డియాగో గార్సియా	டியாகோ கார்ஸியா
జిబౌటి	ஜிபௌடி
డెన్మార్క్	டெந்மார்க்
డోమెనిక	டோமெநிக
డొమెనికన్ రిపబ్లిక్	டொமெநிகந் ரிபப்லிக்
అల్జీరియా	அல்ஜீரியா
స్యూటా మరియు మెలిల్లా	ஸ்யூடா மரியு மெலில்லா
ఈక్వడార్	ஈக்வடார்
ఎస్టోనియా	எஸ்டோநியா
ఈజిప్ట్	ஈஜிப்ட்
పడమటి సహారా	படமடி ஸஹாரா
ఎరిట్రియా	எரிட்ரியா
స్పెయిన్	ஸ்பெயிந்
ఇథియోపియా	இதியோபியா
యురోపియన్ యునియన్	யுரோபியந் யுநியந்
ఫిన్లాండ్	பிந்லாஂட்
ఫిజీ	பிஜீ
ఫాక్‌ల్యాండ్ దీవులు	பாக்‌ல்யாஂட் தீவுலு
ఫాక్‌ల్యాండ్ దీవులు (ఇస్లాస్ మాల్వినాస్)	பாக்‌ல்யாஂட் தீவுலு (இஸ்லாஸ் மால்விநாஸ்)
మైక్రోనేశియ	மைக்ரோநேஶிய
ఫారో దీవులు	பாரோ தீவுலு
ఫ్రాన్స్‌	ப்ராந்ஸ்‌
గాబన్	காபந்
యునైటెడ్ కింగ్‌డమ్	யுநைடெட் கிஂக்‌டம்
గ్రెనెడా	க்ரெநெடா
జార్జియా	ஜார்ஜியா
ఫ్రెంచ్ గియానా	ப்ரெஂச் கியாநா
గ్వేర్నసే	க்வேர்நஸே
ఘనా	கநா
జిబ్రాల్టార్	ஜிப்ரால்டார்
గ్రీన్‌లాండ్	க்ரீந்‌லாஂட்
గాంబియా	காஂபியா
గినియా	கிநியா
గ్వాడేలోప్	க்வாடேலோப்
ఈక్వటోరియల్ గినియా	ஈக்வடோரியல் கிநியா
గ్రీస్	க்ரீஸ்
దక్షిణ జార్జియా &amp; దక్షిణ శాండ్విచ్ దీవులు	தக்ஷிண ஜார்ஜியா &amp; தக்ஷிண ஶாஂட்விச் தீவுலு
గ్వాటిమాల	க்வாடிமால
గ్వామ్	க்வாம்
గినియా-బిస్సావ్	கிநியா-பிஸ்ஸாவ்
గయానా	கயாநா
హాంకాంగ్ ఎస్ఏఆర్ చైనా	ஹாஂகாஂக் எஸ்ஏஆர் சைநா
హాంకాంగ్	ஹாஂகாஂக்
హెర్డ్ &amp; మెక్ డొనాల్డ్ దీవులు	ஹெர்ட் &amp; மெக் டொநால்ட் தீவுலு
హోండురాస్	ஹோஂடுராஸ்
క్రోయేషియా	க்ரோயேஷியா
హైటి	ஹைடி
హంగేరీ	ஹஂகேரீ
కేనరీ దీవులు	கேநரீ தீவுலு
ఇండోనేషియా	இஂடோநேஷியா
ఐర్లాండ్	ஐர்லாஂட்
ఇజ్రాయిల్	இஜ்ராயில்
ఐల్ ఆఫ్ మాన్	ஐல் ஆப் மாந்
భారత దేశం	பாரத தேஶஂ
బ్రిటీష్ భారతీయ సముద్రపు ప్రాంతం	ப்ரிடீஷ் பாரதீய ஸமுத்ரபு ப்ராஂதஂ
ఇరాక్	இராக்
ఇరాన్	இராந்
ఐస్లాండ్	ஐஸ்லாஂட்
ఇటలీ	இடலீ
జెర్సీ	ஜெர்ஸீ
జమైకా	ஜமைகா
జోర్డాన్	ஜோர்டாந்
జపాన్	ஜபாந்
కెన్యా	கெந்யா
కిర్గిజిస్తాన్	கிர்கிஜிஸ்தாந்
కంబోడియా	கஂபோடியா
కిరిబాటి	கிரிபாடி
కొమొరోస్	கொமொரோஸ்
సెంట్ కిట్ట్స్ మరియు నెవిస్	ஸெஂட் கிட்ட்ஸ் மரியு நெவிஸ்
ఉత్తర కొరియా	உத்தர கொரியா
దక్షిణ కొరియా	தக்ஷிண கொரியா
కువైట్	குவைட்
కేమాన్ దీవులు	கேமாந் தீவுலு
కజకస్తాన్	கஜகஸ்தாந்
లావోస్	லாவோஸ்
లెబనాన్	லெபநாந்
సెంట్ లూసియా	ஸெஂட் லூஸியா
లిక్టెస్టేన్	லிக்டெஸ்டேந்
శ్రీలంక	ஶ்ரீலஂக
లైబీరియా	லைபீரியா
లెసోతో	லெஸோதோ
లిథువేనియా	லிதுவேநியா
లక్సంబర్గ్	லக்ஸஂபர்க்
లాత్వియా	லாத்வியா
లిబియా	லிபியா
మొరాక్కో	மொராக்கோ
మొనాకో	மொநாகோ
మోల్డోవా	மோல்டோவா
మోంటేనేగ్రో	மோஂடேநேக்ரோ
సెంట్ మార్టిన్	ஸெஂட் மார்டிந்
మడగాస్కర్	மடகாஸ்கர்
మార్షల్ దీవులు	மார்ஷல் தீவுலு
మేసిడోనియా	மேஸிடோநியா
మేసిడోనియా (FYROM)	மேஸிடோநியா (FYROM)
మాలి	மாலி
మయన్మార్ (బర్మా)	மயந்மார் (பர்மா)
మంగోలియా	மஂகோலியா
మాకావ్ ఎస్ఏఆర్ చైనా	மாகாவ் எஸ்ஏஆர் சைநா
మకావు	மகாவு
ఉత్తర మరియానా దీవులు	உத்தர மரியாநா தீவுலு
మార్టినిక్	மார்டிநிக்
మౌరిటేనియా	மௌரிடேநியா
మోంట్సేర్రాట్	மோஂட்ஸேர்ராட்
మాల్టా	மால்டா
మారిషస్	மாரிஷஸ்
మాల్దీవులు	மால்தீவுலு
మాలావి	மாலாவி
మెక్సికో	மெக்ஸிகோ
మలేషియా	மலேஷியா
మొజాంబిక్	மொஜாஂபிக்
నమీబియా	நமீபியா
క్రొత్త కాలెడోనియా	க்ரொத்த காலெடோநியா
నైజర్	நைஜர்
నార్ఫాక్ దీవి	நார்பாக் தீவி
నైజీరియా	நைஜீரியா
నికరాగువా	நிகராகுவா
నెదర్లాండ్స్	நெதர்லாஂட்ஸ்
నార్వే	நார்வே
నేపాల్	நேபால்
నౌరు	நௌரு
నియు	நியு
న్యూజిలాండ్	ந்யூஜிலாஂட்
ఒమన్	ஒமந்
పనామా	பநாமா
పెరూ	பெரூ
ఫ్రెంచ్ పోలినిషియా	ப்ரெஂச் போலிநிஷியா
పాపువా న్యు గినియా	பாபுவா ந்யு கிநியா
ఫిలిప్పీన్స్	பிலிப்பீந்ஸ்
పాకిస్తాన్	பாகிஸ்தாந்
పోలాండ్	போலாஂட்
సెంట్ పియెర్ మరియు మికెలాన్	ஸெஂட் பியெர் மரியு மிகெலாந்
పిట్‌కెయిర్న్ దీవులు	பிட்‌கெயிர்ந் தீவுலு
ఫ్యూర్టో రికో	ப்யூர்டோ ரிகோ
పాలస్తీనియన్ ప్రాంతాలు	பாலஸ்தீநியந் ப்ராஂதாலு
పాలస్తీనా	பாலஸ்தீநா
పోర్చుగల్	போர்சுகல்
పలావు	பலாவு
పరాగ్వే	பராக்வே
కతర్	கதர்
ఒషీనియా బయటున్నవి	ஒஷீநியா பயடுந்நவி
రియూనియన్	ரியூநியந்
రోమానియా	ரோமாநியா
సెర్బియా	ஸெர்பியா
రష్యా	ரஷ்யா
రువాండా	ருவாஂடா
సౌదీ అరేబియా	ஸௌதீ அரேபியா
సోలమన్ దీవులు	ஸோலமந் தீவுலு
సీషెల్స్	ஸீஷெல்ஸ்
సూడాన్	ஸூடாந்
స్వీడన్	ஸ்வீடந்
సింగపూర్	ஸிஂகபூர்
సెంట్ హెలినా	ஸெஂட் ஹெலிநா
స్లోవేనియా	ஸ்லோவேநியா
స్వాల్బార్డ్ మరియు యాన్ మాయేన్	ஸ்வால்பார்ட் மரியு யாந் மாயேந்
స్లోవేకియా	ஸ்லோவேகியா
సియెర్రా లియాన్	ஸியெர்ரா லியாந்
సాన్ మారినో	ஸாந் மாரிநோ
సెనెగల్	ஸெநெகல்
సోమాలియా	ஸோமாலியா
సురినామ్	ஸுரிநாம்
దక్షిణ సూడాన్	தக்ஷிண ஸூடாந்
సావోటోమ్ మరియు ప్రిన్సిపే	ஸாவோடோம் மரியு ப்ரிந்ஸிபே
ఎల్ సాల్వడోర్	எல் ஸால்வடோர்
సింట్ మార్టెన్	ஸிஂட் மார்டெந்
సిరియా	ஸிரியா
స్వాజిల్యాండ్	ஸ்வாஜில்யாஂட்
ట్రిస్టన్ డ కన్హా	ட்ரிஸ்டந் ட கந்ஹா
తుర్క్ మరియు కాలికోస్ దీవులు	துர்க் மரியு காலிகோஸ் தீவுலு
చాద్	சாத்
ఫ్రెంచ్ దక్షిణ ప్రాంతాలు	ப்ரெஂச் தக்ஷிண ப்ராஂதாலு
టోగో	டோகோ
థాయిలాండ్	தாயிலாஂட்
తజికిస్తాన్	தஜிகிஸ்தாந்
టోకేలావ్	டோகேலாவ்
టిమోర్-లెస్టె	டிமோர்-லெஸ்டெ
తూర్పు తైమూర్	தூர்பு தைமூர்
తుర్కమేనిస్తాన్	துர்கமேநிஸ்தாந்
ట్యునీషియా	ட்யுநீஷியா
టోంగా	டோஂகா
టర్కీ	டர்கீ
ట్రినిడాడ్ మరియు టొబాగో	ட்ரிநிடாட் மரியு டொபாகோ
టువాలు	டுவாலு
తైవాన్	தைவாந்
టాంజానియా	டாஂஜாநியா
ఉక్రెయిన్	உக்ரெயிந்
ఉగాండా	உகாஂடா
సంయుక్త రాజ్య అమెరికా బయట ఉన్న దీవులు	ஸஂயுக்த ராஜ்ய அமெரிகா பயட உந்ந தீவுலு
అమెరికా సంయుక్త రాష్ట్రాలు	அமெரிகா ஸஂயுக்த ராஷ்ட்ராலு
ఉరుగువే	உருகுவே
ఉజ్బెకిస్తాన్	உஜ்பெகிஸ்தாந்
వాటికన్ నగరం	வாடிகந் நகரஂ
సెంట్ విన్సెంట్ మరియు గ్రెనడీన్స్	ஸெஂட் விந்ஸெஂட் மரியு க்ரெநடீந்ஸ்
వెనుజువేలా	வெநுஜுவேலா
బ్రిటిష్ వర్జిన్ దీవులు	ப்ரிடிஷ் வர்ஜிந் தீவுலு
వియత్నాం	வியத்நாஂ
వనాటు	வநாடு
వాలిస్ మరియు ఫ్యుత్యునా	வாலிஸ் மரியு ப்யுத்யுநா
సమోవా	ஸமோவா
కొసోవో	கொஸோவோ
యెమెన్	யெமெந்
మాయొట్టి	மாயொட்டி
దక్షిణ ఆఫ్రికా	தக்ஷிண ஆப்ரிகா
జాంబియా	ஜாஂபியா
జింబాబ్వే	ஜிஂபாப்வே
తెలియని ప్రాంతం	தெலியநி ப்ராஂதஂ
