# Baby names
ଅକର୍ଯସୁଟ	அகர்யஸுட
ଅଚଲା	அசலா
ଅଚିଟ୍	அசிட்
ଅଦିତା	அதிதா
ଅଦ୍ବୈଯା	அத்பையா
ଅଫ୍ର	அப்ர
ଅବିଶ	அபிஶ
ଅବ୍ଭିନବ୍	அப்பிநப்
ଅଭିନତ	அபிநத
ଅଭିନିତି	அபிநிதி
ଅଭିପ୍ରିତି	அபிப்ரிதி
ଅଭିମନି	அபிமநி
ଅଭିରତି	அபிரதி
ଅଭିସର୍	அபிஸர்
ଆଅଶ୍ନା	ஆஅஶ்நா
ଆଇଶ୍	ஆஇஶ்
ଆଗନେଯ	ஆகநேய
ଆଗନେୟା	ஆகநேயா
ଆଘନ୍ୟା	ஆகந்யா
ଆଟିଶ୍	ஆடிஶ்
ଆଡିତ୍	ஆடித்
ଆଡ୍ରିଟି	ஆட்ரிடி
ଆତ୍ମିକ	ஆத்மிக
ଆଦବିକା	ஆதபிகா
ଆଦିନାଥ୍	ஆதிநாத்
ଆଧାବ୍	ஆதாப்
ଆନଗଟ୍	ஆநகட்
ଆନନ୍ଦସ୍ବରୁପ୍	ஆநந்தஸ்பருப்
ଆନଶଲ୍	ஆநஶல்
ଆନାଲ୍	ஆநால்
ଆପଟ୍	ஆபட்
ଆମୁକଥା	ஆமுகதா
ଆଯୁ	ஆயு
ଆରଣା	ஆரணா
ଆରଥ୍	ஆரத்
ଆରବ୍	ஆரப்
ଆରଭି	ஆரபி
ଆରିଟ୍	ஆரிட்
ଆରୁନା	ஆருநா
ଆରୁଶା	ஆருஶா
ଆର୍ଥୀ	ஆர்தீ
ଆର୍ନବ୍	ஆர்நப்
ଆରୟାନ୍	ஆரயாந்
ଆରୟାମନ୍	ஆரயாமந்
ଆଲିୟଃ	ஆலியஃ
ଆଶାଲତା	ஆஶாலதா
ଆସ୍ତ	ஆஸ்த
ଆସ୍ମି	ஆஸ்மி
ଇକ୍ଶିତା	இக்ஶிதா
ଇଟନ୍	இடந்
ଇଡିକା	இடிகா
ଇନକନ୍ଟା	இநகந்டா
ଇନିଯବନ୍	இநியபந்
ଇନେଶ୍	இநேஶ்
ଇନ୍ଡରେଶ୍	இந்டரேஶ்
ଇନ୍ଡୁକାନ୍ଟ୍	இந்டுகாந்ட்
ଇନ୍ଡୁଜ୍	இந்டுஜ்
ଇନ୍ଡ୍ରଯନି	இந்ட்ரயநி
ଇପ୍ସିଟା	இப்ஸிடா
ଇବାନ୍କା	இபாந்கா
ଇଭ୍ଯା	இப்யா
ଇମ୍ପାଲ୍	இம்பால்
ଇମ୍ଲା	இம்லா
ଇରାନା	இராநா
ଇରେନ୍ପ୍ରୀଟ୍	இரேந்ப்ரீட்
ଇଲବେନିଲ୍	இலபேநில்
ଇଲିଶା	இலிஶா
ଇଶା କ୍ରିଟିକ୍	இஶா க்ரிடிக்
ଇଶି	இஶி
ଇଶିର୍	இஶிர்
ଇସାଇଅରାସୁ	இஸாஇஅராஸு
ଇସ୍ଶୁ	இஸ்ஶு
ଇହା	இஹா
ଇହାମ୍	இஹாம்
ଈଶାନି	ஈஶாநி
ଉଜାଲା	உஜாலா
ଉଜ୍ଜାନିନି	உஜ்ஜாநிநி
ଉଟନ୍କା	உடந்கா
ଉଟ୍କର୍ଶା	உட்கர்ஶா
ଉଡାନ୍ଟିକା	உடாந்டிகா
ଉଡିଶା	உடிஶா
ଉଡେଯ୍	உடேய்
ଉଡ୍ଡିଶ୍	உட்டிஶ்
ଉଡ୍ଯମ୍	உட்யம்
ଉତାମି	உதாமி
ଉତିରା	உதிரா
ଉନ୍ନତିଶ୍	உந்நதிஶ்
ଉନ୍ନଭ୍	உந்நப்
ଉନ୍ନିକ୍ରିଶ୍ନନ୍	உந்நிக்ரிஶ்நந்
ଉନ୍ମାଇବିଲମ୍ବି	உந்மாஇபிலம்பி
ଉପାନ୍ଶୁ	உபாந்ஶு
ଉପେନ୍ଡ୍ରା	உபேந்ட்ரா
ଉପ୍ଜୀତ୍	உப்ஜீத்
ଉପ୍ମା	உப்மா
ଉମା	உமா
ଉର୍ବଶି	உர்பஶி
ଉର୍ବଶୀ	உர்பஶீ
ଉର୍ବିଶ୍	உர்பிஶ்
ଉଶା ଲକ୍ଶି	உஶா லக்ஶி
ଉଶ୍ନିସିନ୍	உஶ்நிஸிந்
ଉସ୍ରି	உஸ்ரி
ଊର୍ଜିଟ୍	ஊர்ஜிட்
ଏଇରାବଟି	ஏஇராபடி
ଏକଚକ୍ରା	ஏகசக்ரா
ଏକଚନ୍ଡ୍ର	ஏகசந்ட்ர
ଏକଚିତ୍	ஏகசித்
ଏକବିରା	ஏகபிரா
ଏକଲିଙା	ஏகலிஙா
ଏକ୍ଟା	ஏக்டா
ଏକ୍ଲବ୍ଯ	ஏக்லப்ய
ଏଗୈଅରସୁ	ஏகைஅரஸு
ଏଡୋମ୍	ஏடோம்
ଏଦସ୍	ஏதஸ்
ଏରା	ஏரா
ଏଲବେନ୍ଦନ୍	ஏலபேந்தந்
ଏଲିକା	ஏலிகா
ଏଲିଲ୍ବେନ୍ଡନ୍	ஏலில்பேந்டந்
ଏଶଞା	ஏஶஞா
ଏଶନି	ஏஶநி
ଏଶନ୍ଶ୍	ஏஶந்ஶ்
ଏଶ୍ନି	ஏஶ்நி
ଏଶ୍ମା	ஏஶ்மா
ଓଜାସ୍ବୁଇଟା	ஓஜாஸ்புஇடா
ଓଜାସ୍ବୁଇନି	ஓஜாஸ்புஇநி
ଓବିଶ୍କର୍	ஓபிஶ்கர்
ଓମାନା	ஓமாநா
ଓମାର୍ଜୀଟ୍	ஓமார்ஜீட்
ଓମ୍ଜା	ஓம்ஜா
ଓମ୍ଡୁଟ୍ଟ୍	ஓம்டுட்ட்
କଟେଲ୍ଯ୍ନ୍	கடேல்ய்ந்
କନକବଟି	கநகபடி
କନିସା	கநிஸா
କନ୍ଡର୍ପା	கந்டர்பா
କନ୍ନକି	கந்நகி
କନ୍ଶ୍	கந்ஶ்
କନ୍ହୈଯାଲାଲ୍	கந்ஹையாலால்
କପିଲେଶ୍	கபிலேஶ்
କପୀଶ୍	கபீஶ்
କପୀଶ୍ବୁଅର୍	கபீஶ்புஅர்
କବଲ୍	கபல்
କବିତା	கபிதா
କବିନଯା	கபிநயா
କମଲ୍ନଯନ୍	கமல்நயந்
କମେଶ୍ବୁଅର୍	கமேஶ்புஅர்
କମୋଡ୍	கமோட்
କଯଲ୍ବିଲି	கயல்பிலி
କରିଶ୍ମା	கரிஶ்மா
କରୁନାକର୍	கருநாகர்
କରୋନା	கரோநா
କର୍ଟାର୍	கர்டார்
କର୍ତି	கர்தி
କର୍ତୀକ୍	கர்தீக்
କର୍ହିକ୍	கர்ஹிக்
କଲବତି	கலபதி
କଲୈଅରସି	கலைஅரஸி
କଲ୍ପା	கல்பா
କଲ୍ବା	கல்பா
କଶିଶ୍	கஶிஶ்
କଶ୍ମିରା	கஶ்மிரா
କସିଶ୍	கஸிஶ்
କସ୍ନି	கஸ்நி
କସ୍ସମଲି	கஸ்ஸமலி
କହର୍	கஹர்
କହ୍ଲିମା	கஹ்லிமா
କାକଲି	காகலி
କାକୋଲି	காகோலி
କାକ୍ଶା	காக்ஶா
କାଜୋଲ୍	காஜோல்
କାଡନ୍ମ୍ବରି	காடந்ம்பரி
କାନ୍ଟି	காந்டி
କାଲିକା	காலிகா
କାଲିଚରନ୍	காலிசரந்
କାଲିନ୍ଡି	காலிந்டி
କାଲିଯା	காலியா
କାଲିରନ୍ଜନ୍	காலிரந்ஜந்
କୈରବ୍	கைரப்
କୈଲାସ୍	கைலாஸ்
କୌଶିକା	கௌஶிகா
କୌଶ୍ଲେନ୍ଡେର୍	கௌஶ்லேந்டேர்
ଗଙାଡଟ୍ଟ୍	கஙாடட்ட்
ଗଙେଶ୍	கஙேஶ்
ଗଜନନ	கஜநந
ଗଜାନନ୍ଡ୍	கஜாநந்ட்
ଗଜ୍ରୁପ୍	கஜ்ருப்
ଗନଦ୍ଯକ୍ଶିନା	கநத்யக்ஶிநா
ଗନରାଜ୍	கநராஜ்
ଗମ୍ଭିର୍	கம்பிர்
ଗରିଶିଟ୍	கரிஶிட்
ଗରିଶ୍ଟ୍	கரிஶ்ட்
ଗରୁଡ୍	கருட்
ଗାର୍ଗୀ	கார்கீ
ଗିଟାନ୍ଜଲି	கிடாந்ஜலி
ଗିଟିକା	கிடிகா
ଗିବ୍ସୋନ୍	கிப்ஸோந்
ଗିରିଜନନ୍ଡନ୍	கிரிஜநந்டந்
ଗିରିଶରନ୍	கிரிஶரந்
ଗୀଟାନ୍ଜଲି	கீடாந்ஜலி
ଗୀଟାସ୍ରି	கீடாஸ்ரி
ଗୀତିକା	கீதிகா
ଗୁନସେକରନ୍	குநஸேகரந்
ଗୁନିତା	குநிதா
ଗୁଫାମ୍	குபாம்
ଗୁରୁ	குரு
ଗୁରୁ ଗୁଗନ୍	குரு குகந்
ଗୁରୁସାରନ୍	குருஸாரந்
ଗେଯା	கேயா
ଗୋଉରଙି	கோஉரஙி
ଗୋଟମ୍	கோடம்
ଗୋଡବରି	கோடபரி
ଗୋପାଲ୍	கோபால்
ଗୋପିନାତନ୍	கோபிநாதந்
ଗୋପୁ	கோபு
ଗୋବିଲ୍	கோபில்
ଗୋରଖ୍	கோரக்
ଗୋଲୋଚନ୍	கோலோசந்
ଗୌରଂଗୀ	கௌரஂகீ
ଗ୍ନନଲିଆ	க்நநலிஆ
ଗ୍ଯାନା	க்யாநா
ଗ୍ରହିଲ୍	க்ரஹில்
ଗ୍ରିତେଶ୍	க்ரிதேஶ்
ଘନମଲିକା	கநமலிகா
ଘନଲିଙା	கநலிஙா
ଘୁଲିକା	குலிகா
ଚଟୁର୍ଭୁଜା	சடுர்புஜா
ଚଟୁର୍ଭୁଜ୍	சடுர்புஜ்
ଚନ୍ଚଲା	சந்சலா
ଚନ୍ଡା ବର୍ମନ୍	சந்டா பர்மந்
ଚନ୍ଡେର୍	சந்டேர்
ଚନ୍ଡ୍ରକାନ୍ଟା	சந்ட்ரகாந்டா
ଚନ୍ଡ୍ରକିର୍ତି	சந்ட்ரகிர்தி
ଚନ୍ଡ୍ରଡିଟ୍ଯା	சந்ட்ரடிட்யா
ଚନ୍ଡ୍ରନାତ୍	சந்ட்ரநாத்
ଚନ୍ଡ୍ରପ୍ରକାଶ୍	சந்ட்ரப்ரகாஶ்
ଚନ୍ଡ୍ରବାତି	சந்ட்ரபாதி
ଚନ୍ଡ୍ରମୋଉଲି	சந்ட்ரமோஉலி
ଚନ୍ଡ୍ରଲେଖା	சந்ட்ரலேகா
ଚନ୍ଡ୍ରସହୋଡରି	சந்ட்ரஸஹோடரி
ଚନ୍ଡ୍ରାକିରନ୍	சந்ட்ராகிரந்
ଚନ୍ଡ୍ରେଯୀ	சந்ட்ரேயீ
ଚନ୍ଡ୍ର୍ପୀଡ୍	சந்ட்ர்பீட்
ଚମ୍ପା	சம்பா
ଚମ୍ପିକା	சம்பிகா
ଚରନ୍ଜୀଟ୍	சரந்ஜீட்
ଚରନ୍ଡେବ୍	சரந்டேப்
ଚରିଟା	சரிடா
ଚରୁପ୍ରଭା	சருப்ரபா
ଚରୁଲେଖା	சருலேகா
ଚରୁଶିଲା	சருஶிலா
ଚାଯା	சாயா
ଚିଟ୍ରିଟା	சிட்ரிடா
ଚିଡକଶ୍	சிடகஶ்
ଚିଡାନନ୍ଡ୍	சிடாநந்ட்
ଚିତ୍ରା	சித்ரா
ଚିନ୍କଲ୍	சிந்கல்
ଚିନ୍ଟନା	சிந்டநா
ଚିନ୍ଟନିକା	சிந்டநிகா
ଚିନ୍ଟଲ୍	சிந்டல்
ଚିନ୍ମଯୁ	சிந்மயு
ଚିରନ୍ଜିବ୍	சிரந்ஜிப்
ଚିରନ୍ଜୀବି	சிரந்ஜீபி
ଚିରୁ	சிரு
ଚୁଟ୍କି	சுட்கி
ଚେଟକ୍	சேடக்
ଚେନ୍ନା	சேந்நா
ଚେମ୍ମଲ୍	சேம்மல்
ଚେରିତ୍	சேரித்
ଚେଲନ୍	சேலந்
ଚେଲିଯନ୍	சேலியந்
ଚେଲୁବା	சேலுபா
ଚୈଟ୍ରା	சைட்ரா
ଚୈନ୍	சைந்
ଚୋଲାନ୍	சோலாந்
ଚ୍ହଯାନ୍କ୍	ச்ஹயாந்க்
ଜଗଟି	ஜகடி
ଜଗଟ୍ଗୁରୁ	ஜகட்குரு
ଜଗଡମ୍ବିକା	ஜகடம்பிகா
ଜଗଡ୍ବନ୍ଡୁ	ஜகட்பந்டு
ଜଗନ୍ନାତନ୍	ஜகந்நாதந்
ଜଗନ୍ମଯୀ	ஜகந்மயீ
ଜଗ୍ଜିବନ୍	ஜக்ஜிபந்
ଜଗ୍ଜୀବନ୍	ஜக்ஜீபந்
ଜନକିଭୁଶନ୍	ஜநகிபுஶந்
ଜନଦର୍ନ୍	ஜநதர்ந்
ଜନାନି	ஜநாநி
ଜନାର୍ଦନା	ஜநார்தநா
ଜମୁନା	ஜமுநா
ଜଯ ପ୍ରଟୀକ୍	ஜய ப்ரடீக்
ଜଯ ପ୍ରିଯା	ஜய ப்ரியா
ଜଯପୋର୍ନା	ஜயபோர்நா
ଜଯସ୍ରି	ஜயஸ்ரி
ଜଯାନନ୍ଡ୍	ஜயாநந்ட்
ଜଯ୍କିଶନ୍	ஜய்கிஶந்
ଜଯ୍ସ୍ରୀ	ஜய்ஸ்ரீ
ଜଲକ୍	ஜலக்
ଜଲନ୍ହିଲି	ஜலந்ஹிலி
ଜଲ୍ଦର୍	ஜல்தர்
ଜଶି	ஜஶி
ଜଶୋଡା	ஜஶோடா
ଜସମିଟ୍	ஜஸமிட்
ଜସ୍ବୁଇତା	ஜஸ்புஇதா
ଜସ୍ମେର୍	ஜஸ்மேர்
ଜାଗ୍ରୁଟି	ஜாக்ருடி
ଜାନବି	ஜாநபி
ଜାନ୍	ஜாந்
ଜାନ୍ଜର୍	ஜாந்ஜர்
ଜାବିଅନ୍	ஜாபிஅந்
ଜାବେଶ୍	ஜாபேஶ்
ଜାହି	ஜாஹி
ଜିଗନଶା	ஜிகநஶா
ଜିଗ୍ଯାଶା	ஜிக்யாஶா
ଜିତ୍ଯା	ஜித்யா
ଜିନ୍ସ୍ଯ୍	ஜிந்ஸ்ய்
ଜିବଟି	ஜிபடி
ଜିଯା ଉଶସ୍	ஜியா உஶஸ்
ଜିଶା	ஜிஶா
ଜୀବିଟା	ஜீபிடா
ଜୀବ୍ନୀ	ஜீப்நீ
ଜେନିଶା	ஜேநிஶா
ଜେନ୍ସ୍ଯ୍	ஜேந்ஸ்ய்
ଜେଯରଟ୍ନମ୍	ஜேயரட்நம்
ଜେଲସ୍ମି	ஜேலஸ்மி
ଜେସ୍ରି	ஜேஸ்ரி
ଜେହନ୍ନଜ୍	ஜேஹந்நஜ்
ଜୈଚନ୍ଡ୍ରନ୍	ஜைசந்ட்ரந்
ଜୈଟୈଶ୍	ஜைடைஶ்
ଜୈଡଯାଲ୍	ஜைடயால்
ଜୈନନ୍ଡ୍	ஜைநந்ட்
ଜୈନିଶ୍	ஜைநிஶ்
ଜୈନେଶ୍	ஜைநேஶ்
ଜୈବୀର୍	ஜைபீர்
ଜୈବୁଅନ୍ଟ୍	ஜைபுஅந்ட்
ଜୈମନ୍	ஜைமந்
ଜୈଶନ୍କର୍	ஜைஶந்கர்
ଜୈସୁଦନ୍	ஜைஸுதந்
ଜୋଲ୍ଯ୍	ஜோல்ய்
ଝିନୁକ୍	சிநுக்
ଝିଲ୍ମିଲ୍	சில்மில்
ଟିଟିର୍	டிடிர்
ଟିଲୋଟ୍ଟମା	டிலோட்டமா
ଟିସ୍ଟା	டிஸ்டா
ଟେଜସ୍ବୁଇନ୍	டேஜஸ்புஇந்
ଟୋଶନ୍	டோஶந்
ଟ୍ରୈଲୋକ୍ବା	ட்ரைலோக்பா
ଡଦିଜା	டதிஜா
ଡବୀଟ୍	டபீட்
ଡାନିଶ୍	டாநிஶ்
ଣିଲାନ୍ଜନା	ணிலாந்ஜநா
ତଙାଡୁରାଇ	தஙாடுராஇ
ତଙାମନି	தஙாமநி
ତଙାରାଜ୍	தஙாராஜ்
ତତ୍ବ	தத்ப
ତନଯ୍ମୀ	தநய்மீ
ତନିଆ	தநிஆ
ତନିଗାଇ	தநிகாஇ
ତନିଶ୍କ	தநிஶ்க
ତନିଶ୍ତା	தநிஶ்தா
ତନୁଜ୍	தநுஜ்
ତନୋଜ୍	தநோஜ்
ତନ୍ଶୁ	தந்ஶு
ତପସ୍ଯା	தபஸ்யா
ତବୁ	தபு
ତମୋଘ୍ନା	தமோக்நா
ତରକାର୍ ସେର୍ରୋନ୍	தரகார் ஸேர்ரோந்
ତରକ୍	தரக்
ତରଶ	தரஶ
ତରାନିକା	தராநிகா
ତର୍ଜ୍ନି	தர்ஜ்நி
ତର୍ପନ୍	தர்பந்
ତର୍ଲି	தர்லி
ତର୍ଶିନି	தர்ஶிநி
ତଶ୍ବି	தஶ்பி
ତହାନ୍	தஹாந்
ତାରା	தாரா
ତିଇବ୍ଯେଶ୍	திஇப்யேஶ்
ତିବ୍ଯାନ୍	திப்யாந்
ତିରୁଚନ୍ଡ୍ରା	திருசந்ட்ரா
ତୀକ୍ଶିକ	தீக்ஶிக
ତୀନିଶ୍	தீநிஶ்
ତୁମ୍କି	தும்கி
ତେଜସ୍	தேஜஸ்
ତେଜସ୍ବ୍ବିତ	தேஜஸ்ப்பித
ତେଜି	தேஜி
ତେଜୋବିକସ୍	தேஜோபிகஸ்
ତେଜ୍	தேஜ்
ତେଶିନୀ	தேஶிநீ
ତୋମୋଗ୍ନା	தோமோக்நா
ତ୍ରିଲୂକାମନ୍	த்ரிலூகாமந்
ତ୍ରିଲୋକ୍	த்ரிலோக்
ତ୍ରିଶ୍	த்ரிஶ்
ତ୍ରେଶା	த்ரேஶா
ଦକ୍ଶକ୍	தக்ஶக்
ଦକ୍ଶେଶ୍	தக்ஶேஶ்
ଦଜ୍ଶି	தஜ்ஶி
ଦଞଟା	தஞடா
ଦଞ୍ଟା	தஞ்டா
ଦଟ୍ଟଟ୍ରି	தட்டட்ரி
ଦନନ୍ଜଯ୍	தநந்ஜய்
ଦନଶ୍ରି	தநஶ்ரி
ଦନିଏଲ୍	தநிஏல்
ଦନିଶ୍ଟା	தநிஶ்டா
ଦନିଶ୍ତା	தநிஶ்தா
ଦନୁଶ୍	தநுஶ்
ଦନୁଶ୍ରି	தநுஶ்ரி
ଦନେଶି	தநேஶி
ଦନ୍ବି	தந்பி
ଦବିନ୍	தபிந்
ଦବୀନା	தபீநா
ଦଯନିଟା	தயநிடா
ଦଯମଯୀ	தயமயீ
ଦଯରାମ୍	தயராம்
ଦରହସି	தரஹஸி
ଦର୍ମେନ୍ଦର୍	தர்மேந்தர்
ଦର୍ରେନ୍	தர்ரேந்
ଦସା	தஸா
ଦାମିନି	தாமிநி
ଦୀକ୍ଶି	தீக்ஶி
ଦୀନା	தீநா
ଦୀପକ୍ରାଜ୍	தீபக்ராஜ்
ଦୀପଶ୍ରି	தீபஶ்ரி
ଦୀପେଶ୍	தீபேஶ்
ଦୀପ୍ଟିକା	தீப்டிகா
ଦୀପ୍ଟିମୋଯୀ	தீப்டிமோயீ
ଦୀପ୍ମାଲା	தீப்மாலா
ଦୀପ୍ଯୋଗ୍	தீப்யோக்
ଦୀଶ୍ନା	தீஶ்நா
ଦୀହେର୍	தீஹேர்
ଦେକ୍ଶିତ୍	தேக்ஶித்
ଦେନିଶ୍	தேநிஶ்
ଦେବ ପ୍ରିଯା	தேப ப்ரியா
ଦେବର୍ପନା	தேபர்பநா
ଦେବାର୍ଟି	தேபார்டி
ଦେବିକ୍	தேபிக்
ଦେବିଡାସ୍	தேபிடாஸ்
ଦେବିଲାଲ୍	தேபிலால்
ଦେବେନ୍	தேபேந்
ଦେବେନ୍ଡ୍ରନାତ୍	தேபேந்ட்ரநாத்
ଦେବେନ୍ଡ୍ରଶିକା	தேபேந்ட்ரஶிகா
ଦେବେଶି	தேபேஶி
ଦେବ୍ ନରେନ୍	தேப் நரேந்
ଦେବ୍କି	தேப்கி
ଦେବ୍ଜନି	தேப்ஜநி
ଦେବ୍ଯଶି	தேப்யஶி
ଦେଲୀନା	தேலீநா
ଦେଶ୍ନୀ	தேஶ்நீ
ଦେହଯ୍	தேஹய்
ଦୈବି	தைபி
ଦୈବିକ୍	தைபிக்
ନକ୍ଶା	நக்ஶா
ନଖ୍ରାଜ୍	நக்ராஜ்
ନଗନାତ୍	நகநாத்
ନଗାନ୍ଜଲି	நகாந்ஜலி
ନଗ୍ଗର୍	நக்கர்
ନଗ୍ଦର୍	நக்தர்
ନଙୈ	நஙை
ନଚ୍ନି	நச்நி
ନଟ୍ରାଜ୍	நட்ராஜ்
ନଡୀଶ୍	நடீஶ்
ନନ୍ଡି	நந்டி
ନବନୀତା	நபநீதா
ନବରାଜ୍	நபராஜ்
ନବରାନ୍ଜନି	நபராந்ஜநி
ନବିନା	நபிநா
ନବିନ୍ଡ୍	நபிந்ட்
ନବିଲ୍	நபில்
ନବୁଅଲ୍	நபுஅல்
ନବେଶା	நபேஶா
ନବ୍କର୍	நப்கர்
ନବ୍କିରନ୍	நப்கிரந்
ନବ୍କୁନ୍ଜ୍	நப்குந்ஜ்
ନବ୍ଯା ଦୁର୍ଗା	நப்யா துர்கா
ନଭଯନ୍	நபயந்
ନଭା	நபா
ନଭିଜ୍	நபிஜ்
ନଭିତା	நபிதா
ନମି	நமி
ନମିଟା	நமிடா
ନମିଟ୍	நமிட்
ନମିତା	நமிதா
ନମିଶା	நமிஶா
ନମ୍ଡେବ୍	நம்டேப்
ନରସିମ୍ହା	நரஸிம்ஹா
ନରେନ୍ଡ୍ରନ୍	நரேந்ட்ரந்
ନର୍ମଡ୍	நர்மட்
ନର୍ରେଶ୍	நர்ரேஶ்
ନଲିନାକ୍ଶ୍	நலிநாக்ஶ்
ନାଇଟିକ୍	நாஇடிக்
ନାଲନ୍	நாலந்
ନାଲବେନ୍ଭା	நாலபேந்பா
ନିକ୍କି	நிக்கி
ନିଦି	நிதி
ନିଲମ୍ବରି	நிலம்பரி
ନୀଇଲ୍	நீஇல்
ନୀଜା	நீஜா
ନୀତୁ	நீது
ନୀରାଜା	நீராஜா
ନୀଲବତି	நீலபதி
ନୀଲବ୍ଜା	நீலப்ஜா
ନୀଲମେଗନ୍	நீலமேகந்
ନୀଲଯା	நீலயா
ନୀଲୁ	நீலு
ନୀଲ୍	நீல்
ନୀଲ୍ମାଦବ୍	நீல்மாதப்
ନୀହା	நீஹா
ନେଟ୍ରାବଟି	நேட்ராபடி
ନେଡୁମରନ୍	நேடுமரந்
ନେମି	நேமி
ନେର୍ଯା	நேர்யா
ନେଲ୍ବିନ୍	நேல்பிந்
ନୈମିଶ୍	நைமிஶ்
ପଝନନ୍ଡାବର୍	பசநந்டாபர்
ପତଲା	பதலா
ପତୋଜ୍	பதோஜ்
ପତ୍ରଲିକା	பத்ரலிகா
ପଦାମବତି	பதாமபதி
ପଦ୍ମଜା	பத்மஜா
ପଦ୍ମବସା	பத்மபஸா
ପଦ୍ମମଲଧର	பத்மமலதர
ପଦ୍ମଯନି	பத்மயநி
ପଦ୍ମାଗ୍ରିହ	பத்மாக்ரிஹ
ପଦ୍ମାମୁଖୀ	பத்மாமுகீ
ପଦ୍ମୋଡ୍ଭବ	பத்மோட்பப
ପଦ୍ମ୍	பத்ம்
ପନିଟା	பநிடா
ପନ୍କଜା	பந்கஜா
ପନ୍ଖୁଡି	பந்குடி
ପନ୍ଖୁରି	பந்குரி
ପନ୍ଚଜନା	பந்சஜநா
ପନ୍ଚାବକ୍ଟ୍ରା	பந்சாபக்ட்ரா
ପନ୍ଡୁ	பந்டு
ପନ୍ନାଲାଲ୍	பந்நாலால்
ପବନ୍ କୁମାର୍	பபந் குமார்
ପବିକରାନ୍	பபிகராந்
ପବେଶ୍	பபேஶ்
ପବ୍ଲୀନ୍	பப்லீந்
ପରବାସୁ	பரபாஸு
ପରବି	பரபி
ପରବ୍	பரப்
ପରମାର୍ତା	பரமார்தா
ପରମେସ୍ବୁଅରି	பரமேஸ்புஅரி
ପରିକା	பரிகா
ପରିକେତ୍	பரிகேத்
ପରିଜଟ୍	பரிஜட்
ପରିତୋଶ୍	பரிதோஶ்
ପରିସା	பரிஸா
ପର୍ଦୁ	பர்து
ପର୍ନାଦ୍	பர்நாத்
ପର୍ନାଲ୍	பர்நால்
ପର୍ନି	பர்நி
ପର୍ନିତା	பர்நிதா
ପର୍ବି	பர்பி
ପର୍ବୁଇନ୍ଡେର୍	பர்புஇந்டேர்
ପର୍ମିତା	பர்மிதா
ପର୍ମେଶ୍ବୁଅର୍	பர்மேஶ்புஅர்
ପର୍ଶ୍ବା	பர்ஶ்பா
ପଲକ୍	பலக்
ପଲକ୍ଶି	பலக்ஶி
ପଲାନି କୁମାର୍	பலாநி குமார்
ପଲ୍ବିଶ୍	பல்பிஶ்
ପାଚକ୍	பாசக்
ପାବକି	பாபகி
ପାବନ୍	பாபந்
ପାର୍ତନ୍	பார்தந்
ପାର୍ତିଭ୍	பார்திப்
ପାର୍ବଟିନନ୍ଡନ୍	பார்படிநந்டந்
ପିଯାଶା	பியாஶா
ପିଯୁଶା	பியுஶா
ପୀଟଶ୍ମା	பீடஶ்மா
ପୂଜିତା	பூஜிதா
ପୂବିତନା	பூபிதநா
ପୂରିକା	பூரிகா
ପେର୍ନିତା	பேர்நிதா
ପୋଉଶାଲି	போஉஶாலி
ପ୍ରଭା	ப்ரபா
ପ୍ରଭାବତ୍ଯ୍	ப்ரபாபத்ய்
ପ୍ରାନ୍ବି	ப்ராந்பி
ଫନିଶ୍ବୁଅର୍	பநிஶ்புஅர்
ଫଲାନି	பலாநி
ଫେରଲ୍	பேரல்
ବକ୍ରାଭୁଜ୍	பக்ராபுஜ்
ବକ୍ରୁତ୍	பக்ருத்
ବଗ୍ମିନେ	பக்மிநே
ବଟୁକ୍	படுக்
ବତତ୍ମଜ୍	பதத்மஜ்
ବତ୍ସ୍ଯଯନ୍	பத்ஸ்யயந்
ବନବରାଯନ୍	பநபராயந்
ବନାର୍	பநார்
ବନିନି	பநிநி
ବନିଲା	பநிலா
ବନିସ୍ରୀ	பநிஸ்ரீ
ବନ୍କା	பந்கா
ବନ୍ଦୁ	பந்து
ବନ୍ବିହାରି	பந்பிஹாரி
ବନ୍ଭଟ୍ଟ୍	பந்பட்ட்
ବନ୍ମାଲା	பந்மாலா
ବନ୍ମ୍ଜଲଜ୍	பந்ம்ஜலஜ்
ବନ୍ଶି	பந்ஶி
ବନ୍ଶିଟା	பந்ஶிடா
ବନ୍ଶିଲ୍	பந்ஶில்
ବନ୍ସରି	பந்ஸரி
ବବଞା	பபஞா
ବମାନିଏ	பமாநிஏ
ବମ୍ସି	பம்ஸி
ବମ୍ସୀ	பம்ஸீ
ବଯୁନ୍	பயுந்
ବରଦବିନଯକା	பரதபிநயகா
ବରଲକ୍ଶ୍ମି	பரலக்ஶ்மி
ବରୁନ୍	பருந்
ବରେନ୍ଡ୍ରା	பரேந்ட்ரா
ବର୍ଚେକା	பர்சேகா
ବର୍ଦମାନ୍	பர்தமாந்
ବର୍ଦାନ୍	பர்தாந்
ବର୍ନିକା	பர்நிகா
ବର୍ଶନା	பர்ஶநா
ବର୍ଶନି	பர்ஶநி
ବର୍ଶିକା	பர்ஶிகா
ବଲାବନ୍	பலாபந்
ବଲେନ୍ଡୁ	பலேந்டு
ବଲ୍ମେକି	பல்மேகி
ବଲ୍ଲକି	பல்லகி
ବଲ୍ଲି	பல்லி
ବସନ୍ଟାପ୍ରଭା	பஸந்டாப்ரபா
ବସନ୍ଟି	பஸந்டி
ବସନ୍ତ୍	பஸந்த்
ବସବି	பஸபி
ବସବ୍	பஸப்
ବସୁପତି	பஸுபதி
ବସ୍ଟିନ୍	பஸ்டிந்
ବାଗ୍ଡେବି	பாக்டேபி
ବାଚି	பாசி
ବାନି	பாநி
ବାଲା ଗୋବିନ୍ଡ୍	பாலா கோபிந்ட்
ବାଲ୍ ଗୋପଲ୍	பால் கோபல்
ବାସି	பாஸி
ବାସୁଦା	பாஸுதா
ବାସୁଲକ୍ଶ୍ମି	பாஸுலக்ஶ்மி
ବିତିକା	பிதிகா
ବିଭା	பிபா
ବିଲ୍ବୁଆସ୍ରି	பில்புஆஸ்ரி
ବିଶ୍ନୁ	பிஶ்நு
ବୀଦାସ୍ରୀ	பீதாஸ்ரீ
ବୀନାବନି	பீநாபநி
ବୀରସୁନ୍ଡରି	பீரஸுந்டரி
ବୁଆମନ୍	புஆமந்
ବୁଆମିକା	புஆமிகா
ବୁବନା	புபநா
ବେଡାନ୍	பேடாந்
ବେଡାନ୍ଶି	பேடாந்ஶி
ବେଡିତା	பேடிதா
ବେଦା	பேதா
ବେମ୍ବରାସି	பேம்பராஸி
ବେଲ୍	பேல்
ବୈଜାଯନ୍ଟି	பைஜாயந்டி
ବୈଡିଶ୍	பைடிஶ்
ବୈଦିକ୍	பைதிக்
ବୈନବି	பைநபி
ବୈବଟ୍	பைபட்
ବୈରବି	பைரபி
ବୈଶାଲି	பைஶாலி
ବୈଶେକା	பைஶேகா
ବୈଶ୍ନବି	பைஶ்நபி
ବୈଶ୍ନୋଦେବି	பைஶ்நோதேபி
ବୈଶ୍ନୋବ୍	பைஶ்நோப்
ବ୍ରିଜା	ப்ரிஜா
ବ୍ରିତ୍ହି	ப்ரித்ஹி
ବ୍ରିଶା	ப்ரிஶா
ବ୍ରୁନ୍ଡା	ப்ருந்டா
ଭନଦବ୍ଯା	பநதப்யா
ଭଶ୍ବିକା	பஶ்பிகா
ଭସ୍କରା	பஸ்கரா
ଭାwନା	பாwநா
ଭାଗ୍ବୁଅଟି	பாக்புஅடி
ଭାଗ୍ବୁଅନ୍ଟି	பாக்புஅந்டி
ଭାଗ୍ଯ	பாக்ய
ଭାଗ୍ଯନନ୍ଡନା	பாக்யநந்டநா
ଭାଗ୍ଯଶ୍ରି	பாக்யஶ்ரி
ଭାବଲନ୍	பாபலந்
ଭାବିକ୍	பாபிக்
ଭାରବି	பாரபி
ଭାସ୍କରି	பாஸ்கரி
ଭାସ୍ବୁଅତ୍	பாஸ்புஅத்
ଭିଶ୍ମା	பிஶ்மா
ଭୁମା	புமா
ଭୌଟିକ୍	பௌடிக்
ଭୌମି	பௌமி
ଭ୍ରିତି	ப்ரிதி
ଭ୍ରୁହନ୍ତ୍	ப்ருஹந்த்
ମଗନ୍	மகந்
ମଙଲମ୍	மஙலம்
ମଙଲା	மஙலா
ମଙିରି	மஙிரி
ମଙୈ	மஙை
ମଡନ୍ମୋହନ୍	மடந்மோஹந்
ମଡୁର୍	மடுர்
ମଦୁ ବିନ୍ଡୁ	மது பிந்டு
ମଦୁକ୍	மதுக்
ମଦୁଚନ୍ଡା	மதுசந்டா
ମଦୁନିକା	மதுநிகா
ମଦୁମଯ୍	மதுமய்
ମଦୁମିତା	மதுமிதா
ମଦୁରି	மதுரி
ମନସ୍ବି	மநஸ்பி
ମନସ୍ବୁଇନି	மநஸ்புஇநி
ମନିଟ୍	மநிட்
ମନିତା	மநிதா
ମନିନ୍ଡ୍ରା	மநிந்ட்ரா
ମନିମୋଝି	மநிமோசி
ମନିରାମ୍	மநிராம்
ମନୀଟ୍	மநீட்
ମନୋଜ୍ନା	மநோஜ்நா
ମନ୍ଜିରି	மந்ஜிரி
ମନ୍ଜୁଲ୍	மந்ஜுல்
ମନ୍ଡରା	மந்டரா
ମନ୍ଡର୍ମଲିକା	மந்டர்மலிகா
ମନ୍ଡାବି	மந்டாபி
ମନ୍ତିକା	மந்திகா
ମମତି	மமதி
ମମ୍ତା	மம்தா
ମଲିନି	மலிநி
ମଲ୍ଲି	மல்லி
ମଲ୍ଲୁ	மல்லு
ମଲ୍ଲେଶମ୍	மல்லேஶம்
ମଲ୍ଲେଶ୍	மல்லேஶ்
ମହାକାଲ୍	மஹாகால்
ମହାକ୍ରମ୍	மஹாக்ரம்
ମହାଗୌରି	மஹாகௌரி
ମହାଜୀଟ୍	மஹாஜீட்
ମହାଞା	மஹாஞா
ମହାଟେଜସ୍	மஹாடேஜஸ்
ମହାଡେବ୍	மஹாடேப்
ମହାତି	மஹாதி
ମହାନନ୍ଡ୍	மஹாநந்ட்
ମହାନ୍ଟ୍	மஹாந்ட்
ମହାନ୍ତି	மஹாந்தி
ମହାବାଲା	மஹாபாலா
ମହାଭଡ୍ରା	மஹாபட்ரா
ମହାମନି	மஹாமநி
ମହାରନ୍ତ୍	மஹாரந்த்
ମହାଲ୍ଯା	மஹால்யா
ମହାଶ୍ରି	மஹாஶ்ரி
ମହିରା	மஹிரா
ମହିର୍	மஹிர்
ମହେନ୍ଡ୍ରା	மஹேந்ட்ரா
ମହେଶ୍ବୁଅର୍	மஹேஶ்புஅர்
ମହେସ୍ବୁଅରି	மஹேஸ்புஅரி
ମହ୍ନବ୍	மஹ்நப்
ମାକାଲି	மாகாலி
ମାଞଟା	மாஞடா
ମାନବ୍	மாநப்
ମାନିକାନ୍ଟ୍	மாநிகாந்ட்
ମାଲ୍ବିକା	மால்பிகா
ମୈଟ୍ରଯୀ	மைட்ரயீ
ଯକ୍ଶିଟା	யக்ஶிடா
ଯକ୍ଶିତ୍	யக்ஶித்
ଯଗ୍ନକଯା	யக்நகயா
ଯଟିଶ୍	யடிஶ்
ଯତି	யதி
ଯତିଶ୍	யதிஶ்
ଯଯିନ୍	யயிந்
ଯଶବୁଇନି	யஶபுஇநி
ଯଶାଶ୍ରୀ	யஶாஶ்ரீ
ଯଶାସ୍ବି	யஶாஸ்பி
ଯଶି	யஶி
ଯଶ୍ ରାଜ୍	யஶ் ராஜ்
ଯଶ୍ବନ୍ତ୍	யஶ்பந்த்
ଯଶ୍ରୀ	யஶ்ரீ
ଯସ୍ବୁଅନ୍ତ୍	யஸ்புஅந்த்
ଯାଗ୍ଯାସେନ୍	யாக்யாஸேந்
ଯାଜଟ୍	யாஜட்
ଯାଟୁଦନି	யாடுதநி
ଯାଡାବେନ୍ଡ୍ରା	யாடாபேந்ட்ரா
ଯାମାହିଲ୍	யாமாஹில்
ଯାମୁନା	யாமுநா
ଯାମ୍ଯା	யாம்யா
ଯାହ୍ବି	யாஹ்பி
ଯୁକସ୍ରି	யுகஸ்ரி
ଯୁଗନ୍ଶ୍	யுகந்ஶ்
ଯୁଗେନ୍ଡେର୍	யுகேந்டேர்
ଯୁବନ୍ ସୁର୍ଯା	யுபந் ஸுர்யா
ଯୁବରାନି	யுபராநி
ଯୁବାରାମ୍	யுபாராம்
ଯୁବିନ୍	யுபிந்
ଯୁବ୍ରାନି	யுப்ராநி
ଯେଇଗବନ୍	யேஇகபந்
ଯେଘରାଜ୍	யேகராஜ்
ଯେତର୍ତ୍	யேதர்த்
ଯେମା	யேமா
ଯେସ୍ବୁଅନ୍ତ୍	யேஸ்புஅந்த்
ଯେସ୍ବୁଇନ୍	யேஸ்புஇந்
ଯୋଗାଜି	யோகாஜி
ଯୋଗୀଟା	யோகீடா
ଯୋହନ୍	யோஹந்
ରକଶ୍ନ୍ଡା	ரகஶ்ந்டா
ରକ୍ଶଟି	ரக்ஶடி
ରକ୍ଶିନା	ரக்ஶிநா
ରଘୁନନ୍ଡନ୍	ரகுநந்டந்
ରଘୁନାତ୍	ரகுநாத்
ରଙିତ୍	ரஙித்
ରଜନିକାନ୍ଟା	ரஜநிகாந்டா
ରଜନ୍ଞା	ரஜந்ஞா
ରଟନା	ரடநா
ରଟ୍ନା ପ୍ରିଯା	ரட்நா ப்ரியா
ରଟ୍ନାଜ୍ଯୋଟି	ரட்நாஜ்யோடி
ରଟ୍ନାବଲି	ரட்நாபலி
ରତ୍ନା	ரத்நா
ରନିଶ୍	ரநிஶ்
ରନ୍ଜନି	ரந்ஜநி
ରନ୍ଜଯ୍	ரந்ஜய்
ରନ୍ଜୁ	ரந்ஜு
ରନ୍ବିତା	ரந்பிதா
ରବିପ୍ରଭା	ரபிப்ரபா
ରବିଯାନ୍କି	ரபியாந்கி
ରବେକ୍	ரபேக்
ରମନୁଜମ୍	ரமநுஜம்
ରମାକାନ୍ଟ୍	ரமாகாந்ட்
ରମାଦେବି	ரமாதேபி
ରମୈଅହ୍	ரமைஅஹ்
ରମ୍ଯଦେବି	ரம்யதேபி
ରଶିକା	ரஶிகா
ରଶିଲା	ரஶிலா
ରଶ୍ବୁଇନା	ரஶ்புஇநா
ରଶ୍ମିନ୍	ரஶ்மிந்
ରସୁଲ୍	ரஸுல்
ରହାମ୍	ரஹாம்
ରହ୍ନି	ரஹ்நி
ରାଓସହେବ୍	ராஓஸஹேப்
ରାକା	ராகா
ରାଗେଶ୍	ராகேஶ்
ରାଘବା	ராகபா
ରାଘବ୍	ராகப்
ରାଜଲକ୍ଶ୍ମି	ராஜலக்ஶ்மி
ରାଜାରମନ୍	ராஜாரமந்
ରାଜାରମେଶ୍	ராஜாரமேஶ்
ରାଜେଶ୍ରମ୍	ராஜேஶ்ரம்
ରାଜ୍	ராஜ்
ରାଜ୍ କିରନ୍	ராஜ் கிரந்
ରାଜ୍କଲା	ராஜ்கலா
ରାଝନ୍ସ୍	ராசந்ஸ்
ରାଧା କ୍ରିଶ୍ନା	ராதா க்ரிஶ்நா
ରାମୋଜି	ராமோஜி
ରାମ୍	ராம்
ରାମ୍ଗୋପାଲ୍	ராம்கோபால்
ରାମ୍ସାଗର୍	ராம்ஸாகர்
ରାହୁଲ୍ରାଜ୍	ராஹுல்ராஜ்
ରୀଟ୍	ரீட்
ରୀତନା	ரீதநா
ରୀନା	ரீநா
ରୀମା	ரீமா
ରେବନ୍ତି	ரேபந்தி
ରେବନ୍ତିକା	ரேபந்திகா
ରେମିତା	ரேமிதா
ରେଶିତା	ரேஶிதா
ରେହେଇଲା	ரேஹேஇலா
ରୈନା	ரைநா
ଲକ୍ଶନା	லக்ஶநா
ଲକ୍ଶା	லக்ஶா
ଲକ୍ଶିଟା	லக்ஶிடா
ଲକ୍ଶ୍ମି	லக்ஶ்மி
ଲକ୍ଶ୍ମି ପ୍ରିଯା	லக்ஶ்மி ப்ரியா
ଲଜ୍ଜବୁଅଟି	லஜ்ஜபுஅடி
ଲଜ୍ବଟି	லஜ்படி
ଲଜ୍ବନ୍ଟି	லஜ்பந்டி
ଲତା	லதா
ଲନିବନ୍	லநிபந்
ଲବନା	லபநா
ଲବିନ୍	லபிந்
ଲବ୍ଯ୍	லப்ய்
ଲମ୍ବକର୍ନା	லம்பகர்நா
ଲରଞା	லரஞா
ଲରିନା	லரிநா
ଲଲମ୍	லலம்
ଲଲିଟ୍ମୋହନ୍	லலிட்மோஹந்
ଲଲିଟ୍ରାଜ୍	லலிட்ராஜ்
ଲସିକ୍	லஸிக்
ଲହାରି	லஹாரி
ଲାଲିଟ୍ଯା	லாலிட்யா
ଲାଲିମା	லாலிமா
ଲାସ୍ଯା	லாஸ்யா
ଲିଙେଶ୍	லிஙேஶ்
ଲିନିଶା	லிநிஶா
ଲିମିଶା	லிமிஶா
ଲିଯାନା	லியாநா
ଲିଲା	லிலா
ଲିଲାଦର୍	லிலாதர்
ଲିଶନ୍ତ୍	லிஶந்த்
ଲୀଲବୁଅଟି	லீலபுஅடி
ଲୁନି	லுநி
ଲୁମ୍ବିକା	லும்பிகா
ଲୁମ୍ବିନି	லும்பிநி
ଲୁହିଟ୍	லுஹிட்
ଲୂକେଶ୍ବୁଅରି	லூகேஶ்புஅரி
ଲେଖିଶା	லேகிஶா
ଲେଖ୍ଯା	லேக்யா
ଲେନିଶା	லேநிஶா
ଲେପକ୍ଶ୍	லேபக்ஶ்
ଲେମା	லேமா
ଲୋଉକ୍ଯା	லோஉக்யா
ଲୋକକ୍ରିଟି	லோகக்ரிடி
ଲୋକିନି	லோகிநி
ଲୋକେଶ୍ବୁଅରନ୍	லோகேஶ்புஅரந்
ଲୋକ୍ପ୍ରକାଶ୍	லோக்ப்ரகாஶ்
ଲୋଗିଟା	லோகிடா
ଲୋବେଶ୍	லோபேஶ்
ଲୋମଶ୍	லோமஶ்
ଲୋହିଟା	லோஹிடா
ସକଲେଶ୍ବୁଅର୍	ஸகலேஶ்புஅர்
ସଙିଟା	ஸஙிடா
ସଙିନି	ஸஙிநி
ସଚନ୍ଡ୍ରା	ஸசந்ட்ரா
ସଚି	ஸசி
ସଚିଡାନନ୍ଡ୍	ஸசிடாநந்ட்
ସଚିନ୍	ஸசிந்
ସଚିନ୍ଡେଓ	ஸசிந்டேஓ
ସଚେଟନ୍	ஸசேடந்
ସଡାର୍	ஸடார்
ସଡାଶିବା	ஸடாஶிபா
ସଡିଶ୍	ஸடிஶ்
ସଡ୍ଗଟି	ஸட்கடி
ସଡ୍ଗୁରୁ	ஸட்குரு
ସଦନା	ஸதநா
ସନ୍କରି	ஸந்கரி
ସନ୍ଜନ	ஸந்ஜந
ସନ୍ଜିଟା	ஸந்ஜிடா
ସବରୀଶ୍	ஸபரீஶ்
ସବିତା	ஸபிதா
ସବୁରି	ஸபுரி
ସବ୍ରଙ୍	ஸப்ரங்
ସଭ୍ଯା	ஸப்யா
ସଭ୍ରନ୍ଟ୍	ஸப்ரந்ட்
ସମଞା	ஸமஞா
ସମତା	ஸமதா
ସମିକା	ஸமிகா
ସମେନ୍	ஸமேந்
ସମେଶ୍	ஸமேஶ்
ସମ୍ବିତି	ஸம்பிதி
ସମ୍ବିତ୍	ஸம்பித்
ସମ୍ବୁଡ୍ଦା	ஸம்புட்தா
ସମ୍ବୋଦ୍	ஸம்போத்
ସମ୍ଯତା	ஸம்யதா
ସମ୍ରିଡ୍ଦା	ஸம்ரிட்தா
ସଲେନା	ஸலேநா
ସଲୋଖ୍	ஸலோக்
ସଲୋହି	ஸலோஹி
ସହଡେବ୍	ஸஹடேப்
ସହ୍ଡେବ୍	ஸஹ்டேப்
ସାଇ ଆନନ୍ଡ୍	ஸாஇ ஆநந்ட்
ସାଇ କୁମାରି	ஸாஇ குமாரி
ସାଇ କୁମାର୍	ஸாஇ குமார்
ସାଇ ବାନି	ஸாஇ பாநி
ସାଇ ସର୍ବେଶ୍	ஸாஇ ஸர்பேஶ்
ସାଇଯ୍ଯାନ୍	ஸாஇய்யாந்
ସାଜିତ୍	ஸாஜித்
ସାଜିଲି	ஸாஜிலி
ସାଟ୍ବିକ୍	ஸாட்பிக்
ସାନିଦ୍ଯା	ஸாநித்யா
ସାନିଯା	ஸாநியா
ସାରାନ୍ଶ୍	ஸாராந்ஶ்
ସାହସ୍ଟ୍ରାଜିଟ୍	ஸாஹஸ்ட்ராஜிட்
ସାହିଟ୍ଯା	ஸாஹிட்யா
ସାହିରାମ୍	ஸாஹிராம்
ସାହିଲ୍	ஸாஹில்
ସାହୁଲ୍	ஸாஹுல்
ସୈଜଯାନି	ஸைஜயாநி
ସୈଜାସି	ஸைஜாஸி
ସୈଜିଲ୍	ஸைஜில்
ସୈନାତ୍	ஸைநாத்
ସୈନିଟ୍	ஸைநிட்
ସୈହିଶ୍	ஸைஹிஶ்
ହନିମା	ஹநிமா
ହନିଶା	ஹநிஶா
ହନିଶ୍	ஹநிஶ்
ହନୀଶା	ஹநீஶா
ହନୁମନ୍ଟା	ஹநுமந்டா
ହବିହ୍	ஹபிஹ்
ହମ୍ସାନନ୍ଡି	ஹம்ஸாநந்டி
ହମ୍ସିକା	ஹம்ஸிகா
ହରିକିଶନ୍	ஹரிகிஶந்
ହରିଟେଜା	ஹரிடேஜா
ହରିତା	ஹரிதா
ହରିତ୍	ஹரித்
ହରିଦ	ஹரித
ହରିନା	ஹரிநா
ହରିନାରାଯନ୍	ஹரிநாராயந்
ହରିପେଅସାଡ୍	ஹரிபேஅஸாட்
ହରିମନ୍ଟି	ஹரிமந்டி
ହରେଶ୍	ஹரேஶ்
ହର୍କେଶ୍	ஹர்கேஶ்
ହର୍ଟେଇଜ୍	ஹர்டேஇஜ்
ହର୍ବି	ஹர்பி
ହର୍ଶଲା	ஹர்ஶலா
ହର୍ଶିତା	ஹர்ஶிதா
ହର୍ଶିତ୍	ஹர்ஶித்
ହର୍ଶ୍ ବୀର୍	ஹர்ஶ் பீர்
ହର୍ଶ୍ନିଲ୍	ஹர்ஶ்நில்
ହର୍ସିକା	ஹர்ஸிகா
ହଶ୍ମିତା	ஹஶ்மிதா
ହଶ୍ରୀ	ஹஶ்ரீ
ହସିଟା	ஹஸிடா
ହସିନା	ஹஸிநா
ହସ୍ତା	ஹஸ்தா
ହସ୍ବିତା	ஹஸ்பிதா
ହସ୍ମିତା	ஹஸ்மிதா
ହାରିତ୍	ஹாரித்
ହିଟେନ୍ଡ୍ରା	ஹிடேந்ட்ரா
ହିତେଶ୍	ஹிதேஶ்
ହିମା	ஹிமா
ହିମାଗୋଉରି	ஹிமாகோஉரி
ହିମାଘ୍ନା	ஹிமாக்நா
ହିମାନ୍ସୁ	ஹிமாந்ஸு
ହିମାବନ୍ତ୍	ஹிமாபந்த்
ହିରଞଦା	ஹிரஞதா
ହିରନ୍ମଯି	ஹிரந்மயி
ହିରନ୍ମଯ୍	ஹிரந்மய்
ହିରିଶା	ஹிரிஶா
ହିର୍ବୁଅ	ஹிர்புஅ
ହିଲ୍ଲା	ஹில்லா
ହୀଟ୍ରାଜ୍	ஹீட்ராஜ்
ହୀନା	ஹீநா
ହୀର୍ବ	ஹீர்ப
ହେଇଡି	ஹேஇடி
ହେଟବ୍	ஹேடப்
ହେଟୁ	ஹேடு
ହେଟ୍ବୀକ୍	ஹேட்பீக்
ହେଟ୍ସ୍ଯା	ஹேட்ஸ்யா
ହେତନ୍ଶି	ஹேதந்ஶி
ହେନଲ୍	ஹேநல்
ହେମଙିନି	ஹேமஙிநி
ହେମନ୍ଟ୍	ஹேமந்ட்
ହେମନ୍ତ୍	ஹேமந்த்
ହେମନ୍ତ୍ସ୍ରୀ	ஹேமந்த்ஸ்ரீ
ହେମପ୍ରସାଡ୍	ஹேமப்ரஸாட்
ହେମବଟିନନ୍ଡନ୍	ஹேமபடிநந்டந்
ହେମସ୍ରି	ஹேமஸ்ரி
ହେମିଶା	ஹேமிஶா
ହେମ୍କେଶ୍	ஹேம்கேஶ்
ହେମ୍କ୍ରିଶ୍	ஹேம்க்ரிஶ்
ହେମ୍ରାଜ୍	ஹேம்ராஜ்
ହେରକ୍	ஹேரக்
ହୋନ୍ହାର୍	ஹோந்ஹார்
ହ୍ରିଦ୍ଯା	ஹ்ரித்யா
#
#
# Territory names from CLDR
ଆଣ୍ଡୋରା	ஆண்டோரா
ସଂଯୁକ୍ତ ଆରବ ଏମିରେଟସ୍	ஸஂயுக்த ஆரப ஏமிரேடஸ்
ଆଫାଗାନିସ୍ତାନ୍	ஆபாகாநிஸ்தாந்
ଆଣ୍ଟିଗୁଆ ଏବଂ ବାରବୁଦା	ஆண்டிகுஆ ஏபஂ பாரபுதா
ଆଙ୍ଗୁଇଲ୍ଲା	ஆங்குஇல்லா
ଆଲବାନିଆ	ஆலபாநிஆ
ଆର୍ମେନିଆ	ஆர்மேநிஆ
ଆଙ୍ଗୋଲା	ஆங்கோலா
ଆର୍ଣ୍ଟକଟିକା	ஆர்ண்டகடிகா
ଆର୍ଜେଣ୍ଟିନା	ஆர்ஜேண்டிநா
ଆମେରିକାନ୍ ସାମୋଆ	ஆமேரிகாந் ஸாமோஆ
ଅଷ୍ଟ୍ରିଆ	அஷ்ட்ரிஆ
ଅଷ୍ଟ୍ରେଲିଆ	அஷ்ட்ரேலிஆ
ଆରୁବା	ஆருபா
ଆଲାଣ୍ଡ ଆଇସଲ୍ୟାଣ୍ଡ	ஆலாண்ட ஆஇஸல்யாண்ட
ଆଜେରବାଇଜାନ୍	ஆஜேரபாஇஜாந்
ବୋସନିଆ ଏବଂ ହର୍ଜଗୋଭିନା	போஸநிஆ ஏபஂ ஹர்ஜகோபிநா
ବାରବାଡୋସ୍	பாரபாடோஸ்
ବାଙ୍ଗଲାଦେଶ୍	பாங்கலாதேஶ்
ବେଲଜିୟମ୍	பேலஜியம்
ବୁର୍କିନୋ ଫାସୋ	புர்கிநோ பாஸோ
ବୁଲଗେରିଆ	புலகேரிஆ
ବାହାରିନ୍	பாஹாரிந்
ବୁରୁନ୍ଦି	புருந்தி
ବେନିନ୍	பேநிந்
ସେଣ୍ଟ ବାର୍ଥେଲେମି	ஸேண்ட பார்தேலேமி
ବରମୁଡା	பரமுடா
ବ୍ରୁନେଇ	ப்ருநேஇ
ବୋଲଭିଆ	போலபிஆ
ବ୍ରାଜିଲ୍	ப்ராஜில்
ବାହାମାସ୍	பாஹாமாஸ்
ଭୁଟାନ୍	புடாந்
ବୌଭେଟ୍ ଆଇସଲ୍ୟାଣ୍ଡ	பௌபேட் ஆஇஸல்யாண்ட
ବୋଟସ୍ବାନ୍	போடஸ்பாந்
ବେଲାରୁଷ୍	பேலாருஷ்
ବେଲିଜ୍	பேலிஜ்
କାନାଡା	காநாடா
କୋକୋସ୍ ଆଇସଲ୍ୟାଣ୍ଡ	கோகோஸ் ஆஇஸல்யாண்ட
କଙ୍ଗୋ-କିନସାସା	கங்கோ-கிநஸாஸா
ମଧ୍ୟ ଆଫ୍ରିକୀୟ ଗଣତନ୍ତ୍ର	மத்ய ஆப்ரிகீய கணதந்த்ர
କଙ୍ଗୋ-ବ୍ରାଜିଭିଲ୍ଲେ	கங்கோ-ப்ராஜிபில்லே
ସ୍ବିଜରଲ୍ୟାଣ୍ଡ	ஸ்பிஜரல்யாண்ட
ଆଇବରୀ କୋଷ୍ଟ	ஆஇபரீ கோஷ்ட
କୁକ୍ ଆଇସଲ୍ୟାଣ୍ଡ	குக் ஆஇஸல்யாண்ட
ଚିଲ୍ଲୀ	சில்லீ
କାମେରୁନ୍	காமேருந்
ଚିନ୍	சிந்
କୋଲମ୍ବିଆ	கோலம்பிஆ
କୋଷ୍ଟା ରିକା	கோஷ்டா ரிகா
କ୍ୱିବା	க்விபா
କେପ୍ ଭର୍ଦେ	கேப் பர்தே
ଖ୍ରୀଷ୍ଟମାସ ଆଇଲ୍ୟାଣ୍ଡ	க்ரீஷ்டமாஸ ஆஇல்யாண்ட
ସାଇପ୍ରସ୍	ஸாஇப்ரஸ்
ଚେକ୍ ସାଧାରଣତନ୍ତ୍ର	சேக் ஸாதாரணதந்த்ர
ଜର୍ମାନୀ	ஜர்மாநீ
ଡିବୌଟି	டிபௌடி
ଡେନମାର୍କ	டேநமார்க
ଡୋମିନାକା	டோமிநாகா
ଡୋମିନକାନ୍ ପ୍ରଜାତନ୍ତ୍ର	டோமிநகாந் ப்ரஜாதந்த்ர
ଆଲଜେରିଆ	ஆலஜேரிஆ
ଇକ୍ୱାଡୋର୍	இக்வாடோர்
ଏସ୍ତୋନିଆ	ஏஸ்தோநிஆ
ଇଜିପ୍ଟ	இஜிப்ட
ପଶ୍ଚିମ ସାହାରା	பஶ்சிம ஸாஹாரா
ଇରିଟ୍ରିୟା	இரிட்ரியா
ସ୍ପେନ୍	ஸ்பேந்
ଇଥିଓପିଆ	இதிஓபிஆ
ୟୁରୋପିଆନ୍ ୟୁନିଅନ୍	யுரோபிஆந் யுநிஅந்
ଫିନଲ୍ୟାଣ୍ଡ	பிநல்யாண்ட
ଫିଜି	பிஜி
ଫଲ୍କଲ୍ୟାଣ୍ଡ ଦ୍ବୀପପୁଞ୍ଜ	பல்கல்யாண்ட த்பீபபுஞ்ஜ
ମାଇକ୍ରୋନେସିଆ	மாஇக்ரோநேஸிஆ
ଫାରୋଇ ଦ୍ବୀପପୁଞ୍ଜ	பாரோஇ த்பீபபுஞ்ஜ
ଫ୍ରାନ୍ସ	ப்ராந்ஸ
ଗାବୋନ୍	காபோந்
ବ୍ରିଟେନ୍	ப்ரிடேந்
ଗ୍ରେନାଡା	க்ரேநாடா
ଜର୍ଜିଆ	ஜர்ஜிஆ
ଫ୍ରେଞ୍ଚ ଗୁଇନା	ப்ரேஞ்ச குஇநா
ଗୁଏରନେସି	குஏரநேஸி
ଘାନା	காநா
ଜିବ୍ରାଲ୍ଟର୍	ஜிப்ரால்டர்
ଗ୍ରୀନଲ୍ୟାଣ୍ଡ	க்ரீநல்யாண்ட
ଗାମ୍ବିଆ	காம்பிஆ
ଗୁଏନେଆ	குஏநேஆ
ଗୌଡେଲୌପେ	கௌடேலௌபே
ଇକ୍ବାଟେରିଆଲ୍ ଗୁଇନିଆ	இக்பாடேரிஆல் குஇநிஆ
ଗ୍ରୀସ୍	க்ரீஸ்
ଦକ୍ଷିଣ ଜର୍ଜିଆ ଏବଂ ଦକ୍ଷିଣ ସାଣ୍ଡୱିଚ୍ ଦ୍ବୀପପୁଞ୍ଜ	தக்ஷிண ஜர்ஜிஆ ஏபஂ தக்ஷிண ஸாண்டவிச் த்பீபபுஞ்ஜ
ଗୁଏତମାଲା	குஏதமாலா
ଗୁଆମ୍	குஆம்
ଗୁଇନିଆ-ବିସାଉ	குஇநிஆ-பிஸாஉ
ଗୁଇନା	குஇநா
ହଂକଂ ବିଶେଷ ପ୍ରଶାସନିକ କ୍ଷେତ୍ର ଚୀନ୍	ஹஂகஂ பிஶேஷ ப்ரஶாஸநிக க்ஷேத்ர சீந்
ହାର୍ଡ ଦ୍ବୀପପୁଞ୍ଜ ଏବଂ ମ୍ୟାକଡୋନାଲ୍ ଦ୍ବୀପପୁଞ୍ଜ	ஹார்ட த்பீபபுஞ்ஜ ஏபஂ ம்யாகடோநால் த்பீபபுஞ்ஜ
ହୋଣ୍ଡାରୁସ୍	ஹோண்டாருஸ்
କ୍ରୋଆଟିଆ	க்ரோஆடிஆ
ହାଇତି	ஹாஇதி
ହଙ୍ଗେରୀ	ஹங்கேரீ
ଇଣ୍ଡୋନେସିଆ	இண்டோநேஸிஆ
ଆୟରଲ୍ୟାଣ୍ଡ	ஆயரல்யாண்ட
ଇସ୍ରାଏଲ୍	இஸ்ராஏல்
ଆଇଲ୍ ଅଫ୍ ମୈନ୍	ஆஇல் அப் மைந்
ଭାରତ	பாரத
ବ୍ରିଟିଶ୍ ଭାରତୀୟ ସାମୁଦ୍ରିକ କ୍ଷେତ୍ର	ப்ரிடிஶ் பாரதீய ஸாமுத்ரிக க்ஷேத்ர
ଇରାକ୍	இராக்
ଇରାନ୍	இராந்
ଆଇସଲ୍ୟାଣ୍ଡ	ஆஇஸல்யாண்ட
ଇଟାଲୀ	இடாலீ
ଜର୍ସି	ஜர்ஸி
ଜାମାଇକା	ஜாமாஇகா
ଜୋର୍ଡାନ୍	ஜோர்டாந்
ଜାପାନ୍	ஜாபாந்
କେନିୟା	கேநியா
କିର୍ଗିଜିସ୍ଥାନ	கிர்கிஜிஸ்தாந
କାମ୍ବୋଡିଆ	காம்போடிஆ
କିରିବାଟୀ	கிரிபாடீ
କାମୋରସ୍	காமோரஸ்
ସେଣ୍ଟ କିଟସ୍ ଏଣ୍ଡ ନେଭିସ୍	ஸேண்ட கிடஸ் ஏண்ட நேபிஸ்
ଉତ୍ତର କୋରିଆ	உத்தர கோரிஆ
ଦକ୍ଷିଣ କୋରିଆ	தக்ஷிண கோரிஆ
କୁଏତ୍	குஏத்
କେମ୍ୟାନ୍ ଦ୍ବୀପପୁଞ୍ଜ	கேம்யாந் த்பீபபுஞ்ஜ
କାଜାକାସ୍ଥାନ୍	காஜாகாஸ்தாந்
ଲାଓସ୍	லாஓஸ்
ଲେବାନନ୍	லேபாநந்
ସେଣ୍ଟ ଲୁସିଆ	ஸேண்ட லுஸிஆ
ଲିଚେସ୍ତିଆନାନ୍	லிசேஸ்திஆநாந்
ଶ୍ରୀଲଙ୍କା	ஶ்ரீலங்கா
ଲିବେରିଆ	லிபேரிஆ
ଲେସୋଥୋ	லேஸோதோ
ଲିଥାଆନିଆ	லிதாஆநிஆ
ଲକ୍ସେମବର୍ଗ	லக்ஸேமபர்க
ଲାଟଭିଆ	லாடபிஆ
ଲିବିଆ	லிபிஆ
ମୋରୋକ୍କୋ	மோரோக்கோ
ମୋନାକୋ	மோநாகோ
ମାଲଡୋଭା	மாலடோபா
ମଣ୍ଟେଗ୍ରୋ	மண்டேக்ரோ
ସେଣ୍ଟ ମାର୍ଟିନ୍	ஸேண்ட மார்டிந்
ମାଡାଗାସ୍କର୍	மாடாகாஸ்கர்
ମାର୍ଶଲ୍ ଦ୍ବୀପପୁଞ୍ଜ	மார்ஶல் த்பீபபுஞ்ஜ
ମାସେଡୋନିଆ	மாஸேடோநிஆ
ମାଳୀ	மாளீ
ମିୟାମାର୍	மியாமார்
ମଙ୍ଗୋଲିଆ	மங்கோலிஆ
ମାକାଉ SAR ଚିନ୍	மாகாஉ SAR சிந்
ଉତ୍ତର ମାରିଆନା ଦ୍ବୀପପୁଞ୍ଜ	உத்தர மாரிஆநா த்பீபபுஞ்ஜ
ମାର୍ଟିନିକ୍ୟୁ	மார்டிநிக்யு
ମାଉରିଟାନିଆ	மாஉரிடாநிஆ
ମଣ୍ଟେସେରାଟ୍	மண்டேஸேராட்
ମାଲ୍ଟା	மால்டா
ମୌରିସସ୍	மௌரிஸஸ்
ମାଳଦ୍ବୀପ	மாளத்பீப
ମାଲୱି	மாலவி
ମେକ୍ସିକୋ	மேக்ஸிகோ
ମାଲେସିଆ	மாலேஸிஆ
ମୋଜାମ୍ବିକ୍ୟୁ	மோஜாம்பிக்யு
ନାମ୍ବିଆ	நாம்பிஆ
ନୂତନ କାଲେଡୋନିଆ	நூதந காலேடோநிஆ
ନାଇଜର୍	நாஇஜர்
ନରଫ୍ଲକ୍ ଦ୍ବୀପ	நரப்லக் த்பீப
ନାଇଜେରିଆ	நாஇஜேரிஆ
ନିକାରାଗୁଆ	நிகாராகுஆ
ନେଦରଲ୍ୟାଣ୍ଡ	நேதரல்யாண்ட
ନରୱେ	நரவே
ନେପାଳ	நேபாள
ନାଉରୁ	நாஉரு
ନିଉ	நிஉ
ନ୍ୟୁଜିଲାଣ୍ଡ	ந்யுஜிலாண்ட
ଓମାନ୍	ஓமாந்
ପାନାମା	பாநாமா
ପେରୁ	பேரு
ଫ୍ରେଞ୍ଚ ପଲିନେସିଆ	ப்ரேஞ்ச பலிநேஸிஆ
ପପୁଆ ନ୍ୟୁ ଗୁଏନିଆ	பபுஆ ந்யு குஏநிஆ
ଫିଲିପାଇନସ୍	பிலிபாஇநஸ்
ପାକିସ୍ତାନ	பாகிஸ்தாந
ପୋଲାଣ୍ଡ	போலாண்ட
ସେଣ୍ଟ ପିଏରେ ଏବଂ ମିକ୍ବାଲୋନ୍	ஸேண்ட பிஏரே ஏபஂ மிக்பாலோந்
ପିଟକାଇରିନ୍	பிடகாஇரிந்
ପୁଏର୍ତ୍ତୋ ରିକୋ	புஏர்த்தோ ரிகோ
ପାଲେସ୍ତେନିଆ	பாலேஸ்தேநிஆ
ପର୍ତ୍ତୁଗାଲ୍	பர்த்துகால்
ପାଲାଉ	பாலாஉ
ପାରାଗୁଏ	பாராகுஏ
କତାର୍	கதார்
ଆଉଟଲେଇଂ ଓସେନିଆ	ஆஉடலேஇஂ ஓஸேநிஆ
ରିୟୁନିଅନ୍	ரியுநிஅந்
ରୋମାନିଆ	ரோமாநிஆ
ସର୍ବିଆ	ஸர்பிஆ
ରୁଷିଆ	ருஷிஆ
ରାୱାଣ୍ଡା	ராவாண்டா
ସାଉଦି ଆରବିଆ	ஸாஉதி ஆரபிஆ
ସୋଲୋମନ୍ ଦ୍ବୀପପୁଞ୍ଜ	ஸோலோமந் த்பீபபுஞ்ஜ
ସେଚେଲସ୍	ஸேசேலஸ்
ସୁଦାନ୍	ஸுதாந்
ସ୍ୱେଡେନ୍	ஸ்வேடேந்
ସିଙ୍ଗାପୁର୍	ஸிங்காபுர்
ସେଣ୍ଟ ହେଲେନା	ஸேண்ட ஹேலேநா
ସ୍ଲୋଭେନିଆ	ஸ்லோபேநிஆ
ସାଲ୍ଭାର୍ଡ ଏବଂ ଜାନ୍ ମାୟୋନ୍	ஸால்பார்ட ஏபஂ ஜாந் மாயோந்
ସ୍ଲୋଭାକିଆ	ஸ்லோபாகிஆ
ସିଓରା ଲିଓନ୍	ஸிஓரா லிஓந்
ସାନ୍ ମାରିନୋ	ஸாந் மாரிநோ
ସେନେଗାଲ୍	ஸேநேகால்
ସୋମାଲିଆ	ஸோமாலிஆ
ସୁରିନାମ	ஸுரிநாம
ଦକ୍ଷିନ ସୁଦାନ	தக்ஷிந ஸுதாந
ସାଓ ଟୋମେ ଏବଂ ପ୍ରିନସିପି	ஸாஓ டோமே ஏபஂ ப்ரிநஸிபி
ଏଲ୍ ସାଲଭାଡୋର୍	ஏல் ஸாலபாடோர்
ସିରିଆ	ஸிரிஆ
ସ୍ବାଜିଲାଣ୍ଡ	ஸ்பாஜிலாண்ட
ତୁର୍କସ୍ ଏବଂ ସାଇକସ୍ ଦ୍ବୀପପୁଞ୍ଜ	துர்கஸ் ஏபஂ ஸாஇகஸ் த்பீபபுஞ்ஜ
ଚାଦ୍	சாத்
ଫରାସୀ ଦକ୍ଷିଣ କ୍ଷେତ୍ର	பராஸீ தக்ஷிண க்ஷேத்ர
ଟୋଗୋ	டோகோ
ଥାଇଲାଣ୍ଡ	தாஇலாண்ட
ତାଜିକିସ୍ଥାନ୍	தாஜிகிஸ்தாந்
ଟୋକେଲାଉ	டோகேலாஉ
ପୁର୍ବ ତିମୋର୍	புர்ப திமோர்
ତୁର୍କମେନିସ୍ତାନ୍	துர்கமேநிஸ்தாந்
ତୁନିସିଆ	துநிஸிஆ
ଟୋଙ୍ଗା	டோங்கா
ତୁର୍କୀ	துர்கீ
ତ୍ରିନିଦାଦ୍ ଏବଂ ଟୋବାଗୋ	த்ரிநிதாத் ஏபஂ டோபாகோ
ଟୁଭାଲୁ	டுபாலு
ତାଇୱାନ୍	தாஇவாந்
ତାଞ୍ଜାନିଆ	தாஞ்ஜாநிஆ
ୟୁକ୍ରାଇନ୍	யுக்ராஇந்
ଉଗାଣ୍ଡା	உகாண்டா
ୟୁନାଇଟେଡ୍ ଷ୍ଟେଟସ୍ ମାଇନର୍ ଆଉଟଲେଇଂ ଦ୍ବୀପପୁଞ୍ଜ	யுநாஇடேட் ஷ்டேடஸ் மாஇநர் ஆஉடலேஇஂ த்பீபபுஞ்ஜ
ଯୁକ୍ତ ରାଷ୍ଟ୍ର ଆମେରିକା	யுக்த ராஷ்ட்ர ஆமேரிகா
ଉରୁଗୁଏ	உருகுஏ
ଉଜବେକିସ୍ଥାନ୍	உஜபேகிஸ்தாந்
ଭାଟିକାନ୍	பாடிகாந்
ସେଣ୍ଟ ଭିନସେଣ୍ଟ ଏବଂ ଦି ଗ୍ରେନାଡିସ୍	ஸேண்ட பிநஸேண்ட ஏபஂ தி க்ரேநாடிஸ்
ଭେନଜୁଏଲା	பேநஜுஏலா
ବ୍ରିଟିଶ୍ ଭର୍ଜିନ୍ ଦ୍ବୀପପୁଞ୍ଜ	ப்ரிடிஶ் பர்ஜிந் த்பீபபுஞ்ஜ
ୟୁଏସ୍ ଭର୍ଜିନ୍ ଦ୍ବୀପପୁଞ୍ଜ	யுஏஸ் பர்ஜிந் த்பீபபுஞ்ஜ
ଭିଏତନାମ୍	பிஏதநாம்
ଭାନୁଆତୁ	பாநுஆது
ୱାଲିସ୍ ଏବଂ ଫୁତୁନା	வாலிஸ் ஏபஂ புதுநா
ସାମୋଆ	ஸாமோஆ
ୟେମେନ୍	யேமேந்
ମାୟୋଟେ	மாயோடே
ଦକ୍ଷିଣ ଆଫ୍ରିକା	தக்ஷிண ஆப்ரிகா
ଜାମ୍ବିଆ	ஜாம்பிஆ
ଜିମ୍ବାୱେ	ஜிம்பாவே
ଅଜଣା କିମ୍ବା ଅବୈଧ ପ୍ରଦେଶ	அஜணா கிம்பா அபைத ப்ரதேஶ
