# Baby names
అకుతీ	akutī
అక్సిథీ	aksithī
అచలరాజ	acalarāja
అచలా	acalā
అజగంధా	ajagandhā
అజాణీ	ajāṇī
అజియా	ajiyā
అడ్యాత్రయీ	aḍyātrayī
అదీక్యా	adīkyā
అదృశ	adr̥śa
అదేన్య	adēn'ya
అద్రిక	adrika
అద్రీపతి	adrīpati
అధిక్శీఠా	adhikśīṭhā
అబిభవా	abibhavā
అబీశాఈ	abīśā'ī
అబేల	abēla
అబోఇల	abō'ila
అబ్జా	abjā
అబ్ధీ	abdhī
అబ్బ్య్నాయ్హా	abbynāyhā
అభయ	abhaya
అభయాన	abhayāna
అభిథా	abhithā
అభిథి	abhithi
అభినయ	abhinaya
అభినిత	abhinita
అభినీత	abhinīta
అభిమంద	abhimanda
అభిమానీ	abhimānī
అభిసోకా	abhisōkā
అభిహీతా	abhihītā
అభీచంద్ర	abhīcandra
అభీనాతా	abhīnātā
అభీశీక్తా	abhīśīktā
అభీసుమత	abhīsumata
అభ్జిత	abhjita
అభ్యప్సీత	abhyapsīta
అలకనందా	alakanandā
అశవ	aśava
అశునత	aśunata
అశ్నేఇల	aśnē'ila
అహేలీ	ahēlī
ఆకర్షక	ākarṣaka
ఆచమన	ācamana
ఆతమన	ātamana
ఆత్మజ	ātmaja
ఆత్రయీ	ātrayī
ఆదరవ	ādarava
ఆదర్శా	ādarśā
ఆదర్శీనీ	ādarśīnī
ఆదీప్తా	ādīptā
ఆధరిత	ādharita
ఆధార	ādhāra
ఆధిరా	ādhirā
ఆధిరాఇ	ādhirā'i
ఆధ్యా	ādhyā
ఆనందీ	ānandī
ఆనుష	ānuṣa
ఆబీర	ābīra
ఆభాస	ābhāsa
ఆయనా	āyanā
ఆరమాన	āramāna
ఆరాడ్యా	ārāḍyā
ఆరీవ	ārīva
ఆర్కశ	ārkaśa
ఆర్థీ	ārthī
ఆలాప	ālāpa
ఆల్యా	ālyā
ఆవీ	āvī
ఆశిమ	āśima
ఆస్రీతా	āsrītā
ఆస్లుంనన	āslunnana
ఇందుభూషణ	indubhūṣaṇa
ఇందుమతీ	indumatī
ఇందుముఖీ	indumukhī
ఇందుశేఖర	induśēkhara
ఇతిశ్రీ	itiśrī
ఇధా	idhā
ఇధికా	idhikā
ఇన్గనామ	in'ganāma
ఇన్దారేశ	indārēśa
ఇన్దుదార	indudāra
ఇన్దుబాలా	indubālā
ఇన్ద్రాణీ	indrāṇī
ఇన్ద్రేశ	indrēśa
ఇయురేశ	iyurēśa
ఇలా	ilā
ఇలావేనిల	ilāvēnila
ఇలాశ్పస్తీ	ilāśpastī
ఇశానికా	iśānikā
ఇశాన్వీ	iśānvī
ఇష్య	iṣya
ఇస్లేత	islēta
ఈచ్ఛా	īcchā
ఈన్దుస	īndusa
ఈశాంత	īśānta
ఈశానపుత్ర	īśānaputra
ఉగ్రేశ	ugrēśa
ఉజవణీ	ujavaṇī
ఉజీత్ర	ujītra
ఉజేశ	ujēśa
ఉజ్జమ	ujjama
ఉజ్జవాలా	ujjavālā
ఉత్తల	uttala
ఉత్పర	utpara
ఉత్విక	utvika
ఉత్సర్గ	utsarga
ఉత్సుక	utsuka
ఉదయన	udayana
ఉదయసూరియాఁ	udayasūriyām̐
ఉదేయ	udēya
ఉద్వాహనీ	udvāhanī
ఉధ్గీతా	udhgītā
ఉపనయ	upanaya
ఉపాసనా	upāsanā
ఉమాంపుత్ర	umāmputra
ఉమికా	umikā
ఉలగన	ulagana
ఉల్ముక	ulmuka
ఉషాకిరణ	uṣākiraṇa
ఋచా	r̥cā
ఏకంశీ	ēkanśī
ఏకలవ్య	ēkalavya
ఏకాంత	ēkānta
ఏకాంతా	ēkāntā
ఏకాంతికా	ēkāntikā
ఏకాత్మా	ēkātmā
ఏకావలీ	ēkāvalī
ఏత్తన	ēttana
ఏనక్షీ	ēnakṣī
ఏరీన	ērīna
ఏలామరణ	ēlāmaraṇa
ఏలావేన్ధన	ēlāvēndhana
ఏలుమలాఈ	ēlumalā'ī
ఏవాంశీ	ēvānśī
ఏశానికా	ēśānikā
ఓఇశని	ō'iśani
ఓఈశీ	ō'īśī
ఓజస్వీ	ōjasvī
ఓజస్వీతా	ōjasvītā
ఓజ్జస్వీన	ōjjasvīna
ఓప్పిలమణి	ōppilamaṇi
ఓమలా	ōmalā
ఓమాజా	ōmājā
ఓమేసా	ōmēsā
ఓమ్దుత్త	ōmdutta
ఓవీఏ	ōvī'ē
ఓశమాం	ōśamāṁ
ఓహస	ōhasa
కంగనా	kaṅganā
కంజ	kan̄ja
కంధన	kandhana
కంశ	kanśa
కజరీ	kajarī
కతకీ	katakī
కథీర	kathīra
కథ్యనీ	kathyanī
కదంబన	kadambana
కదంబీ	kadambī
కనక	kanaka
కనాహియా	kanāhiyā
కనిక	kanika
కనిశ్టా	kaniśṭā
కనీషా	kanīṣā
కనుష	kanuṣa
కనైయా	kanaiyā
కన్కేయా	kankēyā
కన్తారవ	kantārava
కన్నన	kannana
కన్హైయా	kanhaiyā
కపిల	kapila
కమసంతక	kamasantaka
కమాన	kamāna
కమాలబంధూ	kamālabandhū
కయాల్వీఝ్హీ	kayālvījhhī
కరబీ	karabī
కరమజీత	karamajīta
కరూణా	karūṇā
కర్ణన	karṇana
కర్తవయా	kartavayā
కలాఈ	kalā'ī
కలానీతీ	kalānītī
కలోల	kalōla
కల్యాణీ	kalyāṇī
కవి	kavi
కవీన్ద్ర	kavīndra
కవీప్రనీతా	kavīpranītā
కవీయాసరీ	kavīyāsarī
కవీరాసన	kavīrāsana
కవీషా	kavīṣā
కశీక	kaśīka
కశ్నీ	kaśnī
కశ్మాంలమ	kaśmānlama
కస్లుంనీరా	kaslunnīrā
కహన	kahana
కహ్లీమాం	kahlīmāṁ
కాంచీ	kān̄cī
కాంతవ	kāntava
కాంతా	kāntā
కాంతామనీ	kāntāmanī
కాంతి	kānti
కాకలీ	kākalī
కాక్షీ	kākṣī
కాన్జీరా	kānjīrā
కామేరీనా	kāmērīnā
కారుం	kāruṁ
కార్తికేయన	kārtikēyana
కార్నిక	kārnika
కాలిందీ	kālindī
కాలిత	kālita
కాలిదాస	kālidāsa
కాలీ	kālī
కాలీదాస	kālīdāsa
కావ్యరజ్సింహ	kāvyarajsinha
కావ్యా	kāvyā
కాసనీ	kāsanī
కిరాత	kirāta
కేంగా	kēṅgā
కేఈశా	kē'īśā
కేతక	kētaka
కేతవ	kētava
కేతాఘనీ	kētāghanī
కేనాలీ	kēnālī
కేనీత	kēnīta
కేనీల	kēnīla
కేల్వీన	kēlvīna
కేవ్లీనా	kēvlīnā
కేసరీనందన	kēsarīnandana
కేసవ	kēsava
కేసవారాజ	kēsavārāja
కైతవ	kaitava
కైశిక	kaiśika
కౌర్వాకీ	kaurvākī
ఖగేశ	khagēśa
ఖాజిత	khājita
ఖానామ	khānāma
ఖామారీ	khāmārī
ఖాశ్వీ	khāśvī
ఖుశీకా	khuśīkā
ఖుశ్మీతా	khuśmītā
ఖైలాశ	khailāśa
గంగవార	gaṅgavāra
గంగోల	gaṅgōla
గందిరా	gandirā
గంధారా	gandhārā
గగనాసరీ	gaganāsarī
గగ్నేశ	gagnēśa
గజగామినీ	gajagāminī
గజరా	gajarā
గజలక్ష్మీ	gajalakṣmī
గజానన	gajānana
గతితా	gatitā
గత్రికా	gatrikā
గదీన	gadīna
గధాధర	gadhādhara
గన్గసీరువన	gan'gasīruvana
గరిష్ట	gariṣṭa
గరుల	garula
గర్గ	garga
గాథా	gāthā
గాయక	gāyaka
గిరీ	girī
గీతా సుహానీ	gītā suhānī
గీరీచంద్ర	gīrīcandra
గీరీనాథ	gīrīnātha
గీర్వేన	gīrvēna
గీశుం	gīśuṁ
గుదాకేశ	gudākēśa
గునవంత	gunavanta
గునాలన	gunālana
గునితా	gunitā
గురశరణ	guraśaraṇa
గురురాజా	gururājā
గృహ్యా	gr̥hyā
గేహనా	gēhanā
గోఉరబ	gō'uraba
గోకుల	gōkula
గోదావరీ	gōdāvarī
గోపాల	gōpāla
గోపీ	gōpī
గోబీకా	gōbīkā
గోమాంథీ	gōmānthī
గోరల	gōrala
గోవీనేశ	gōvīnēśa
గోవీన్దారాజ	gōvīndārāja
గోశీతా	gōśītā
గౌరీ	gaurī
గ్నాపీకా	gnāpīkā
గ్రంథిక	granthika
గ్రహిత	grahita
గ్రీతిక	grītika
ఘటా	ghaṭā
ఘనావీ	ghanāvī
ఘోరరుపా	ghōrarupā
ఘోశీనీ	ghōśīnī
ఘోషా	ghōṣā
ఘ్యాన	ghyāna
చందక	candaka
చందనా లక్ష్మీ	candanā lakṣmī
చంద్రకలా	candrakalā
చంద్రకాంత	candrakānta
చంద్రకిశోర	candrakiśōra
చంద్రమాం	candramāṁ
చంద్రమౌలీ	candramaulī
చంద్రలేక్షా	candralēkṣā
చంద్రహాస	candrahāsa
చంద్రాయణ	candrāyaṇa
చక్రిక	cakrika
చక్రికా	cakrikā
చక్రియా	cakriyā
చక్షస	cakṣasa
చన్ద్రకేతు	candrakētu
చన్ద్రజ్యోతీ	candrajyōtī
చన్నాప్పా	cannāppā
చరణ  రాజ	caraṇa  rāja
చరణరజ	caraṇaraja
చరీథా	carīthā
చరులా	carulā
చరుశీల	caruśīla
చాతీమాం	cātīmāṁ
చాతుర్య	cāturya
చామీనీ	cāmīnī
చారుతా	cārutā
చారుహస	cāruhasa
చారుహాస	cāruhāsa
చాశ్ముమ	cāśmuma
చాహనా	cāhanā
చింతక	cintaka
చింతా	cintā
చిత్తప్రసాద	cittaprasāda
చిత్రంశీ	citranśī
చిత్రఅక్షాం	citra'akṣāṁ
చిత్రకూట సమాంశ్రాయా	citrakūṭa samānśrāyā
చిత్రబానా	citrabānā
చిత్రలేఖా	citralēkhā
చిత్రాంగీ	citrāṅgī
చిత్రాదీప	citrādīpa
చిత్రాదేవీ	citrādēvī
చిత్రీనీ	citrīnī
చిన్మయానందా	cinmayānandā
చిమాయీ	cimāyī
చీథాన్యలాథా	cīthān'yalāthā
చీనీత్య	cīnītya
చీన్నీః	cīnnīḥ
చీరాన్తానా	cīrāntānā
చేతన	cētana
చేతన్దీప	cētandīpa
చేతన్సాఈ	cētansā'ī
చేథనా	cēthanā
చేననా	cēnanā
చేరన్రాజ	cēranrāja
చేరాస్య	cērāsya
చేష్టా	cēṣṭā
చైతాలీ	caitālī
చైన	caina
చైసరణ	caisaraṇa
జగజీత	jagajīta
జగతపాల	jagatapāla
జగనమోహన	jaganamōhana
జగనమోహినీ	jaganamōhinī
జగ్రవీ	jagravī
జతన	jatana
జతాస్యా	jatāsyā
జత్యా	jatyā
జనకనందినీ	janakanandinī
జనావ	janāva
జన్మయా	janmayā
జప్తేశ	japtēśa
జమునా	jamunā
జయకిరన	jayakirana
జయప్రభా	jayaprabhā
జయలేన	jayalēna
జయాద్రాతా	jayādrātā
జయాన్థ్య	jayānthya
జరాసంధా	jarāsandhā
జలధర	jaladhara
జలస	jalasa
జలార్క	jalārka
జలీతా	jalītā
జవాస	javāsa
జవాహరీ	javāharī
జశంక	jaśaṅka
జసల	jasala
జసు	jasu
జసోదా	jasōdā
జస్మీథా	jasmīthā
జస్మీథ్యా	jasmīthyā
జస్వందీ	jasvandī
జహానవీ	jahānavī
జహితా	jahitā
జహేన్కార	jahēnkāra
జాంసీ	jānsī
జాగృతి	jāgr̥ti
జాగేశ	jāgēśa
జాగ్రతి	jāgrati
జాఝీమ	jājhīma
జానవీ	jānavī
జిఅనా	ji'anā
జిగీషా	jigīṣā
జితేన్ద్రియ	jitēndriya
జిల్పా	jilpā
జీగాయాంశ	jīgāyānśa
జీజీద	jījīda
జీజేశ	jījēśa
జీతాకమ	jītākama
జీతేశ	jītēśa
జీనయ	jīnaya
జీరల	jīrala
జీల	jīla
జీవజ	jīvaja
జీవానాన్ధామ	jīvānāndhāma
జీవిథా	jīvithā
జుఈ	ju'ī
జూహీ	jūhī
జేఈనన	jē'īnana
జేగన	jēgana
జేత్వీక	jētvīka
జేయాన్ద్రణ	jēyāndraṇa
జేలక్ష్మీ	jēlakṣmī
జేశన	jēśana
జేహాన్నాఝ	jēhānnājha
జైచంద	jaicanda
జైదిశ	jaidiśa
జైదీశ	jaidīśa
జైదేవ	jaidēva
జైలేణ	jailēṇa
జ్ఞానవ	jñānava
జ్ఞానా	jñānā
జ్య భగవాన	jya bhagavāna
జ్యోతిబాలా	jyōtibālā
జ్యోత్సనీ	jyōtsanī
జ్హోశీల	j'hōśīla
ఝంకృత	jhaṅkr̥ta
ఝరల	jharala
ఝినూక	jhinūka
ఝియాన	jhiyāna
ఝేన్శీ	jhēnśī
ఝ్యాననీ	jhyānanī
టీనా	ṭīnā
ఠాకరశీ	ṭhākaraśī
ఠుమకీ	ṭhumakī
తంగసామీ	taṅgasāmī
తంగామనీ	taṅgāmanī
తక్షక	takṣaka
తనిష	taniṣa
తనీశా	tanīśā
తనుం ప్రియా	tanuṁ priyā
తనుంజాశ్రీ	tanun̄jāśrī
తనుపా	tanupā
తనుశ్రీ	tanuśrī
తన్మయ	tanmaya
తమిరా	tamirā
తమోఘ్నా	tamōghnā
తరాశా	tarāśā
తరిత	tarita
తరుణ	taruṇa
తరునా	tarunā
తరులతా	tarulatā
తరుశ్రీ	taruśrī
తర్పనా	tarpanā
తర్లికా	tarlikā
తస్మయ	tasmaya
తహేలీ	tahēlī
తాక్ష్యా	tākṣyā
తానాయ్మీ	tānāymī
తానికా	tānikā
తానీగాఈ	tānīgā'ī
తానీసకా	tānīsakā
తానులీప	tānulīpa
తానుసియా	tānusiyā
తాన్శ్రాయ	tānśrāya
తాప్తీ	tāptī
తామాస్వినీ	tāmāsvinī
తారకేశ	tārakēśa
తారాక్ష	tārākṣa
తారానీసేన	tārānīsēna
తారూశ	tārūśa
తిమిన	timina
తిరు	tiru
తిరుపథీ	tirupathī
తీననీ	tīnanī
తీరుమరణ	tīrumaraṇa
తుంష్యతీ	tunṣyatī
తుక్సా	tuksā
తునావా	tunāvā
తుపమ	tupama
తుర్వీ	turvī
తులసీలతా	tulasīlatā
తులికా	tulikā
తులీ	tulī
తులీనదార	tulīnadāra
తుశారా	tuśārā
తుసరికా	tusarikā
తేగవిర	tēgavira
తేజీ	tējī
తేజేన్ద్ర	tējēndra
తేనుం	tēnuṁ
తేవాన	tēvāna
తోయేశ	tōyēśa
తోరుం	tōruṁ
తౌతిక	tautika
తౌలీక	taulīka
త్రిజగతి	trijagati
త్రినాథ	trinātha
త్రిలోకేశ	trilōkēśa
త్రిలోచనా	trilōcanā
త్రిశల	triśala
త్రిశులినీ	triśulinī
త్రిషర	triṣara
త్రీజోయా	trījōyā
త్రీపుర్తి	trīpurti
త్రీయోగ	trīyōga
త్రీవిదా	trīvidā
త్వరితా	tvaritā
థంసీ	thansī
థయా	thayā
థార్సీన	thārsīna
థీక్శీకా	thīkśīkā
థీనీథా	thīnīthā
థేజల	thējala
థ్రీశంఠ	thrīśaṇṭha
దందాపానీ	dandāpānī
దక్శీన్య	dakśīn'ya
దక్షిత	dakṣita
దక్షీణ	dakṣīṇa
దనీలా	danīlā
దన్యతా	dan'yatā
దయానిధి	dayānidhi
దరరేన	dararēna
దరిద్రా ధావ్సీనీ	daridrā dhāvsīnī
దరిద్రీయానాశీనీ	daridrīyānāśīnī
దర్పిత	darpita
దర్మీనీ	darmīnī
దర్మేన్దర	darmēndara
దర్శనా	darśanā
దర్శ్వానా	darśvānā
దలపతి	dalapati
దలాపథీ	dalāpathī
దల్శేర	dalśēra
దహా	dahā
దానాస్వీ	dānāsvī
దానీశ	dānīśa
దామినీ	dāminī
దారుకా	dārukā
దిబసరీ	dibasarī
దిబ్యా	dibyā
దివీథా	divīthā
దిశీతా	diśītā
దీక్శీకా	dīkśīkā
దీక్షానా	dīkṣānā
దీపక	dīpaka
దీపథీ	dīpathī
దీపా లక్ష్మీ	dīpā lakṣmī
దీపాంశ	dīpānśa
దీపేందు	dīpēndu
దీప్తిమాన	dīptimāna
దేజ	dēja
దేబజ్యోతీ	dēbajyōtī
దేబన్శీ	dēbanśī
దేబ్ప్రతిమ	dēbpratima
దేబ్ప్రసాద	dēbprasāda
దేయాశీనీ	dēyāśīnī
దేవకలీ	dēvakalī
దేవదత్తా	dēvadattā
దేవదర్శన	dēvadarśana
దేవనారాయణ	dēvanārāyaṇa
దేవమతి	dēvamati
దేవాదార్స	dēvādārsa
దేవాన్శీ	dēvānśī
దేవారహాల్లీ	dēvārahāllī
దేవారీశీ	dēvārīśī
దేవార్యా	dēvāryā
దేవాశ్రీ	dēvāśrī
దేవాస్మిథా	dēvāsmithā
దేవినా	dēvinā
దేవేశీ	dēvēśī
దేవేసీ	dēvēsī
దేవ్యశీ	dēvyaśī
దేశనీ	dēśanī
దేశిక	dēśika
దైపాయన	daipāyana
ధనాశ్రీ	dhanāśrī
ధనాస్వీ	dhanāsvī
ధనుస	dhanusa
ధరనీ	dharanī
ధరమనిష్ఠ	dharamaniṣṭha
ధరానిశ	dharāniśa
ధర్మజా	dharmajā
ధర్మదాస	dharmadāsa
ధర్మదేవ	dharmadēva
ధర్శానీ	dharśānī
ధర్శీనీ	dharśīnī
ధర్శీనీకా	dharśīnīkā
ధవల	dhavala
ధాన	dhāna
ధానశ్రీ	dhānaśrī
ధానీశ్కా	dhānīśkā
ధామ	dhāma
ధామన	dhāmana
ధారణా	dhāraṇā
ధారనా	dhāranā
ధావక	dhāvaka
ధీక్శీథా	dhīkśīthā
ధీయాన	dhīyāna
ధీవాశీనీ	dhīvāśīnī
ధుమావతీ	dhumāvatī
ధూన	dhūna
ధృతి	dhr̥ti
ధేయాంశీ	dhēyānśī
ధైర్యశీల	dhairyaśīla
ధోశీనీ	dhōśīnī
ధ్రాస్తీ	dhrāstī
నంద	nanda
నందలాల	nandalāla
నందినీ	nandinī
నందీఘోష	nandīghōṣa
నక్షాత్ర	nakṣātra
నగరజన	nagarajana
నగా మాంల్లేస్వారీ	nagā mānllēsvārī
నచికేతాస	nacikētāsa
నటరాజన	naṭarājana
నభా	nabhā
నభాన్యు	nabhān'yu
నభోజ	nabhōja
నమ్రతా	namratā
నరేన	narēna
నరేన్దేర	narēndēra
నర్తానా	nartānā
నర్మద	narmada
నర్మదా	narmadā
నలినా	nalinā
నలేశ	nalēśa
నవకార	navakāra
నవరాజ	navarāja
నవితా	navitā
నాగదాతా	nāgadātā
నాగనాథ	nāganātha
నాగరాజు	nāgarāju
నాగేశ్వర	nāgēśvara
నాతాభైరవీ	nātābhairavī
నాతేసన	nātēsana
నాధీనీ	nādhīnī
నాన్నాన	nānnāna
నామదేవ	nāmadēva
నామాంనారాయనీ	nāmānnārāyanī
నామాంశీ	nāmānśī
నామీశా	nāmīśā
నారన	nārana
నారాయన	nārāyana
నారీనే	nārīnē
నావేతా	nāvētā
నాహర	nāhara
నికేతా	nikētā
నిఖార	nikhāra
నిఖాల	nikhāla
నితల	nitala
నిదాన	nidāna
నిధ్యానా	nidhyānā
నినాద	nināda
నిమల	nimala
నిమేశ	nimēśa
నిరంజనీ	niran̄janī
నిరాంత	nirānta
నిరాధార	nirādhāra
నిర్మళా	nirmaḷā
నిలారూనా	nilārūnā
నిలావోలీ	nilāvōlī
నిలీన	nilīna
నిశ్కా	niśkā
నిష్ణాం	niṣṇāṁ
నీకశ	nīkaśa
నీకాన్దర్య	nīkāndarya
నీకాశా	nīkāśā
నీకుంజా	nīkun̄jā
నీక్కుం	nīkkuṁ
నీఖేల	nīkhēla
నీగీ	nīgī
నీచికా	nīcikā
నీధాన	nīdhāna
నీనీశా	nīnīśā
నీపునా	nīpunā
నీబోధీతా	nībōdhītā
నీభా	nībhā
నీమ్రిత	nīmrita
నీరాలీ	nīrālī
నీల కాంతా	nīla kāntā
నీలనీ	nīlanī
నీలమణి	nīlamaṇi
నీలాంజనా	nīlān̄janā
నీలాబ్జా	nīlābjā
నీలామ్బరీ	nīlāmbarī
నీలేశ	nīlēśa
నీవ	nīva
నీశ్రుతా	nīśrutā
నీసమాం	nīsamāṁ
నీహన	nīhana
నేదుమాన	nēdumāna
నేమీ	nēmī
నేమీశా	nēmīśā
నైంశీ	nainśī
నైజా	naijā
నైమాథ	naimātha
నైషా	naiṣā
పంచావక్త్ర	pan̄cāvaktra
పంధారీ	pandhārī
పద్మనాభ	padmanābha
పద్మనాభా	padmanābhā
పద్మరేఖా	padmarēkhā
పద్మల	padmala
పద్మలోచన	padmalōcana
పద్మాంనాభాన	padmānnābhāna
పద్మాంనేత్ర	padmānnētra
పద్మాకలీ	padmākalī
పద్మాక్షీ	padmākṣī
పద్మామ	padmāma
పద్మారాజ	padmārāja
పనితా	panitā
పన్కీల	pankīla
పన్కోజ	pankōja
పన్యశ్రీ	pan'yaśrī
పమ్బా	pambā
పరణావీ	paraṇāvī
పరబ్రహ్మనా	parabrahmanā
పరమ-హంస	parama-hansa
పరమేశ్వరీ	paramēśvarī
పరసమే	parasamē
పరాగ	parāga
పరాన్జయ	parānjaya
పరామితా	parāmitā
పరిణీతా	pariṇītā
పరీశుధ	parīśudha
పరు	paru
పరుశీ	paruśī
పర్తిక	partika
పర్వతీప్రిత	parvatīprita
పలానీచామ్య	palānīcāmya
పలాశకుసూమ	palāśakusūma
పల్లవిత	pallavita
పళవా	paḷavā
పవనసుత	pavanasuta
పవీథా	pavīthā
పవీన	pavīna
పవీశ	pavīśa
పవీశీకా	pavīśīkā
పాండురంగ	pāṇḍuraṅga
పాగలావన	pāgalāvana
పాటవ	pāṭava
పాణినీ	pāṇinī
పానీక	pānīka
పాయోధర	pāyōdhara
పారమితా	pāramitā
పారవాథీ	pāravāthī
పారిజాత	pārijāta
పార్థే	pārthē
పావకీ	pāvakī
పావలీన	pāvalīna
పావానా	pāvānā
పింగా	piṅgā
పినాకిన	pinākina
పీఅల్లీ	pī'allī
పీయుశా	pīyuśā
పీరనీథా	pīranīthā
పీహూ	pīhū
పూజా	pūjā
పూజిత	pūjita
పూనిశ	pūniśa
పూర్వికా	pūrvikā
పూర్వీ	pūrvī
పేమల	pēmala
పోంనన	pōnnana
పోగులా	pōgulā
పోన్మాంలా	pōnmānlā
పోరోమాం	pōrōmāṁ
పౌలోమీ	paulōmī
ప్రకారనా	prakāranā
ప్రగ్నీకా	pragnīkā
ప్రచీతా	pracītā
ప్రనాయా	pranāyā
ప్రనావ్యా	pranāvyā
ప్రబంజన	praban̄jana
ప్రబకరణ	prabakaraṇa
ప్రభావ	prabhāva
ప్రమ్లాతా	pramlātā
ప్రహాసా	prahāsā
ప్రాగీ	prāgī
ప్రాచికా	prācikā
ప్రాణ	prāṇa
ప్రానక	prānaka
ప్రానల	prānala
ప్రాశా	prāśā
ఫనిన్ద్రనాథ	phanindranātha
ఫాల్గున	phālguna
ఫాల్గునీ	phālgunī
ఫాల్యా	phālyā
ఫుతికా	phutikā
ఫూలమాలా	phūlamālā
ఫూలేందు	phūlēndu
ఫేనిల	phēnila
బటుక	baṭuka
బద్రీ	badrī
బద్రీనాథ	badrīnātha
బనవారీ	banavārī
బన్శిక	banśika
బన్హీ	banhī
బబితా	babitā
బరన	barana
బరసాత	barasāta
బరిద	barida
బరున	baruna
బలదేవ	baladēva
బలప్రదా	balapradā
బలరామ	balarāma
బలవీర	balavīra
బల్మానీ	balmānī
బవిశ్యా	baviśyā
బాంకేబిహారీ	bāṅkēbihārī
బాంసురీ	bānsurī
బాల కృష్ణ	bāla kr̥ṣṇa
బాలక్రిష్నా	bālakriṣnā
బాలా	bālā
బాలారాజ	bālārāja
బాలారామ	bālārāma
బాలాశంకర	bālāśaṅkara
బాళ గణపతి	bāḷa gaṇapati
బావరీ	bāvarī
బావీన	bāvīna
బిందియా	bindiyā
బినీతా	binītā
బిమల	bimala
బిమలా	bimalā
బిల్వా	bilvā
బీనాతా	bīnātā
బీన్కాల	bīnkāla
బీన్దేశ్వర	bīndēśvara
బీన్నీకేర	bīnnīkēra
బీప్రా	bīprā
బీసలతా	bīsalatā
బుధీప్రియా	budhīpriyā
బేకురీ	bēkurī
బేథినా	bēthinā
బేలావార్ధానా	bēlāvārdhānā
బ్రహ్మావతీ	brahmāvatī
బ్రీన్ధా	brīndhā
భక్తావాత్సలా	bhaktāvātsalā
భక్తి	bhakti
భగదిత్య	bhagaditya
భద్రీశా	bhadrīśā
భవాద	bhavāda
భవ్య శ్రీ	bhavya śrī
భాగవాథ్య	bhāgavāthya
భాగేశ	bhāgēśa
భాగ్యా	bhāgyā
భానీశ	bhānīśa
భాన్ధవీ	bhāndhavī
భాలేంద్ర	bhālēndra
భావ	bhāva
భావిన	bhāvina
భావేశ్వారీ	bhāvēśvārī
భావ్నీశ	bhāvnīśa
భావ్యశ్రీ	bhāvyaśrī
భాశ్వీనీ	bhāśvīnī
భాస్వన	bhāsvana
భాస్వాథ	bhāsvātha
భిమేశ	bhimēśa
భీఖీ	bhīkhī
భీమా	bhīmā
భీలానగనా	bhīlānaganā
భీష్మ	bhīṣma
భువనేశ్వరీ	bhuvanēśvarī
భువన్పతీ	bhuvanpatī
భువేశ	bhuvēśa
భూతేశ్వర	bhūtēśvara
భూపేన్ద్ర	bhūpēndra
భూమత	bhūmata
భూమిక	bhūmika
భూమీజా	bhūmījā
భోజరాజా	bhōjarājā
భ్రమర	bhramara
భ్రిథీ	bhrithī
మంగలమూర్తి	maṅgalamūrti
మంజుల	man̄jula
మంజులా	man̄julā
మందాకినీ	mandākinī
మందాక్రాంతా	mandākrāntā
మణిశంకర	maṇiśaṅkara
మదిర	madira
మదేశ	madēśa
మద్వాన	madvāna
మధుప	madhupa
మధుపాల	madhupāla
మధురానీ	madhurānī
మధులా	madhulā
మధుశా	madhuśā
మధుసూదన	madhusūdana
మనన	manana
మనప	manapa
మనమోహన	manamōhana
మనస్విన	manasvina
మనాగోబీనదా	manāgōbīnadā
మనీమ	manīma
మనోమయ	manōmaya
మనోహర	manōhara
మనోహరణ	manōharaṇa
మన్మాయీ	manmāyī
మన్విత	manvita
మన్వీర	manvīra
మల్లేశ	mallēśa
మశీనీ	maśīnī
మహాయోగీన	mahāyōgīna
మహారావణమర్దానా	mahārāvaṇamardānā
మహాలీన్గమ	mahālīn'gama
మహింద్రా	mahindrā
మహీథా	mahīthā
మహేర	mahēra
మహేశీ	mahēśī
మహేశ్వర	mahēśvara
మాంగలీ	māṅgalī
మాంగేశ్వారీ	māṅgēśvārī
మాందవ	māndava
మాంన్గ్గౌర్దీ	mānn'ggaurdī
మాంన్జీరీ	mānnjīrī
మాంన్దారికా	mānndārikā
మాంన్వితా	mānnvitā
మాంరుతాత్మాజా	mānrutātmājā
మాతంగీ	mātaṅgī
మాతన	mātana
మాధవిలతా	mādhavilatā
మాధుకేశ	mādhukēśa
మాధుర్య	mādhurya
మానధన	mānadhana
మానీక్యా	mānīkyā
మాన్యసరీ	mān'yasarī
మాయుఖీ	māyukhī
మారూత	mārūta
మార్గీన	mārgīna
మార్తండ	mārtaṇḍa
మాలారవిలీ	mālāravilī
మాసమాం	māsamāṁ
మీనల	mīnala
మైత్రా	maitrā
మైనాలీ	mainālī
మైనావీ	maināvī
మైరవా	mairavā
మౌలీశా	maulīśā
యక్ష	yakṣa
యజత	yajata
యజుర్వ	yajurva
యతావన	yatāvana
యత్నేశ	yatnēśa
యదు	yadu
యదుక్రిష్నా	yadukriṣnā
యదునందన	yadunandana
యవనా	yavanā
యశవర్ధన	yaśavardhana
యశికా	yaśikā
యశ్వీ	yaśvī
యశ్శ్రీ	yaśśrī
యాజ్నా	yājnā
యాతన	yātana
యాతనా	yātanā
యాత్నీక	yātnīka
యాత్వికా	yātvikā
యాదమమాం	yādamamāṁ
యాదీతా	yādītā
యాద్నేశ	yādnēśa
యామికా	yāmikā
యాశీకా	yāśīkā
యాసస్వీ	yāsasvī
యుంగేన్దర	yuṅgēndara
యుగన్తీకా	yugantīkā
యుగా	yugā
యుగీన	yugīna
యుధావ	yudhāva
యుధీష్ఠీర	yudhīṣṭhīra
యుధ్ధ	yudhdha
యుయుత్సు	yuyutsu
యువతీ	yuvatī
యువాసరీ	yuvāsarī
యుసు	yusu
యూరా	yūrā
యేక్షిత	yēkṣita
యేఘరాజ	yēgharāja
యేశాస్వీనీ	yēśāsvīnī
యేశ్మిత	yēśmita
యేస్వంఠ	yēsvaṇṭha
యోగధీపా	yōgadhīpā
యోగలక్ష్మీ	yōgalakṣmī
యోగా	yōgā
యోగాజా	yōgājā
యోగానంద	yōgānanda
యోగీ	yōgī
యోగేశ్వర	yōgēśvara
యోగ్నవీ	yōgnavī
యోజనా	yōjanā
యోనితా	yōnitā
యోనేన్ద్ర	yōnēndra
యోషిత	yōṣita
యోసనా	yōsanā
యోహ్శీనీ	yōhśīnī
రంగప్రసాత	raṅgaprasāta
రంగరాజన	raṅgarājana
రంగీత	raṅgīta
రంజన	ran̄jana
రంజినీ	ran̄jinī
రంహ	ranha
రక్త	rakta
రక్తకమళ	raktakamaḷa
రక్తీమాం	raktīmāṁ
రక్షాద	rakṣāda
రక్షావనరసంగథీనే	rakṣāvanarasaṅgathīnē
రగవార్శీనీ	ragavārśīnī
రగిశ	ragiśa
రగునాన్తన	ragunāntana
రజనీ	rajanī
రజిత	rajita
రజినిపతి	rajinipati
రజీనీ	rajīnī
రజీబ	rajība
రజోఅబా	rajō'abā
రణబీర	raṇabīra
రతనమ	ratanama
రత్నాలీ	ratnālī
రత్నావలీ	ratnāvalī
రత్న్ప్రీయా	ratnprīyā
రథనా	rathanā
రదీతే	radītē
రబేక	rabēka
రమాంలీన్గమ	ramānlīn'gama
రమాంవితా	ramānvitā
రమేశ్వరీ	ramēśvarī
రర్నా	rarnā
రవి కాన్త	ravi kānta
రవిజ	ravija
రవిన్శు	ravinśu
రవిశంకర	raviśaṅkara
రవిశరణ	raviśaraṇa
రవీకిరణ	ravīkiraṇa
రవీచక్ర	ravīcakra
రవీతేజా	ravītējā
రవీయంకీ	ravīyaṅkī
రవేన	ravēna
రశీల	raśīla
రశేష	raśēṣa
రశ్వంత	raśvanta
రసికా	rasikā
రాగ్వీనదార	rāgvīnadāra
రాజ  కిరణ	rāja  kiraṇa
రాజతిలక	rājatilaka
రాజనాథ	rājanātha
రాజన్య	rājan'ya
రాజమ	rājama
రాజవంత	rājavanta
రాజసేకరణ	rājasēkaraṇa
రాజహంసా	rājahansā
రాజాథీ	rājāthī
రాజూ	rājū
రాజేంద్రమోహన	rājēndramōhana
రాజేశ	rājēśa
రాజ్వార్దన	rājvārdana
రాధనా	rādhanā
రాధేయ	rādhēya
రాధ్యా	rādhyā
రాబేన	rābēna
రామ  సేవక	rāma  sēvaka
రామచంద్ర	rāmacandra
రామదాస	rāmadāsa
రామనాథ	rāmanātha
రామనారాయణ	rāmanārāyaṇa
రామమోహన	rāmamōhana
రావణ	rāvaṇa
రావలీ	rāvalī
రాశిమ	rāśima
రాష్పల	rāṣpala
రాహనీ	rāhanī
రాహుల	rāhula
రినీ	rinī
రియా	riyā
రీఅనా	rī'anā
రీతోమాం	rītōmāṁ
రీథానా	rīthānā
రీథీశా	rīthīśā
రీథేకా	rīthēkā
రీథ్వీ	rīthvī
రీధుశనీ	rīdhuśanī
రీపాంశీ	rīpānśī
రీశీప్రియా	rīśīpriyā
రీశుం	rīśuṁ
రేఖా	rēkhā
రేచల	rēcala
రేణు	rēṇu
రేశమ	rēśama
రేశ్వింద	rēśvinda
రౌశన	rauśana
ర్హియా	r'hiyā
ల వేశ	la vēśa
లక్షన్య	lakṣan'ya
లక్ష్మణ	lakṣmaṇa
లక్ష్మీదేవీ	lakṣmīdēvī
లగాన	lagāna
లజ్జా	lajjā
లజ్జాన	lajjāna
లతికా	latikā
లశీతా	laśītā
లాడలీ	lāḍalī
లాథీకా	lāthīkā
లాభా	lābhā
లామ్బోధార	lāmbōdhāra
లాయక	lāyaka
లారా	lārā
లాలాతక్షా	lālātakṣā
లావణ్య	lāvaṇya
లావానయ	lāvānaya
లావీత్ర	lāvītra
లావీశ	lāvīśa
లాస్రీథా	lāsrīthā
లిబ్నీ	libnī
లియన	liyana
లీకీలేశ	līkīlēśa
లీక్సీథా	līksīthā
లీగ	līga
లీన్సీ	līnsī
లీపికా	līpikā
లీషణ	līṣaṇa
లుకేశ	lukēśa
లేఈవీనా	lē'īvīnā
లేఖ	lēkha
లేఖిత	lēkhita
లేథీకా	lēthīkā
లేమార	lēmāra
లోఉకిక	lō'ukika
లోఉక్యీనీ	lō'ukyīnī
లోకరంజన	lōkaran̄jana
లోకాపుజ్య	lōkāpujya
లోక్యా	lōkyā
లోమశ	lōmaśa
లోలా	lōlā
లోవ్యమ	lōvyama
లోశానా	lōśānā
లోహీతాక్ష	lōhītākṣa
వంచిత	van̄cita
వంచితా	van̄citā
వంశజా	vanśajā
వక్తి	vakti
వచన	vacana
వజ్రబాహూ	vajrabāhū
వజ్రాకాయా	vajrākāyā
వజ్రాజిత	vajrājita
వనజా	vanajā
వనినీ	vaninī
వనియా	vaniyā
వనీత	vanīta
వన్ధానా	vandhānā
వయుజత	vayujata
వయ్శీనీ	vayśīnī
వరదావీనాయకా	varadāvīnāyakā
వరహీ	varahī
వరిన	varina
వరియాస	variyāsa
వరునాగురుం	varunāguruṁ
వరునాప్రియా	varunāpriyā
వరునేశ	varunēśa
వరేణ్య	varēṇya
వరేన్ద్ర	varēndra
వరేసీఖ	varēsīkha
వర్చస	varcasa
వర్ణికా	varṇikā
వర్ధమాన	vardhamāna
వర్ధానీ	vardhānī
వర్నీశా	varnīśā
వర్శనేయా	varśanēyā
వర్శాల	varśāla
వర్శీద	varśīda
వర్ష	varṣa
వర్షీత	varṣīta
వర్షేనీ	varṣēnī
వలాక	valāka
వశీకరణ	vaśīkaraṇa
వశీతా	vaśītā
వసవీ	vasavī
వసుదేవన	vasudēvana
వాకుల	vākula
వాచాస్య	vācāsya
వాత్సల్య	vātsalya
వాత్సల్రాజ	vātsalrāja
వాదిశ	vādiśa
వానాజక్ష	vānājakṣa
వానిఏ	vāni'ē
వానుం	vānuṁ
వాన్శుల	vānśula
వాన్సీకా	vānsīkā
వామిల	vāmila
వామీకా	vāmīkā
వామ్నాయీ	vāmnāyī
వామ్శీథా	vāmśīthā
వామ్సిధార	vāmsidhāra
వాయున	vāyuna
వాయునా	vāyunā
వారుణీ	vāruṇī
వారునీ	vārunī
వాల్లాకీ	vāllākī
వాసన్తీ	vāsantī
వాసుశ్రీ	vāsuśrī
వాహీలా	vāhīlā
వికీశా	vikīśā
విక్నేస్వారీ	viknēsvārī
విజైతా	vijaitā
విదీకా	vidīkā
విదుషీ	viduṣī
విద్యాలక్ష్మీ	vidyālakṣmī
వినతి	vinati
వినాపానీ	vināpānī
వినావాదీనీ	vināvādīnī
విన్ధుజా	vindhujā
విభాంశు	vibhānśu
విభాత్సుం	vibhātsuṁ
విభావ	vibhāva
విభావాసు	vibhāvāsu
విభిశానా ప్రతీశ్త్తాత్రే	vibhiśānā pratīśttātrē
విరాజు	virāju
విరాస్వామ్య	virāsvāmya
విలాసితా	vilāsitā
విహారికా	vihārikā
వీక్షా	vīkṣā
వీణాధారీ	vīṇādhārī
వీహా	vīhā
వేక్శనా	vēkśanā
వేద ఆర్యన	vēda āryana
వేదవల్లీ	vēdavallī
వేదవ్రతా	vēdavratā
వేదీష	vēdīṣa
వేనీధర	vēnīdhara
వేనుం గోపాల	vēnuṁ gōpāla
వేనుమాధవ	vēnumādhava
వేన్కాత్రమణ	vēnkātramaṇa
వేన్కాత్శీవా	vēnkātśīvā
వేర్నీకా	vērnīkā
వైకుంఠ నాథ	vaikuṇṭha nātha
వైజయీ	vaijayī
వైదిక	vaidika
వైద్యుంత	vaidyunta
వైధవీక	vaidhavīka
వైధాఈ	vaidhā'ī
వైనావీ	vaināvī
శక్తిధార్య	śaktidhārya
సంకీతా	saṅkītā
సంగత	saṅgata
సంగ్రామ	saṅgrāma
సంచాయా	san̄cāyā
సంచాలీ	san̄cālī
సంజన	san̄jana
సంజయా	san̄jayā
సంజితా	san̄jitā
సంజీతీ	san̄jītī
సంజీథా	san̄jīthā
సంతయానీ	santayānī
సందతా	sandatā
సందీప	sandīpa
సందీపన	sandīpana
సందీపేన	sandīpēna
సంబిత	sambita
సంయోగితా	sanyōgitā
సంవిధా	sanvidhā
సంహిత	sanhita
సంహితా	sanhitā
సఈ దిపక	sa'ī dipaka
సకలేశ్వర	sakalēśvara
సకుంజ	sakun̄ja
సకేశ	sakēśa
సగుణ	saguṇa
సగునా	sagunā
సచంద్ర	sacandra
సచ్చిత	saccita
సచ్చిదానందా	saccidānandā
సదా	sadā
సదా శివమ	sadā śivama
సదానంద	sadānanda
సదాశివ	sadāśiva
సద్గుణ	sadguṇa
సనత	sanata
సనల	sanala
సనాతనా	sanātanā
సనావ్య	sanāvya
సనీత	sanīta
సన్థీమాంథీ	santhīmānthī
సన్నిధి	sannidhi
సపనా దేవీ	sapanā dēvī
సప్తోమీ	saptōmī
సబ్రేశ	sabrēśa
సమరేందు	samarēndu
సమర్థ	samartha
సమవర్త	samavarta
సమాంర్ధ	samānrdha
సమితా	samitā
సమీన	samīna
సమీరన	samīrana
సమీసా	samīsā
సముదాయ	samudāya
సమృద్ధి	samr̥d'dhi
సమ్ప్రీతీ	samprītī
సమ్ప్రీయా	samprīyā
సమ్ముద	sam'muda
సమ్రీధా	samrīdhā
సమ్వీథ	samvītha
సరసతీ	sarasatī
సరస్వతీ	sarasvatī
సరీగా	sarīgā
సర్బానీ	sarbānī
సహస్త్రజిత	sahastrajita
సహ్తోష	sahtōṣa
సాఈ కార్తిక	sā'ī kārtika
సాఈ కుమారీ	sā'ī kumārī
సాఈ జీవధరా	sā'ī jīvadharā
సాఈ వాణీ	sā'ī vāṇī
సాఈ శ్రీ	sā'ī śrī
సాకేథా	sākēthā
సాక్షీన	sākṣīna
సాత్విక	sātvika
సాధవ	sādhava
సానందనా	sānandanā
సాబరీఏశ	sābarī'ēśa
సామిల	sāmila
సాయన	sāyana
సారణీ	sāraṇī
సాలేనా	sālēnā
సాహస్రాంజలి	sāhasrān̄jali
సైచారణ	saicāraṇa
సైనా	sainā
సైలేశ్వర	sailēśvara
సైశా	saiśā
హంశల	hanśala
హక్ష	hakṣa
హటీశ	haṭīśa
హనసీకా	hanasīkā
హనార్వీన	hanārvīna
హనిశ	haniśa
హన్శీతా	hanśītā
హమసాదీపికా	hamasādīpikā
హమీర	hamīra
హమ్సలేఖా	hamsalēkhā
హయాగ్రివ	hayāgriva
హయాతీ	hayātī
హరమ్యా	haramyā
హరిఅక్సా	hari'aksā
హరికా	harikā
హరిగోపాల	harigōpāla
హరిత	harita
హరిదాస	haridāsa
హరిన	harina
హరినా	harinā
హరినాక్షీ	harinākṣī
హరియాన	hariyāna
హరిశంకర	hariśaṅkara
హరిహర పుత్ర	harihara putra
హరీ నారాయణ	harī nārāyaṇa
హర్యక్ష	haryakṣa
హర్యాక్షా	haryākṣā
హర్ష	harṣa
హర్షవర్దన	harṣavardana
హర్షిత	harṣita
హర్స్వీతా	harsvītā
హవన	havana
హవీసా	havīsā
హసీనా	hasīnā
హసుం	hasuṁ
హార్శీనీ	hārśīnī
హావీషా	hāvīṣā
హితాంశీ	hitānśī
హితాంశు	hitānśu
హిన్దవీ	hindavī
హిన్ధావీ	hindhāvī
హిమంత రాజ	himanta rāja
హిమాంవార్శీకా	himānvārśīkā
హిమాంసేఖర	himānsēkhara
హిమాన	himāna
హిమావత	himāvata
హిమీశా	himīśā
హిరణ	hiraṇa
హిరుధాయా	hirudhāyā
హిశేతా	hiśētā
హీతా	hītā
హీమాంవాథీ	hīmānvāthī
హీరకనీ	hīrakanī
హృషీకేశ	hr̥ṣīkēśa
హేఇఅన	hē'i'ana
హేనీల	hēnīla
హేమ	hēma
హేమ లథా	hēma lathā
హేమకాంతా	hēmakāntā
హేమచంద్రా	hēmacandrā
హేమన	hēmana
హేమా	hēmā
హేమాంతి	hēmānti
హేమీతా	hēmītā
హేమ్నందన	hēmnandana
హైమాం	haimāṁ
హోనేయ్షా	hōnēyṣā
హ్రదయ	hradaya
హ్రిదయఆంశు	hridaya'ānśu
హ్రీథీకా	hrīthīkā
హ్రీయాన	hrīyāna
హ్రీశా	hrīśā
హ్రీషిత	hrīṣita
#
#
# Territory names from CLDR
ఎసెషన్ దీవి	eseṣan dīvi
అండొర్రా	aṇḍorrā
యునైటెడ్ అరబ్ ఎమిరేట్స్	yunaiṭeḍ arab emirēṭs
ఆఫ్ఘనిస్తాన్	āphghanistān
ఆంటిగ్వా మరియు బార్బుడా	āṇṭigvā mariyu bārbuḍā
ఆంగవిల్లా	āṅgavillā
అల్బేనియా	albēniyā
ఆర్మేనియా	ārmēniyā
అంగోలా	aṅgōlā
అంటార్కటికా	aṇṭārkaṭikā
అర్జెంటీనా	arjeṇṭīnā
అమెరికన్ సమోవా	amerikan samōvā
ఆస్ట్రియా	āsṭriyā
ఆస్ట్రేలియా	āsṭrēliyā
అరుబా	arubā
ఆలేండ్ దీవులు	ālēṇḍ dīvulu
అజర్బైజాన్	ajarbaijān
బోస్నియా మరియు హెర్జెగొవీనా	bōsniyā mariyu herjegovīnā
బార్బడోస్	bārbaḍōs
బంగ్లాదేశ్	baṅglādēś
బెల్జియం	beljiyaṁ
బుర్కినా ఫాసో	burkinā phāsō
బల్గేరియా	balgēriyā
బహ్రెయిన్	bahreyin
బురుండి	buruṇḍi
బెనిన్	benin
సెంట్ బర్తేలెమీ	seṇṭ bartēlemī
బెర్ముడా	bermuḍā
బ్రూనై	brūnai
బొలీవియా	bolīviyā
కరీబియన్ నెదర్లాండ్స్	karībiyan nedarlāṇḍs
బ్రెజిల్	brejil
బహామాస్	bahāmās
భూటాన్	bhūṭān
బొవెట్ దీవి	boveṭ dīvi
బోట్స్వానా	bōṭsvānā
బెలారస్	belāras
బెలిజ్	belij
కెనడా	kenaḍā
కోకోస్ (కీలింగ్) దీవులు	kōkōs (kīliṅg) dīvulu
కాంగో- కిన్షాసా	kāṅgō- kinṣāsā
కాంగో (DRC)	kāṅgō (DRC)
సెంట్రల్ ఆఫ్రికన్ రిపబ్లిక్	seṇṭral āphrikan ripablik
కాంగో- బ్రాజావిల్లి	kāṅgō- brājāvilli
కాంగో (రిపబ్లిక్)	kāṅgō (ripablik)
స్విట్జర్లాండ్	sviṭjarlāṇḍ
ఐవరీ కోస్ట్	aivarī kōsṭ
కుక్ దీవులు	kuk dīvulu
చిలీ	cilī
కామెరూన్	kāmerūn
చైనా	cainā
కొలంబియా	kolambiyā
క్లిప్పర్టన్ దీవి	klipparṭan dīvi
కోస్టా రికా	kōsṭā rikā
క్యూబా	kyūbā
కేప్ వెర్డే	kēp verḍē
కురాకవో	kurākavō
క్రిస్మస్ దీవి	krismas dīvi
సైప్రస్	saipras
చెక్ రిపబ్లిక్	cek ripablik
జర్మనీ	jarmanī
డియాగో గార్సియా	ḍiyāgō gārsiyā
జిబౌటి	jibauṭi
డెన్మార్క్	ḍenmārk
డోమెనిక	ḍōmenika
డొమెనికన్ రిపబ్లిక్	ḍomenikan ripablik
అల్జీరియా	aljīriyā
స్యూటా మరియు మెలిల్లా	syūṭā mariyu melillā
ఈక్వడార్	īkvaḍār
ఎస్టోనియా	esṭōniyā
ఈజిప్ట్	ījipṭ
పడమటి సహారా	paḍamaṭi sahārā
ఎరిట్రియా	eriṭriyā
స్పెయిన్	speyin
ఇథియోపియా	ithiyōpiyā
యురోపియన్ యునియన్	yurōpiyan yuniyan
ఫిన్లాండ్	phinlāṇḍ
ఫిజీ	phijī
ఫాక్‌ల్యాండ్ దీవులు	phāk‌lyāṇḍ dīvulu
ఫాక్‌ల్యాండ్ దీవులు (ఇస్లాస్ మాల్వినాస్)	phāk‌lyāṇḍ dīvulu (islās mālvinās)
మైక్రోనేశియ	maikrōnēśiya
ఫారో దీవులు	phārō dīvulu
ఫ్రాన్స్‌	phrāns‌
గాబన్	gāban
యునైటెడ్ కింగ్‌డమ్	yunaiṭeḍ kiṅg‌ḍam
గ్రెనెడా	greneḍā
జార్జియా	jārjiyā
ఫ్రెంచ్ గియానా	phren̄c giyānā
గ్వేర్నసే	gvērnasē
ఘనా	ghanā
జిబ్రాల్టార్	jibrālṭār
గ్రీన్‌లాండ్	grīn‌lāṇḍ
గాంబియా	gāmbiyā
గినియా	giniyā
గ్వాడేలోప్	gvāḍēlōp
ఈక్వటోరియల్ గినియా	īkvaṭōriyal giniyā
గ్రీస్	grīs
దక్షిణ జార్జియా &amp; దక్షిణ శాండ్విచ్ దీవులు	dakṣiṇa jārjiyā &amp; dakṣiṇa śāṇḍvic dīvulu
గ్వాటిమాల	gvāṭimāla
గ్వామ్	gvām
గినియా-బిస్సావ్	giniyā-bis'sāv
గయానా	gayānā
హాంకాంగ్ ఎస్ఏఆర్ చైనా	hāṅkāṅg esē'ār cainā
హాంకాంగ్	hāṅkāṅg
హెర్డ్ &amp; మెక్ డొనాల్డ్ దీవులు	herḍ &amp; mek ḍonālḍ dīvulu
హోండురాస్	hōṇḍurās
క్రోయేషియా	krōyēṣiyā
హైటి	haiṭi
హంగేరీ	haṅgērī
కేనరీ దీవులు	kēnarī dīvulu
ఇండోనేషియా	iṇḍōnēṣiyā
ఐర్లాండ్	airlāṇḍ
ఇజ్రాయిల్	ijrāyil
ఐల్ ఆఫ్ మాన్	ail āph mān
భారత దేశం	bhārata dēśaṁ
బ్రిటీష్ భారతీయ సముద్రపు ప్రాంతం	briṭīṣ bhāratīya samudrapu prāntaṁ
ఇరాక్	irāk
ఇరాన్	irān
ఐస్లాండ్	aislāṇḍ
ఇటలీ	iṭalī
జెర్సీ	jersī
జమైకా	jamaikā
జోర్డాన్	jōrḍān
జపాన్	japān
కెన్యా	ken'yā
కిర్గిజిస్తాన్	kirgijistān
కంబోడియా	kambōḍiyā
కిరిబాటి	kiribāṭi
కొమొరోస్	komorōs
సెంట్ కిట్ట్స్ మరియు నెవిస్	seṇṭ kiṭṭs mariyu nevis
ఉత్తర కొరియా	uttara koriyā
దక్షిణ కొరియా	dakṣiṇa koriyā
కువైట్	kuvaiṭ
కేమాన్ దీవులు	kēmān dīvulu
కజకస్తాన్	kajakastān
లావోస్	lāvōs
లెబనాన్	lebanān
సెంట్ లూసియా	seṇṭ lūsiyā
లిక్టెస్టేన్	likṭesṭēn
శ్రీలంక	śrīlaṅka
లైబీరియా	laibīriyā
లెసోతో	lesōtō
లిథువేనియా	lithuvēniyā
లక్సంబర్గ్	laksambarg
లాత్వియా	lātviyā
లిబియా	libiyā
మొరాక్కో	morākkō
మొనాకో	monākō
మోల్డోవా	mōlḍōvā
మోంటేనేగ్రో	mōṇṭēnēgrō
సెంట్ మార్టిన్	seṇṭ mārṭin
మడగాస్కర్	maḍagāskar
మార్షల్ దీవులు	mārṣal dīvulu
మేసిడోనియా	mēsiḍōniyā
మేసిడోనియా (FYROM)	mēsiḍōniyā (FYROM)
మాలి	māli
మయన్మార్ (బర్మా)	mayanmār (barmā)
మంగోలియా	maṅgōliyā
మాకావ్ ఎస్ఏఆర్ చైనా	mākāv esē'ār cainā
మకావు	makāvu
ఉత్తర మరియానా దీవులు	uttara mariyānā dīvulu
మార్టినిక్	mārṭinik
మౌరిటేనియా	mauriṭēniyā
మోంట్సేర్రాట్	mōṇṭsērrāṭ
మాల్టా	mālṭā
మారిషస్	māriṣas
మాల్దీవులు	māldīvulu
మాలావి	mālāvi
మెక్సికో	meksikō
మలేషియా	malēṣiyā
మొజాంబిక్	mojāmbik
నమీబియా	namībiyā
క్రొత్త కాలెడోనియా	krotta kāleḍōniyā
నైజర్	naijar
నార్ఫాక్ దీవి	nārphāk dīvi
నైజీరియా	naijīriyā
నికరాగువా	nikarāguvā
నెదర్లాండ్స్	nedarlāṇḍs
నార్వే	nārvē
నేపాల్	nēpāl
నౌరు	nauru
నియు	niyu
న్యూజిలాండ్	n'yūjilāṇḍ
ఒమన్	oman
పనామా	panāmā
పెరూ	perū
ఫ్రెంచ్ పోలినిషియా	phren̄c pōliniṣiyā
పాపువా న్యు గినియా	pāpuvā n'yu giniyā
ఫిలిప్పీన్స్	philippīns
పాకిస్తాన్	pākistān
పోలాండ్	pōlāṇḍ
సెంట్ పియెర్ మరియు మికెలాన్	seṇṭ piyer mariyu mikelān
పిట్‌కెయిర్న్ దీవులు	piṭ‌keyirn dīvulu
ఫ్యూర్టో రికో	phyūrṭō rikō
పాలస్తీనియన్ ప్రాంతాలు	pālastīniyan prāntālu
పాలస్తీనా	pālastīnā
పోర్చుగల్	pōrcugal
పలావు	palāvu
పరాగ్వే	parāgvē
కతర్	katar
ఒషీనియా బయటున్నవి	oṣīniyā bayaṭunnavi
రియూనియన్	riyūniyan
రోమానియా	rōmāniyā
సెర్బియా	serbiyā
రష్యా	raṣyā
రువాండా	ruvāṇḍā
సౌదీ అరేబియా	saudī arēbiyā
సోలమన్ దీవులు	sōlaman dīvulu
సీషెల్స్	sīṣels
సూడాన్	sūḍān
స్వీడన్	svīḍan
సింగపూర్	siṅgapūr
సెంట్ హెలినా	seṇṭ helinā
స్లోవేనియా	slōvēniyā
స్వాల్బార్డ్ మరియు యాన్ మాయేన్	svālbārḍ mariyu yān māyēn
స్లోవేకియా	slōvēkiyā
సియెర్రా లియాన్	siyerrā liyān
సాన్ మారినో	sān mārinō
సెనెగల్	senegal
సోమాలియా	sōmāliyā
సురినామ్	surinām
దక్షిణ సూడాన్	dakṣiṇa sūḍān
సావోటోమ్ మరియు ప్రిన్సిపే	sāvōṭōm mariyu prinsipē
ఎల్ సాల్వడోర్	el sālvaḍōr
సింట్ మార్టెన్	siṇṭ mārṭen
సిరియా	siriyā
స్వాజిల్యాండ్	svājilyāṇḍ
ట్రిస్టన్ డ కన్హా	ṭrisṭan ḍa kanhā
తుర్క్ మరియు కాలికోస్ దీవులు	turk mariyu kālikōs dīvulu
చాద్	cād
ఫ్రెంచ్ దక్షిణ ప్రాంతాలు	phren̄c dakṣiṇa prāntālu
టోగో	ṭōgō
థాయిలాండ్	thāyilāṇḍ
తజికిస్తాన్	tajikistān
టోకేలావ్	ṭōkēlāv
టిమోర్-లెస్టె	ṭimōr-lesṭe
తూర్పు తైమూర్	tūrpu taimūr
తుర్కమేనిస్తాన్	turkamēnistān
ట్యునీషియా	ṭyunīṣiyā
టోంగా	ṭōṅgā
టర్కీ	ṭarkī
ట్రినిడాడ్ మరియు టొబాగో	ṭriniḍāḍ mariyu ṭobāgō
టువాలు	ṭuvālu
తైవాన్	taivān
టాంజానియా	ṭān̄jāniyā
ఉక్రెయిన్	ukreyin
ఉగాండా	ugāṇḍā
సంయుక్త రాజ్య అమెరికా బయట ఉన్న దీవులు	sanyukta rājya amerikā bayaṭa unna dīvulu
అమెరికా సంయుక్త రాష్ట్రాలు	amerikā sanyukta rāṣṭrālu
ఉరుగువే	uruguvē
ఉజ్బెకిస్తాన్	ujbekistān
వాటికన్ నగరం	vāṭikan nagaraṁ
సెంట్ విన్సెంట్ మరియు గ్రెనడీన్స్	seṇṭ vinseṇṭ mariyu grenaḍīns
వెనుజువేలా	venujuvēlā
బ్రిటిష్ వర్జిన్ దీవులు	briṭiṣ varjin dīvulu
వియత్నాం	viyatnāṁ
వనాటు	vanāṭu
వాలిస్ మరియు ఫ్యుత్యునా	vālis mariyu phyutyunā
సమోవా	samōvā
కొసోవో	kosōvō
యెమెన్	yemen
మాయొట్టి	māyoṭṭi
దక్షిణ ఆఫ్రికా	dakṣiṇa āphrikā
జాంబియా	jāmbiyā
జింబాబ్వే	jimbābvē
తెలియని ప్రాంతం	teliyani prāntaṁ
