# Baby names
অকার্যতানাযা	ಅಕಾರ್ಯತಾನಾಯಾ
অগল্যা	ಅಗಲ್ಯಾ
অগ্রাজা	ಅಗ್ರಾಜಾ
অড্যাত্রযী	ಅಡ್ಯಾತ್ರಯೀ
অদ্বিথা	ಅದ್ಬಿಥಾ
অদ্বৈথী	ಅದ್ಬೈಥೀ
অদ্রিতা	ಅದ್ರಿತಾ
অদ্রীত্যা	ಅದ್ರೀತ್ಯಾ
অদ্শযা	ಅದ್ಶಯಾ
অধুজা	ಅಧುಜಾ
অবীনাযা	ಅಬೀನಾಯಾ
অবীলাশীনী	ಅಬೀಲಾಶೀನೀ
অবীষেক	ಅಬೀಷೇಕ
অব্জিত	ಅಬ್ಜಿತ
অব্ব্য্নায্হা	ಅಬ್ಬ್ಯ್ನಾಯ್ಹಾ
অভাতী	ಅಭಾತೀ
অভিজিত	ಅಭಿಜಿತ
অভিজ্ঞান	ಅಭಿಜ್ಞಾನ
অভিনন্দন	ಅಭಿನನ್ದನ
অভিমান	ಅಭಿಮಾನ
অভিসোকা	ಅಭಿಸೋಕಾ
অভিহীতা	ಅಭಿಹೀತಾ
অভীনাশ	ಅಭೀನಾಶ
অভ্থা	ಅಭ್ಥಾ
অভ্যান্কর	ಅಭ್ಯಾನ್ಕರ
অভ্রনীলা	ಅಭ್ರನೀಲಾ
অহংতী	ಅಹಂತೀ
অহিল্যা	ಅಹಿಲ್ಯಾ
অহেলী	ಅಹೇಲೀ
আংজনেয	ಆಂಜನೇಯ
আকর	ಆಕರ
আকার	ಆಕಾರ
আঘোশ	ಆಘೋಶ
আচমন	ಆಚಮನ
আতিশ	ಆತಿಶ
আত্রব	ಆತ್ರಬ
আথী	ಆಥೀ
আদিতা	ಆದಿತಾ
আদিম	ಆದಿಮ
আদিযা	ಆದಿಯಾ
আদীজয	ಆದೀಜಯ
আদীত্রী	ಆದೀತ್ರೀ
আদ্রিকা	ಆದ್ರಿಕಾ
আনংদতা	ಆನಂದತಾ
আনংদিত	ಆನಂದಿತ
আনল	ಆನಲ
আনাধীতা	ಆನಾಧೀತಾ
আনাযা	ಆನಾಯಾ
আন্শাল	ಆನ್ಶಾಲ
আপেক্ষা	ಆಪೇಕ್ಷಾ
আবীশ	ಆಬೀಶ
আভাস	ಆಭಾಸ
আভীর	ಆಭೀರ
আমিষ	ಆಮಿಷ
আমোদ	ಆಮೋದ
আযুষ্মান	ಆಯುಷ್ಮಾನ
আরংভী	ಆರಂಭೀ
আরব	ಆರಬ
আরা	ಆರಾ
আরিনী	ಆರಿನೀ
আরিযা	ಆರಿಯಾ
আরীন	ಆರೀನ
আরুষী	ಆರುಷೀ
আরোন	ಆರೋನ
আর্থী	ಆರ್ಥೀ
আর্যমন	ಆರ್ಯಮನ
আর্যমিক	ಆರ್ಯಮಿಕ
আর্য্থ্য	ಆರ್ಯ್ಥ್ಯ
আর্শ্বী	ಆರ್ಶ್ಬೀ
আলংব	ಆಲಂಬ
আলোক	ಆಲೋಕ
আলোকা	ಆಲೋಕಾ
আশাকিরণ	ಆಶಾಕಿರಣ
আশীতা	ಆಶೀತಾ
আষ্নী	ಆಷ್ನೀ
আসিত	ಆಸಿತ
আহলাদ	ಆಹಲಾದ
ইংদুমতী	ಇಂದುಮತೀ
ইংদুলেক্ষ	ಇಂದುಲೇಕ್ಷ
ইংবনাথন	ಇಂಬನಾಥನ
ইক্ষিত	ಇಕ್ಷಿತ
ইক্সুরা	ಇಕ್ಸುರಾ
ইদুম	ಇದುಮ
ইধাযা	ಇಧಾಯಾ
ইনকী	ಇನಕೀ
ইন্দ্রদযুম্ন	ಇನ್ದ್ರದಯುಮ್ನ
ইন্দ্রন	ಇನ್ದ್ರನ
ইন্দ্রসেন	ಇನ್ದ್ರಸೇನ
ইন্দ্রিনা	ಇನ್ದ್ರಿನಾ
ইবাংকা	ಇಬಾಂಕಾ
ইব্বানী	ಇಬ್ಬಾನೀ
ইযুরেশ	ಇಯುರೇಶ
ইরাজা	ಇರಾಜಾ
ইরী	ಇರೀ
ইলা	ಇಲಾ
ইশান্য	ಇಶಾನ್ಯ
ইসকী	ಇಸಕೀ
ইহিনা	ಇಹಿನಾ
ঈজ্যা	ಈಜ್ಯಾ
ঈরীন	ಈರೀನ
ঈলাক্ষী	ಈಲಾಕ್ಷೀ
ঈশা	ಈಶಾ
ঈশাংত	ಈಶಾಂತ
ঈশিকা	ಈಶಿಕಾ
ঈসাঈ	ಈಸಾಈ
উগন	ಉಗನ
উগ্রসাঈ	ಉಗ್ರಸಾಈ
উজযাতী	ಉಜಯಾತೀ
উজাযন	ಉಜಾಯನ
উজ্জম	ಉಜ್ಜಮ
উজ্জয	ಉಜ್ಜಯ
উত্তরা	ಉತ್ತರಾ
উত্পত্তি	ಉತ್ಪತ್ತಿ
উত্সা	ಉತ್ಸಾ
উথামী	ಉಥಾಮೀ
উদযন	ಉದಯನ
উদযা	ಉದಯಾ
উধায	ಉಧಾಯ
উধাযারনী	ಉಧಾಯಾರನೀ
উনীনাজ	ಉನೀನಾಜ
উন্নত	ಉನ್ನತ
উন্নতীশ	ಉನ್ನತೀಶ
উন্নাথী	ಉನ್ನಾಥೀ
উপল	ಉಪಲ
উপেক্ষ	ಉಪೇಕ್ಷ
উপ্জস	ಉಪ್ಜಸ
উপ্পাস	ಉಪ್ಪಾಸ
উফ্তম	ಉಫ್ತಮ
উভয	ಉಭಯ
উর্জানী	ಉರ್ಜಾನೀ
উর্দাহাব	ಉರ್ದಾಹಾಬ
উর্বিক	ಉರ್ಬಿಕ
উর্বীনাথ	ಉರ್ಬೀನಾಥ
উশ্নীক	ಉಶ್ನೀಕ
উষা	ಉಷಾ
উষাশি	ಉಷಾಶಿ
উষাশ্রী	ಉಷಾಶ್ರೀ
উস্রা	ಉಸ್ರಾ
একাকান্য	ಏಕಾಕಾನ್ಯ
একাক্ষা	ಏಕಾಕ್ಷಾ
একাগ্রহ	ಏಕಾಗ್ರಹ
একান্তিকা	ಏಕಾನ್ತಿಕಾ
এচ্চুমতি	ಏಚ್ಚುಮತಿ
এবেলিন	ಏಬೇಲಿನ
এবোন	ಏಬೋನ
এব্বনী	ಏಬ್ಬನೀ
এরীন	ಏರೀನ
এলীনা	ಏಲೀನಾ
এলীলরাসন	ಏಲೀಲರಾಸನ
এশমাং	ಏಶಮಾಂ
এশানিকা	ಏಶಾನಿಕಾ
এহিমাযা	ಏಹಿಮಾಯಾ
ওংদ্রিলা	ಓಂದ್ರಿಲಾ
ওঈশী	ಓಈಶೀ
ওজস	ಓಜಸ
ওজস্বী	ಓಜಸ್ಬೀ
ওজস্বীন	ಓಜಸ್ಬೀನ
ওজা	ಓಜಾ
ওজীস	ಓಜೀಸ
ওদিতী	ಓದಿತೀ
ওবীএ	ಓಬೀಏ
ওমাজা	ಓಮಾಜಾ
ওমীশ	ಓಮೀಶ
ওমেশ	ಓಮೇಶ
ওশ্মী	ಓಶ್ಮೀ
ঔশিগ	ಔಶಿಗ
কংচ	ಕಂಚ
কংচনভা	ಕಂಚನಭಾ
কংজন	ಕಂಜನ
কক্ষাপ	ಕಕ್ಷಾಪ
কদংবন	ಕದಂಬನ
কদান্ম্বরী	ಕದಾನ್ಮ್ಬರೀ
কনিতা	ಕನಿತಾ
কনীজা	ಕನೀಜಾ
কনীরা	ಕನೀರಾ
কনীষা	ಕನೀಷಾ
কন্তারব	ಕನ್ತಾರಬ
কন্হৈযা	ಕನ್ಹೈಯಾ
কপার্দিনী	ಕಪಾರ್ದಿನೀ
কপিল	ಕಪಿಲ
কবচ	ಕಬಚ
কবিনযা	ಕಬಿನಯಾ
কবীযাসরী	ಕಬೀಯಾಸರೀ
কবীলান	ಕಬೀಲಾನ
কমলা সমভাব	ಕಮಲಾ ಸಮಭಾಬ
কমলাপতি	ಕಮಲಾಪತಿ
কমোদ	ಕಮೋದ
করীশা	ಕರೀಶಾ
করুণা সাগর	ಕರುಣಾ ಸಾಗರ
করুণানিধি	ಕರುಣಾನಿಧಿ
করুনাশংকর	ಕರುನಾಶಂಕರ
করূলী	ಕರೂಲೀ
কর্তিযন	ಕರ್ತಿಯನ
কর্দমাং	ಕರ್ದಮಾಂ
কল-হংস	ಕಲ-ಹಂಸ
কলাকাংতী	ಕಲಾಕಾಂತೀ
কলাপীন	ಕಲಾಪೀನ
কলাপ্রিযা	ಕಲಾಪ್ರಿಯಾ
কলীযাহ	ಕಲೀಯಾಹ
কল্প	ಕಲ್ಪ
কল্যাণ	ಕಲ್ಯಾಣ
কল্লোলা	ಕಲ್ಲೋಲಾ
কল্হার	ಕಲ್ಹಾರ
কশীনাতন	ಕಶೀನಾತನ
কশ্বী	ಕಶ್ಬೀ
কহ্কাশন	ಕಹ್ಕಾಶನ
কাঁচী	ಕಾಂಚೀ
কাংতব	ಕಾಂತಬ
কাংতা	ಕಾಂತಾ
কাজল	ಕಾಜಲ
কাজোল	ಕಾಜೋಲ
কাতীত	ಕಾತೀತ
কানাকাবাল্লী	ಕಾನಾಕಾಬಾಲ್ಲೀ
কানাসু	ಕಾನಾಸು
কানীমোঝ্হী	ಕಾನೀಮೋಝ್ಹೀ
কানীল	ಕಾನೀಲ
কাব্য শ্রী	ಕಾಬ್ಯ ಶ್ರೀ
কাব্যস্রী	ಕಾಬ್ಯಸ್ರೀ
কামক্যা	ಕಾಮಕ್ಯಾ
কামদা	ಕಾಮದಾ
কামরাজ	ಕಾಮರಾಜ
কামুনা	ಕಾಮುನಾ
কারথী	ಕಾರಥೀ
কারীন	ಕಾರೀನ
কার্লা	ಕಾರ್ಲಾ
কালিদাস	ಕಾಲಿದಾಸ
কাশী	ಕಾಶೀ
কাশ্যপ	ಕಾಶ್ಯಪ
কাহীনী	ಕಾಹೀನೀ
কৌটিল্য	ಕೌಟಿಲ್ಯ
কৌশ	ಕೌಶ
কৌশ্লেন্দর	ಕೌಶ್ಲೇನ್ದರ
কৌসল্যা	ಕೌಸಲ್ಯಾ
গংগিকা	ಗಂಗಿಕಾ
গংগী	ಗಂಗೀ
গংধারা	ಗಂಧಾರಾ
গজপতি	ಗಜಪತಿ
গজরা	ಗಜರಾ
গজরূপ	ಗಜರೂಪ
গজেংদ্রনাথ	ಗಜೇಂದ್ರನಾಥ
গতিক	ಗತಿಕ
গদাধর	ಗದಾಧರ
গনেসা	ಗನೇಸಾ
গন্গেযন	ಗನ್ಗೇಯನ
গহনা	ಗಹನಾ
গাথা	ಗಾಥಾ
গাথিকা	ಗಾಥಿಕಾ
গাব্যা	ಗಾಬ್ಯಾ
গাযকাপ্রিযা	ಗಾಯಕಾಪ್ರಿಯಾ
গীতাম্রীতা মহোদধি	ಗೀತಾಮ್ರೀತಾ ಮಹೋದಧಿ
গীতাশ্রী	ಗೀತಾಶ್ರೀ
গীতি	ಗೀತಿ
গীনা	ಗೀನಾ
গীরীনাথ	ಗೀರೀನಾಥ
গীরীশরণ	ಗೀರೀಶರಣ
গুংজা	ಗುಂಜಾ
গুগন	ಗುಗನ
গুণাজী	ಗುಣಾಜೀ
গুনাশেকরণ	ಗುನಾಶೇಕರಣ
গুনীত	ಗುನೀತ
গুন্জীতা	ಗುನ್ಜೀತಾ
গুরদযাল	ಗುರದಯಾಲ
গুরব	ಗುರಬ
গুরীশ	ಗುರೀಶ
গুরু	ಗುರು
গুরুচরণ	ಗುರುಚರಣ
গুরুপদা	ಗುರುಪದಾ
গুরুরাজ	ಗುರುರಾಜ
গুরুরাজা	ಗುರುರಾಜಾ
গুরুশরণ	ಗುರುಶರಣ
গুল	ಗುಲ
গূহারী	ಗೂಹಾರೀ
গেশনা	ಗೇಶನಾ
গোউংতামান	ಗೋಉಂತಾಮಾನ
গোউংথমী	ಗೋಉಂಥಮೀ
গোউংসিক	ಗೋಉಂಸಿಕ
গোকুল	ಗೋಕುಲ
গোপান	ಗೋಪಾನ
গোপাল কৃষ্ণন	ಗೋಪಾಲ ಕೃಷ್ಣನ
গোপীচংদ	ಗೋಪೀಚಂದ
গোপেশ	ಗೋಪೇಶ
গোমাংতক	ಗೋಮಾಂತಕ
গোমীনী	ಗೋಮೀನೀ
গোম্যাসরী	ಗೋಮ್ಯಾಸರೀ
গোরল	ಗೋರಲ
গোশীতা	ಗೋಶೀತಾ
গৌর	ಗೌರ
গৌরবী	ಗೌರಬೀ
গৌরাংশ	ಗೌರಾಂಶ
গৌরীতা	ಗೌರೀತಾ
গৌর্যনবী	ಗೌರ್ಯನಬೀ
গ্নানেন্দের	ಗ್ನಾನೇನ್ದೇರ
গ্যানবী	ಗ್ಯಾನಬೀ
গ্রাহ্য	ಗ್ರಾಹ್ಯ
গ্রিষ্মা	ಗ್ರಿಷ್ಮಾ
গ্রীশ্মীতা	ಗ್ರೀಶ್ಮೀತಾ
গ্রীসমাং	ಗ್ರೀಸಮಾಂ
ঘটোতকত্চা	ಘಟೋತಕತ್ಚಾ
ঘুংগরূ	ಘುಂಗರೂ
চংদসরী	ಚಂದಸರೀ
চংদের্ভান	ಚಂದೇರ್ಭಾನ
চংদ্রকংতী	ಚಂದ್ರಕಂತೀ
চংদ্রকিশোর	ಚಂದ್ರಕಿಶೋರ
চংদ্রকীর্তী	ಚಂದ್ರಕೀರ್ತೀ
চংদ্রন	ಚಂದ್ರನ
চংদ্রন্শুং	ಚಂದ್ರನ್ಶುಂ
চংদ্রমতি	ಚಂದ್ರಮತಿ
চংদ্রমনী	ಚಂದ್ರಮನೀ
চংদ্রা	ಚಂದ್ರಾ
চংদ্রিকা	ಚಂದ್ರಿಕಾ
চংদ্রেযী	ಚಂದ್ರೇಯೀ
চংধু	ಚಂಧು
চক্রপাণী	ಚಕ್ರಪಾಣೀ
চতুর্বী	ಚತುರ್ಬೀ
চনক	ಚನಕ
চনাস্যা	ಚನಾಸ್ಯಾ
চন্দ্রকলী	ಚನ್ದ್ರಕಲೀ
চন্দ্রসহোদারী	ಚನ್ದ್ರಸಹೋದಾರೀ
চপলা	ಚಪಲಾ
চযাংক	ಚಯಾಂಕ
চরণ	ಚರಣ
চরীতাব্যা	ಚರೀತಾಬ್ಯಾ
চরীথা	ಚರೀಥಾ
চরুশীল	ಚರುಶೀಲ
চানাস্যা	ಚಾನಾಸ್ಯಾ
চাব্রিক	ಚಾಬ್ರಿಕ
চামীনী	ಚಾಮೀನೀ
চিত্তেশ	ಚಿತ್ತೇಶ
চিত্রকূট সমাংশ্রাযা	ಚಿತ್ರಕೂಟ ಸಮಾಂಶ್ರಾಯಾ
চিত্রবাহূ	ಚಿತ್ರಬಾಹೂ
চিত্রমালা	ಚಿತ್ರಮಾಲಾ
চিত্রযুদ্ধ	ಚಿತ್ರಯುದ್ಧ
চিত্রিকা	ಚಿತ್ರಿಕಾ
চিত্রিতা	ಚಿತ್ರಿತಾ
চিমাযী	ಚಿಮಾಯೀ
চিরংজীব	ಚಿರಂಜೀಬ
চিরংতন	ಚಿರಂತನ
চীথরা	ಚೀಥರಾ
চীন্নীঃ	ಚೀನ್ನೀಃ
চীস্থা	ಚೀಸ್ಥಾ
চুংবন	ಚುಂಬನ
চুটকী	ಚುಟಕೀ
চুন্নী	ಚುನ್ನೀ
চুমকী	ಚುಮಕೀ
চেতন্সাঈ	ಚೇತನ್ಸಾಈ
চৈতাল	ಚೈತಾಲ
চৈত্রী	ಚೈತ್ರೀ
চৈনীকা	ಚೈನೀಕಾ
চৈসরণ	ಚೈಸರಣ
জক্ষানী	ಜಕ್ಷಾನೀ
জগতপ্রকাশ	ಜಗತಪ್ರಕಾಶ
জগদগুরুবে	ಜಗದಗುರುಬೇ
জগদীপ	ಜಗದೀಪ
জগদেশা	ಜಗದೇಶಾ
জগাতী	ಜಗಾತೀ
জগ্সনা	ಜಗ್ಸನಾ
জতন	ಜತನ
জনামেজয	ಜನಾಮೇಜಯ
জনিতা	ಜನಿತಾ
জবিনে	ಜಬಿನೇ
জযকিশন	ಜಯಕಿಶನ
জযগোপাল	ಜಯಗೋಪಾಲ
জযনা	ಜಯನಾ
জযাজীত	ಜಯಾಜೀತ
জযানংদ	ಜಯಾನಂದ
জরুল	ಜರುಲ
জলজ়া	ಜಲಜ಼ಾ
জশ্বীথা	ಜಶ್ಬೀಥಾ
জশ্মীথা	ಜಶ್ಮೀಥಾ
জসরাজ	ಜಸರಾಜ
জস্টীন	ಜಸ್ಟೀನ
জহাংগীর	ಜಹಾಂಗೀರ
জাংবুবন	ಜಾಂಬುಬನ
জাগচংদ্রা	ಜಾಗಚಂದ್ರಾ
জানকীবল্লভ	ಜಾನಕೀಬಲ್ಲಭ
জানকীভূষণ	ಜಾನಕೀಭೂಷಣ
জানবী	ಜಾನಬೀ
জানহিতা	ಜಾನಹಿತಾ
জানীশ	ಜಾನೀಶ
জাবা	ಜಾಬಾ
জারন	ಜಾರನ
জালেংদু	ಜಾಲೇಂದು
জিগ্নাসা	ಜಿಗ್ನಾಸಾ
জীজ্ঞাশা	ಜೀಜ್ಞಾಶಾ
জীতেশী	ಜೀತೇಶೀ
জীন্ষা	ಜೀನ್ಷಾ
জীমী	ಜೀಮೀ
জেনীকা	ಜೇನೀಕಾ
জের্শীকা	ಜೇರ್ಶೀಕಾ
জেসরী	ಜೇಸರೀ
জৈক্রীশ	ಜೈಕ್ರೀಶ
জৈন	ಜೈನ
জৈনিল	ಜೈನಿಲ
জৈনীত	ಜೈನೀತ
জৈমীনী	ಜೈಮೀನೀ
জৈহাসীনী	ಜೈಹಾಸೀನೀ
জ্ঞানী	ಜ್ಞಾನೀ
জ্ঞানেশ্বর	ಜ್ಞಾನೇಶ್ಬರ
জ্হুমাং	ಜ್ಹುಮಾಂ
ঝারা	ಝಾರಾ
ঝিনূক	ಝಿನೂಕ
ঝিযন	ಝಿಯನ
ঝীল	ಝೀಲ
ঝীহান	ಝೀಹಾನ
ঝেনীল	ಝೇನೀಲ
ঝেনীশা	ಝೇನೀಶಾ
ঠাকুর	ಠಾಕುರ
ঠুমরী	ಠುಮರೀ
তংত্র	ತಂತ್ರ
তজজ্ঞ	ತಜಜ್ಞ
তনিশ্ক	ತನಿಶ್ಕ
তনিষ	ತನಿಷ
তনুংগ্না	ತನುಂಗ್ನಾ
তনেশ	ತನೇಶ
তনোজ	ತನೋಜ
তন্বিকা	ತನ್ಬಿಕಾ
তন্মাযা	ತನ್ಮಾಯಾ
তপেন্দ্র	ತಪೇನ್ದ್ರ
তবলীন :	ತಬಲೀನ :
তব্বু	ತಬ್ಬು
তমসী	ತಮಸೀ
তরুণ  বিজয	ತರುಣ  ಬಿಜಯ
তরুন্সীবা	ತರುನ್ಸೀಬಾ
তরুশ্রী	ತರುಶ್ರೀ
তরুসা	ತರುಸಾ
তলংক	ತಲಂಕ
তাত্বিক	ತಾತ್ಬಿಕ
তানুংমালয	ತಾನುಂಮಾಲಯ
তানুংশ্সী	ತಾನುಂಶ್ಸೀ
তাপিত	ತಾಪಿತ
তামাংশ্রী	ತಾಮಾಂಶ್ರೀ
তারকনাথ	ತಾರಕನಾಥ
তারকা	ತಾರಕಾ
তারকেশ	ತಾರಕೇಶ
তারকেশ্বর	ತಾರಕೇಶ್ಬರ
তারচংদ	ತಾರಚಂದ
তারা প্রশাদ	ತಾರಾ ಪ್ರಶಾದ
তারাকিনী	ತಾರಾಕಿನೀ
তারীশী	ತಾರೀಶೀ
তারুষ	ತಾರುಷ
তালংক	ತಾಲಂಕ
তালিকা	ತಾಲಿಕಾ
তালীন	ತಾಲೀನ
তিনাশ	ತಿನಾಶ
তিরবিকা	ತಿರಬಿಕಾ
তিলক	ತಿಲಕ
তিস্যা	ತಿಸ್ಯಾ
তীম্মাং	ತೀಮ್ಮಾಂ
তীযাসা	ತೀಯಾಸಾ
তীলাকারতনা	ತೀಲಾಕಾರತನಾ
তীস্তা	ತೀಸ್ತಾ
তুমীর	ತುಮೀರ
তেজপাল	ತೇಜಪಾಲ
তেজম	ತೇಜಮ
তেজস্মীতা	ತೇಜಸ್ಮೀತಾ
তেজ়	ತೇಜ಼
তেজুস	ತೇಜುಸ
তেজোভাদ্র	ತೇಜೋಭಾದ್ರ
তেনুং	ತೇನುಂ
তের্ষম	ತೇರ್ಷಮ
তোযেশ	ತೋಯೇಶ
তোশাল	ತೋಶಾಲ
তোশী	ತೋಶೀ
ত্রিলোক	ತ್ರಿಲೋಕ
ত্রীলূকামন	ತ್ರೀಲೂಕಾಮನ
ত্রীশ	ತ್ರೀಶ
থমারাঈ	ಥಮಾರಾಈ
থারা	ಥಾರಾ
থেন্মোলী	ಥೇನ್ಮೋಲೀ
থ্রানীসা	ಥ್ರಾನೀಸಾ
দক্শিনযন	ದಕ್ಶಿನಯನ
দক্শীন্য	ದಕ್ಶೀನ್ಯ
দক্ষেশ্বর	ದಕ್ಷೇಶ್ಬರ
দক্ষেষ	ದಕ್ಷೇಷ
দত্তাত্রী	ದತ್ತಾತ್ರೀ
দত্তাত্রেয	ದತ್ತಾತ್ರೇಯ
দনীলা	ದನೀಲಾ
দনুংসীযা	ದನುಂಸೀಯಾ
দন্যতা	ದನ್ಯತಾ
দবাশীশ	ದಬಾಶೀಶ
দবীত	ದಬೀತ
দযাল	ದಯಾಲ
দযাস্বরূপ	ದಯಾಸ್ಬರೂಪ
দর্মীনী	ದರ್ಮೀನೀ
দর্শনী	ದರ್ಶನೀ
দর্শিক	ದರ್ಶಿಕ
দর্শীল	ದರ್ಶೀಲ
দলাপথী	ದಲಾಪಥೀ
দশাবহবে	ದಶಾಬಹಬೇ
দানবেন্দ্রবিনাশকা	ದಾನಬೇನ್ದ್ರಬಿನಾಶಕಾ
দান্দাপানী	ದಾನ್ದಾಪಾನೀ
দাব	ದಾಬ
দামন	ದಾಮನ
দারুণ	ದಾರುಣ
দাল্ভযা	ದಾಲ್ಭಯಾ
দাস	ದಾಸ
দিক্ষীন	ದಿಕ್ಷೀನ
দিন দযাল	ದಿನ ದಯಾಲ
দিনাবংধাবে	ದಿನಾಬಂಧಾಬೇ
দিপন্ষা	ದಿಪನ್ಷಾ
দিপ্তিকা	ದಿಪ್ತಿಕಾ
দিবেনা	ದಿಬೇನಾ
দিযা	ದಿಯಾ
দিরাজ	ದಿರಾಜ
দীক্ষিতা	ದೀಕ್ಷಿತಾ
দীতা	ದೀತಾ
দীপক	ದೀಪಕ
দীপনা	ದೀಪನಾ
দীপশিখা	ದೀಪಶಿಖಾ
দীপালী	ದೀಪಾಲೀ
দীপ্তা	ದೀಪ್ತಾ
দীপ্তিকানা	ದೀಪ್ತಿಕಾನಾ
দেনীষ	ದೇನೀಷ
দেন্সী	ದೇನ್ಸೀ
দেবগর্ভা	ದೇಬಗರ್ಭಾ
দেবর্পীতা	ದೇಬರ್ಪೀತಾ
দেবা	ದೇಬಾ
দেবাগাংধারী	ದೇಬಾಗಾಂಧಾರೀ
দেবারতী	ದೇಬಾರತೀ
দেবারীশী	ದೇಬಾರೀಶೀ
দেবিক	ದೇಬಿಕ
দেবীন	ದೇಬೀನ
দেব্প্রসাদ	ದೇಬ್ಪ್ರಸಾದ
দেব্প্রীতা	ದೇಬ್ಪ್ರೀತಾ
দেম্ধেন্দ্র	ದೇಮ್ಧೇನ್ದ್ರ
দেযাশীনী	ದೇಯಾಶೀನೀ
দেস্পীনা	ದೇಸ್ಪೀನಾ
দৈবত	ದೈಬತ
দৈবী	ದೈಬೀ
দৈবেয	ದೈಬೇಯ
ধনশ্রী	ಧನಶ್ರೀ
ধনিযা	ಧನಿಯಾ
ধন্যতা	ಧನ್ಯತಾ
ধন্যশ্রী	ಧನ್ಯಶ್ರೀ
ধরনী	ಧರನೀ
ধরাহাসীনী	ಧರಾಹಾಸೀನೀ
ধারিকা	ಧಾರಿಕಾ
ধারীত্রী	ಧಾರೀತ್ರೀ
ধার্শীকা	ಧಾರ್ಶೀಕಾ
নংদ-নংদন	ನಂದ-ನಂದನ
নংদপাল	ನಂದಪಾಲ
নংধা	ನಂಧಾ
নচিকেতা	ನಚಿಕೇತಾ
নটরাজ	ನಟರಾಜ
নবকুংজ	ನಬಕುಂಜ
নবরাতনা	ನಬರಾತನಾ
নবেংদু	ನಬೇಂದು
নমনা	ನಮನಾ
নর্মদা	ನರ್ಮದಾ
নাংবী	ನಾಂಬೀ
নাগবেনী	ನಾಗಬೇನೀ
নাগভুষণ	ನಾಗಭುಷಣ
নাগমমাং	ನಾಗಮಮಾಂ
নাগরাজু	ನಾಗರಾಜು
নাগেস্বারী	ನಾಗೇಸ್ಬಾರೀ
নাতন	ನಾತನ
নাতিন	ನಾತಿನ
নাতীক	ನಾತೀಕ
নান্দীথা	ನಾನ್ದೀಥಾ
নাবেতা	ನಾಬೇತಾ
নাবেশা	ನಾಬೇಶಾ
নাভ্যা	ನಾಭ್ಯಾ
নামাংহা	ನಾಮಾಂಹಾ
নাযসা	ನಾಯಸಾ
নাযানী	ನಾಯಾನೀ
নারাযণন	ನಾರಾಯಣನ
নারাযন	ನಾರಾಯನ
নার্ন্রতা	ನಾರ್ನ್ರತಾ
নাশাল	ನಾಶಾಲ
নিদ্রা	ನಿದ್ರಾ
নিবা	ನಿಬಾ
নিহারিকা	ನಿಹಾರಿಕಾ
নীকাশা	ನೀಕಾಶಾ
নীচিকা	ನೀಚಿಕಾ
নীথী	ನೀಥೀ
নীনা	ನೀನಾ
নীবেদীতা	ನೀಬೇದೀತಾ
নীরজ নযন	ನೀರಜ ನಯನ
নীরব	ನೀರಬ
নীলকাংত্	ನೀಲಕಾಂತ್
নীলযা	ನೀಲಯಾ
নীলাবাথী	ನೀಲಾಬಾಥೀ
নীলাম্বর	ನೀಲಾಮ್ಬರ
নীলাম্বরী	ನೀಲಾಮ್ಬರೀ
নেকা	ನೇಕಾ
নেথ্রা	ನೇಥ್ರಾ
নেবেধা	ನೇಬೇಧಾ
নেমাংলী	ನೇಮಾಂಲೀ
নেল্বীন	ನೇಲ್ಬೀನ
নেসরা	ನೇಸರಾ
নৈংশী	ನೈಂಶೀ
নৈনীশ	ನೈನೀಶ
নৈনুষ	ನೈನುಷ
নৈমিষ	ನೈಮಿಷ
নৈমিষা	ನೈಮಿಷಾ
নৈমেষ	ನೈಮೇಷ
নৌরিন	ನೌರಿನ
পংকজ	ಪಂಕಜ
পংকাজধারিণী	ಪಂಕಾಜಧಾರಿಣೀ
পংখী	ಪಂಖೀ
পংচজন্য	ಪಂಚಜನ್ಯ
পংধারী	ಪಂಧಾರೀ
পট মংজরী	ಪಟ ಮಂಜರೀ
পতগ	ಪತಗ
পত্তাম্বরাপরীধানা	ಪತ್ತಾಮ್ಬರಾಪರೀಧಾನಾ
পত্র	ಪತ್ರ
পদমাংক্ষ্য	ಪದಮಾಂಕ್ಷ್ಯ
পদ্মকাংত	ಪದ್ಮಕಾಂತ
পদ্মগ্রিহা	ಪದ್ಮಗ್ರಿಹಾ
পদ্মমালিনী	ಪದ್ಮಮಾಲಿನೀ
পদ্মাংকল্যানী	ಪದ್ಮಾಂಕಲ್ಯಾನೀ
পদ্মাজঈ	ಪದ್ಮಾಜಈ
পনিতা	ಪನಿತಾ
পন্দালাবাসন	ಪನ್ದಾಲಾಬಾಸನ
পন্দীযারাজ	ಪನ್ದೀಯಾರಾಜ
পবন  আদিত্য	ಪಬನ  ಆದಿತ್ಯ
পবনপুত্র	ಪಬನಪುತ್ರ
পবিত্রণ	ಪಬಿತ್ರಣ
পবিনা	ಪಬಿನಾ
পবীকরণ	ಪಬೀಕರಣ
পবীশ্না	ಪಬೀಶ್ನಾ
পযোধরা	ಪಯೋಧರಾ
পরতাপ ; পরতাপ	ಪರತಾಪ ; ಪರತಾಪ
পরম-হংস	ಪರಮ-ಹಂಸ
পরমাত্মা	ಪರಮಾತ್ಮಾ
পরমার্থ	ಪರಮಾರ್ಥ
পরাকাষ	ಪರಾಕಾಷ
পরান্জয	ಪರಾನ್ಜಯ
পরাসরা	ಪರಾಸರಾ
পরিচয	ಪರಿಚಯ
পরিসী	ಪರಿಸೀ
পরেশ	ಪರೇಶ
পর্কাবী	ಪರ್ಕಾಬೀ
পর্নবী	ಪರ್ನಬೀ
পর্নল	ಪರ್ನಲ
পর্বতীপ্রিত	ಪರ್ಬತೀಪ್ರಿತ
পর্হন	ಪರ್ಹನ
পলক	ಪಲಕ
পলানী	ಪಲಾನೀ
পলাশ	ಪಲಾಶ
পল্লাবী	ಪಲ್ಲಾಬೀ
পহেল	ಪಹೇಲ
পাক	ಪಾಕ
পানমোলী	ಪಾನಮೋಲೀ
পাব	ಪಾಬ
পাযোধর	ಪಾಯೋಧರ
পারিতোশ	ಪಾರಿತೋಶ
পারুল	ಪಾರುಲ
পালীত	ಪಾಲೀತ
পাহী	ಪಾಹೀ
পীতাংবর	ಪೀತಾಂಬರ
পীযাশা	ಪೀಯಾಶಾ
পূজীতা	ಪೂಜೀತಾ
পূর্বীজ্হা	ಪೂರ್ಬೀಜ್ಹಾ
পূশীথা	ಪೂಶೀಥಾ
পোউর্নীমাং	ಪೋಉರ್ನೀಮಾಂ
পোর্নীমাং	ಪೋರ್ನೀಮಾಂ
পোশীথা	ಪೋಶೀಥಾ
পৌরুষ	ಪೌರುಷ
ফণীশ	ಫಣೀಶ
ফনিংদ্র	ಫನಿಂದ್ರ
ফ্রেযল	ಫ್ರೇಯಲ
ফ্লাবীনা	ಫ್ಲಾಬೀನಾ
বংশজা	ಬಂಶಜಾ
বংশীধর	ಬಂಶೀಧರ
বংসী	ಬಂಸೀ
বকা	ಬಕಾ
বদ্রীনাথ	ಬದ್ರೀನಾಥ
বনমালা	ಬನಮಾಲಾ
বনাজ	ಬನಾಜ
বনীলা	ಬನೀಲಾ
বন্দীনী	ಬನ್ದೀನೀ
বন্ধানা	ಬನ್ಧಾನಾ
বপুন	ಬಪುನ
ববয	ಬಬಯ
ববিশ	ಬಬಿಶ
বরজোত্তামাং	ಬರಜೋತ್ತಾಮಾಂ
বর্টীক	ಬರ್ಟೀಕ
বর্তার	ಬರ್ತಾರ
বর্শনেযা	ಬರ್ಶನೇಯಾ
বর্শীতা	ಬರ್ಶೀತಾ
বর্ষিত	ಬರ್ಷಿತ
বলরাম	ಬಲರಾಮ
বলাচান্দ্রণ	ಬಲಾಚಾನ್ದ್ರಣ
বলামানী	ಬಲಾಮಾನೀ
বলামুরুগন	ಬಲಾಮುರುಗನ
বশীশ্কা	ಬಶೀಶ್ಕಾ
বষা	ಬಷಾ
বসংতী	ಬಸಂತೀ
বসংথাজা	ಬಸಂಥಾಜಾ
বসব	ಬಸಬ
বসুদেবন	ಬಸುದೇಬನ
বস্তী	ಬಸ್ತೀ
বস্মীহা	ಬಸ್ಮೀಹಾ
বহুলেযন	ಬಹುಲೇಯನ
বাংসুরী	ಬಾಂಸುರೀ
বাগ-দেবী	ಬಾಗ-ದೇಬೀ
বাচাস্য	ಬಾಚಾಸ್ಯ
বাজীনাথ	ಬಾಜೀನಾಥ
বাজ্রহাস্তা	ಬಾಜ್ರಹಾಸ್ತಾ
বাত্সক	ಬಾತ್ಸಕ
বানাজাক্ষী	ಬಾನಾಜಾಕ್ಷೀ
বানীস্রী	ಬಾನೀಸ್ರೀ
বানুজা	ಬಾನುಜಾ
বাপু	ಬಾಪು
বাবীন	ಬಾಬೀನ
বাযুন	ಬಾಯುನ
বারীধার	ಬಾರೀಧಾರ
বার্গবী	ಬಾರ್ಗಬೀ
বাল কৃষ্ণ	ಬಾಲ ಕೃಷ್ಣ
বালচংদ্র	ಬಾಲಚಂದ್ರ
বালাদিত্য	ಬಾಲಾದಿತ್ಯ
বালামানী	ಬಾಲಾಮಾನೀ
বালামুরুগন	ಬಾಲಾಮುರುಗನ
বালার	ಬಾಲಾರ
বালারমাংথী	ಬಾಲಾರಮಾಂಥೀ
বালারাম	ಬಾಲಾರಾಮ
বাল্দাস	ಬಾಲ್ದಾಸ
বাল্মিক	ಬಾಲ್ಮಿಕ
বাশু	ಬಾಶು
বাস্তব	ಬಾಸ್ತಬ
বিংদী	ಬಿಂದೀ
বিনা	ಬಿನಾ
বিনাপানী	ಬಿನಾಪಾನೀ
বিপাশা	ಬಿಪಾಶಾ
বিরাজ	ಬಿರಾಜ
বীড্যা	ಬೀಡ್ಯಾ
বীণা	ಬೀಣಾ
বীথীকা	ಬೀಥೀಕಾ
বীনাবানী	ಬೀನಾಬಾನೀ
বীরাজীনী	ಬೀರಾಜೀನೀ
বুলবুল	ಬುಲಬುಲ
বূমী	ಬೂಮೀ
বেথিনা	ಬೇಥಿನಾ
বেদকার্তিক	ಬೇದಕಾರ್ತಿಕ
বেদবিদ্যা	ಬೇದಬಿದ್ಯಾ
বেদা শ্রী	ಬೇದಾ ಶ್ರೀ
বেদাবাথী	ಬೇದಾಬಾಥೀ
বেদীথা	ಬೇದೀಥಾ
বেনীতা	ಬೇನೀತಾ
বেন্শিক	ಬೇನ್ಶಿಕ
বৈদয	ಬೈದಯ
বৈদ্যনাথ	ಬೈದ್ಯನಾಥ
বৈধাঈ	ಬೈಧಾಈ
বৈরাজ	ಬೈರಾಜ
বৈশ্নোব	ಬೈಶ್ನೋಬ
ব্রহ্মবাদীনী	ಬ್ರಹ್ಮಬಾದೀನೀ
ব্রাহ্মী	ಬ್ರಾಹ್ಮೀ
ব্রিজা	ಬ್ರಿಜಾ
ব্লেস্সী	ಬ್ಲೇಸ್ಸೀ
ভক্তি	ಭಕ್ತಿ
ভদ্রংগ	ಭದ್ರಂಗ
ভবিযা	ಭಬಿಯಾ
ভরনী	ಭರನೀ
ভর্গ	ಭರ್ಗ
ভাদ্রুষা	ಭಾದ್ರುಷಾ
ভানু রেখা	ಭಾನು ರೇಖಾ
ভাব্যংশ	ಭಾಬ್ಯಂಶ
ভামিনী	ಭಾಮಿನೀ
ভার্গবী	ಭಾರ್ಗಬೀ
ভালচংদ্র	ಭಾಲಚಂದ್ರ
ভাস্বন	ಭಾಸ್ಬನ
ভীবত্সুং	ಭೀಬತ್ಸುಂ
ভীলানগনা	ಭೀಲಾನಗನಾ
ভীষ্মা	ಭೀಷ್ಮಾ
ভুবা	ಭುಬಾ
ভূমি	ಭೂಮಿ
ভেরূ	ಭೇರೂ
ভোজা	ಭೋಜಾ
ভৌমিক	ಭೌಮಿಕ
ভ্রামরী	ಭ್ರಾಮರೀ
মংদা	ಮಂದಾ
মংদিথ	ಮಂದಿಥ
মগধ	ಮಗಧ
মগনা	ಮಗನಾ
মদনীকা	ಮದನೀಕಾ
মদির	ಮದಿರ
মধুমাংলী	ಮಧುಮಾಂಲೀ
মধুল	ಮಧುಲ
মধুলতা	ಮಧುಲತಾ
মধুশা	ಮಧುಶಾ
মনিক	ಮನಿಕ
মনীদীপ	ಮನೀದೀಪ
মনীবলন	ಮನೀಬಲನ
মনীষ	ಮನೀಷ
মমতা	ಮಮತಾ
মলাংক	ಮಲಾಂಕ
মল্লিকা	ಮಲ್ಲಿಕಾ
মহা গণপতি	ಮಹಾ ಗಣಪತಿ
মহাতাপ	ಮಹಾತಾಪ
মহাদেবাদীপুজীতা	ಮಹಾದೇಬಾದೀಪುಜೀತಾ
মহাবালা	ಮಹಾಬಾಲಾ
মহাবীর	ಮಹಾಬೀರ
মহারাবণমর্দানা	ಮಹಾರಾಬಣಮರ್ದಾನಾ
মহালক্ষ্মী	ಮಹಾಲಕ್ಷ್ಮೀ
মহালিকা	ಮಹಾಲಿಕಾ
মহালীংগ	ಮಹಾಲೀಂಗ
মহিমা	ಮಹಿಮಾ
মহিষাসুরমর্দিনী	ಮಹಿಷಾಸುರಮರ್ದಿನೀ
মহীথা	ಮಹೀಥಾ
মহুযা	ಮಹುಯಾ
মহেন্দর	ಮಹೇನ್ದರ
মহেলীকা	ಮಹೇಲೀಕಾ
মহেশ	ಮಹೇಶ
মহেশ্বর	ಮಹೇಶ್ಬರ
মহোদরা	ಮಹೋದರಾ
মাংধুমাংন্তী	ಮಾಂಧುಮಾಂನ್ತೀ
মাংনাশ্যুং	ಮಾಂನಾಶ್ಯುಂ
মাংনীশোব্র্যা	ಮಾಂನೀಶೋಬ್ರ್ಯಾ
মাংন্জুনাতা	ಮಾಂನ್ಜುನಾತಾ
মাংন্দারিকা	ಮಾಂನ್ದಾರಿಕಾ
মাংলার্বীঝ্হী	ಮಾಂಲಾರ್ಬೀಝ್ಹೀ
মাংলাশ্রী	ಮಾಂಲಾಶ್ರೀ
মাগথী	ಮಾಗಥೀ
মাথুর	ಮಾಥುರ
মাধান	ಮಾಧಾನ
মাধ্যম	ಮಾಧ್ಯಮ
মানক	ಮಾನಕ
মানজ	ಮಾನಜ
মানসিকা	ಮಾನಸಿಕಾ
মানিক	ಮಾನಿಕ
মানিনী	ಮಾನಿನೀ
মানীএ	ಮಾನೀಏ
মানীসিলা	ಮಾನೀಸಿಲಾ
মানোবীকা	ಮಾನೋಬೀಕಾ
মান্দাবিক	ಮಾನ್ದಾಬಿಕ
মান্ধাতা	ಮಾನ್ಧಾತಾ
মান্মাতন	ಮಾನ್ಮಾತನ
মান্যসরী	ಮಾನ್ಯಸರೀ
মালারাবন	ಮಾಲಾರಾಬನ
মাল্লেষম	ಮಾಲ್ಲೇಷಮ
মাহিত	ಮಾಹಿತ
মৈথ্রা	ಮೈಥ್ರಾ
মৈনাবী	ಮೈನಾಬೀ
যজুর	ಯಜುರ
যদু	ಯದು
যদুনংদন	ಯದುನಂದನ
যশস্ব	ಯಶಸ್ಬ
যশীল	ಯಶೀಲ
যশ্বী	ಯಶ್ಬೀ
যাগবী/যহাবী	ಯಾಗಬೀ/ಯಹಾಬೀ
যাগ্নেশ্বারা	ಯಾಗ್ನೇಶ್ಬಾರಾ
যাতনা	ಯಾತನಾ
যাদবা	ಯಾದಬಾ
যামি	ಯಾಮಿ
যামিনী	ಯಾಮಿನೀ
যাশ্রী	ಯಾಶ್ರೀ
যুকাশ্রী	ಯುಕಾಶ್ರೀ
যুগান্ধর	ಯುಗಾನ್ಧರ
যুতি	ಯುತಿ
যুধ্ধ	ಯುಧ್ಧ
যুব	ಯುಬ
যুবরাণী	ಯುಬರಾಣೀ
যুবানী	ಯುಬಾನೀ
যুবাসরী	ಯುಬಾಸರೀ
যেঘরাজ	ಯೇಘರಾಜ
যেনাক্ষী	ಯೇನಾಕ್ಷೀ
যেশাস্বীনী	ಯೇಶಾಸ್ಬೀನೀ
যেশ্বীন	ಯೇಶ್ಬೀನ
যেস্বীন	ಯೇಸ್ಬೀನ
যোগনা	ಯೋಗನಾ
যোগী	ಯೋಗೀ
যোগীন	ಯೋಗೀನ
যোগেশ্বর	ಯೋಗೇಶ್ಬರ
যোচনা	ಯೋಚನಾ
যোত্শনা	ಯೋತ್ಶನಾ
যোশন	ಯೋಶನ
যোশিতা	ಯೋಶಿತಾ
যোষিত	ಯೋಷಿತ
যৌষা	ಯೌಷಾ
রংগনাতন	ರಂಗನಾತನ
রংগিথা	ರಂಗಿಥಾ
রংজীব	ರಂಜೀಬ
রংহ	ರಂಹ
রংহিতা	ರಂಹಿತಾ
রক্ষা	ರಕ್ಷಾ
রক্ষ্য	ರಕ್ಷ್ಯ
রগাব	ರಗಾಬ
রগীশ	ರಗೀಶ
রঘবেন্দর	ರಘಬೇನ್ದರ
রজনী	ರಜನೀ
রজনীগংধা	ರಜನೀಗಂಧಾ
রজিত	ರಜಿತ
রণছোড	ರಣಛೋಡ
রণবিজয	ರಣಬಿಜಯ
রনীত	ರನೀತ
রন্কীনী	ರನ್ಕೀನೀ
রমণীক	ರಮಣೀಕ
রমাংভাদ্র	ರಮಾಂಭಾದ್ರ
রমাংস্বম্য	ರಮಾಂಸ್ಬಮ್ಯ
রসনা	ರಸನಾ
রাকীন	ರಾಕೀನ
রাগ	ರಾಗ
রাগ্বীনদার	ರಾಗ್ಬೀನದಾರ
রাজঋষি	ರಾಜಋಷಿ
রাজস	ರಾಜಸ
রাজসূয	ರಾಜಸೂಯ
রাজসেকরণ	ರಾಜಸೇಕರಣ
রাজান্ন্য	ರಾಜಾನ್ನ್ಯ
রাজাবেলুং	ರಾಜಾಬೇಲುಂ
রাজারাম	ರಾಜಾರಾಮ
রাজালক্ষ্মী	ರಾಜಾಲಕ್ಷ್ಮೀ
রাজীষ	ರಾಜೀಷ
রাজেন্দর	ರಾಜೇನ್ದರ
রাজেশ্রম	ರಾಜೇಶ್ರಮ
রাজ্বলা	ರಾಜ್ಬಲಾ
রাধিকা	ರಾಧಿಕಾ
রাধী	ರಾಧೀ
রাধেশ	ರಾಧೇಶ
রাম  কীন্কার	ರಾಮ  ಕೀನ್ಕಾರ
রামকথালোলাযা	ರಾಮಕಥಾಲೋಲಾಯಾ
রামচংদর	ರಾಮಚಂದರ
রামচংদ্র	ರಾಮಚಂದ್ರ
রামনাথন	ರಾಮನಾಥನ
রামাধুতা	ರಾಮಾಧುತಾ
রাষীপ	ರಾಷೀಪ
রিনী	ರಿನೀ
রিলা	ರಿಲಾ
রীমা	ರೀಮಾ
রীষা	ರೀಷಾ
রেধা	ರೇಧಾ
রেভা	ರೇಭಾ
রেমিথা	ರೇಮಿಥಾ
রেহা	ರೇಹಾ
রোসাহেব	ರೋಸಾಹೇಬ
লক্ষণা	ಲಕ್ಷಣಾ
লক্ষ্মণ	ಲಕ್ಷ್ಮಣ
লক্ষ্মিবংতা	ಲಕ್ಷ್ಮಿಬಂತಾ
লক্ষ্মীকা	ಲಕ್ಷ್ಮೀಕಾ
লক্ষ্মীনাথ	ಲಕ್ಷ್ಮೀನಾಥ
লক্ষ্মীনারাযনা	ಲಕ್ಷ್ಮೀನಾರಾಯನಾ
লজীথা	ಲಜೀಥಾ
লবিনিযা	ಲಬಿನಿಯಾ
লযনা	ಲಯನಾ
ললিতামোহনা	ಲಲಿತಾಮೋಹನಾ
লাক্শীকা	ಲಾಕ್ಶೀಕಾ
লান্কীনীভান্জানা	ಲಾನ್ಕೀನೀಭಾನ್ಜಾನಾ
লালন	ಲಾಲನ
লালনা	ಲಾಲನಾ
লালী	ಲಾಲೀ
লীজেশ	ಲೀಜೇಶ
লীতীশা	ಲೀತೀಶಾ
লীনেয্ষা	ಲೀನೇಯ್ಷಾ
লীন্গসম্য	ಲೀನ್ಗಸಮ್ಯ
লীন্নেত	ಲೀನ್ನೇತ
লীন্সী	ಲೀನ್ಸೀ
লীলাকর	ಲೀಲಾಕರ
লীশীথা	ಲೀಶೀಥಾ
লুকেশ্বর	ಲುಕೇಶ್ಬರ
লুব্যা	ಲುಬ್ಯಾ
লুম্বিনী	ಲುಮ್ಬಿನೀ
লুসিযা	ಲುಸಿಯಾ
লেঈবীনা	ಲೇಈಬೀನಾ
লেখিত	ಲೇಖಿತ
লেনীশা	ಲೇನೀಶಾ
লেমাং	ಲೇಮಾಂ
লোকাপতী	ಲೋಕಾಪತೀ
লোকীথা	ಲೋಕೀಥಾ
লোকীনী	ಲೋಕೀನೀ
লোকেন্দের	ಲೋಕೇನ್ದೇರ
লোগনাথন	ಲೋಗನಾಥನ
লোগীতা	ಲೋಗೀತಾ
লোবীশ	ಲೋಬೀಶ
লোবেযংশ	ಲೋಬೇಯಂಶ
লোবেলীন	ಲೋಬೇಲೀನ
লোলাকসী	ಲೋಲಾಕಸೀ
লোহেংদ্র	ಲೋಹೇಂದ್ರ
সংকষ্টী	ಸಂಕಷ್ಟೀ
সংকেত	ಸಂಕೇತ
সংচিতা	ಸಂಚಿತಾ
সংজাণথী	ಸಂಜಾಣಥೀ
সংজীতী	ಸಂಜೀತೀ
সংভাজী	ಸಂಭಾಜೀ
সক্তীবেল	ಸಕ್ತೀಬೇಲ
সক্ষম	ಸಕ್ಷಮ
সখ্যা	ಸಖ್ಯಾ
সচংদ্র	ಸಚಂದ್ರ
সচিদানংদ বিগ্রহ	ಸಚಿದಾನಂದ ಬಿಗ್ರಹ
সচিশ	ಸಚಿಶ
সচীনা	ಸಚೀನಾ
সজনী	ಸಜನೀ
সজলা	ಸಜಲಾ
সজীলী	ಸಜೀಲೀ
সদগুনা	ಸದಗುನಾ
সদভুজা	ಸದಭುಜಾ
সনাহ	ಸನಾಹ
সবরিশ	ಸಬರಿಶ
সমবরণ	ಸಮಬರಣ
সমরজীত	ಸಮರಜೀತ
সমাংখ্যা	ಸಮಾಂಖ್ಯಾ
সমান্য	ಸಮಾನ್ಯ
সমাপ্তি	ಸಮಾಪ್ತಿ
সমিতা	ಸಮಿತಾ
সমীপতা	ಸಮೀಪತಾ
সমুদীতা	ಸಮುದೀತಾ
সমেধ	ಸಮೇಧ
সম্কীর্তী	ಸಮ್ಕೀರ್ತೀ
সম্মতি	ಸಮ್ಮತಿ
সম্রীতা	ಸಮ್ರೀತಾ
সম্হীঠা	ಸಮ್ಹೀಠಾ
সম্হীত	ಸಮ್ಹೀತ
সলজ	ಸಲಜ
সলারজুংগ	ಸಲಾರಜುಂಗ
সলীজ	ಸಲೀಜ
সলোখ	ಸಲೋಖ
সহজানংদ	ಸಹಜಾನಂದ
সহস্য	ಸಹಸ್ಯ
সহুরী	ಸಹುರೀ
সহেলী	ಸಹೇಲೀ
সহ্রুদী	ಸಹ್ರುದೀ
সাঈ	ಸಾಈ
সাঈ কুমার	ಸಾಈ ಕುಮಾರ
সাঈ চরণ	ಸಾಈ ಚರಣ
সাঈ সাহস	ಸಾಈ ಸಾಹಸ
সাকেত  শ্রীরাম	ಸಾಕೇತ  ಶ್ರೀರಾಮ
সাগরী	ಸಾಗರೀ
সাগ্নীকা	ಸಾಗ್ನೀಕಾ
সাচিকা	ಸಾಚಿಕಾ
সাজিশ	ಸಾಜಿಶ
সাত্বী	ಸಾತ್ಬೀ
সাধনা	ಸಾಧನಾ
সাধীন	ಸಾಧೀನ
সাধ্রী	ಸಾಧ್ರೀ
সানাবী	ಸಾನಾಬೀ
সানিযা	ಸಾನಿಯಾ
সাফল্য	ಸಾಫಲ್ಯ
সামলী	ಸಾಮಲೀ
সামান	ಸಾಮಾನ
সালন	ಸಾಲನ
সাহিত্য	ಸಾಹಿತ್ಯ
সাহিল	ಸಾಹಿಲ
সৈকত	ಸೈಕತ
সৈচারণ	ಸೈಚಾರಣ
সৈলী	ಸೈಲೀ
সৈলেশ্বর	ಸೈಲೇಶ್ಬರ
সৈস্বেঠা	ಸೈಸ್ಬೇಠಾ
হংসিক	ಹಂಸಿಕ
হতিশা	ಹತಿಶಾ
হনীমা	ಹನೀಮಾ
হনীশ	ಹನೀಶ
হনুমংত	ಹನುಮಂತ
হন্বীথা	ಹನ್ಬೀಥಾ
হবন	ಹಬನ
হম্সলেখা	ಹಮ್ಸಲೇಖಾ
হযাতী	ಹಯಾತೀ
হরম্যা	ಹರಮ್ಯಾ
হরা	ಹರಾ
হরীআক্ষ	ಹರೀಆಕ್ಷ
হরীচংদনা	ಹರೀಚಂದನಾ
হরীরাম	ಹರೀರಾಮ
হরীশ	ಹರೀಶ
হরেকৃষ্ণ	ಹರೇಕೃಷ್ಣ
হরেশ	ಹರೇಶ
হরেহান	ಹರೇಹಾನ
হর্থীকা	ಹರ್ಥೀಕಾ
হর্শত	ಹರ್ಶತ
হশন	ಹಶನ
হশিকা	ಹಶಿಕಾ
হশ্বর্ধন	ಹಶ್ಬರ್ಧನ
হসিত	ಹಸಿತ
হসীত	ಹಸೀತ
হসীনী	ಹಸೀನೀ
হস্বীকা	ಹಸ್ಬೀಕಾ
হস্সীনী	ಹಸ್ಸೀನೀ
হাকেশ	ಹಾಕೇಶ
হারজীত	ಹಾರಜೀತ
হাসীতা	ಹಾಸೀತಾ
হিডিংবা	ಹಿಡಿಂಬಾ
হিত	ಹಿತ
হিতেশ	ಹಿತೇಶ
হিথীকা	ಹಿಥೀಕಾ
হিমংজয	ಹಿಮಂಜಯ
হিমবংত	ಹಿಮಬಂತ
হিরকনী	ಹಿರಕನೀ
হিরণ	ಹಿರಣ
হিরেশ	ಹಿರೇಶ
হিশেথা	ಹಿಶೇಥಾ
হীমীর	ಹೀಮೀರ
হেতংশ	ಹೇತಂಶ
হেনীত	ಹೇನೀತ
হেনীশী	ಹೇನೀಶೀ
হেপ্পী	ಹೇಪ್ಪೀ
হেমচংদর	ಹೇಮಚಂದರ
হেমরাজ	ಹೇಮರಾಜ
হেমা লাথী	ಹೇಮಾ ಲಾಥೀ
হেমাংগ	ಹೇಮಾಂಗ
হেমাংবিংদু	ಹೇಮಾಂಬಿಂದು
হেমাংশু	ಹೇಮಾಂಶು
হেমাগনী	ಹೇಮಾಗನೀ
হেমিল	ಹೇಮಿಲ
হেম্স	ಹೇಮ್ಸ
হেরংব	ಹೇರಂಬ
হৈমাং	ಹೈಮಾಂ
হৈযা	ಹೈಯಾ
হোমা	ಹೋಮಾ
হ্রাদিনী	ಹ್ರಾದಿನೀ
হ্রাধা	ಹ್ರಾಧಾ
হ্রীদা	ಹ್ರೀದಾ
হ্রীদান্ক্ষ	ಹ್ರೀದಾನ್ಕ್ಷ
#
#
# Territory names from CLDR
অ্যাসসেনশন আইল্যান্ড	ಅ್ಯಾಸಸೇನಶನ ಆಇಲ್ಯಾನ್ಡ
এ্যান্ডোরা	ಏ್ಯಾನ್ಡೋರಾ
সংযুক্ত আরব আমিরাত	ಸಂಯುಕ್ತ ಆರಬ ಆಮಿರಾತ
আফগানিস্তান	ಆಫಗಾನಿಸ್ತಾನ
এন্টিগুয়া ও বারবুডা	ಏನ್ಟಿಗುಯ಼ಾ ಓ ಬಾರಬುಡಾ
এ্যাঙ্গুইলা	ಏ್ಯಾಙ್ಗುಇಲಾ
আলব্যানিয়া	ಆಲಬ್ಯಾನಿಯ಼ಾ
আর্মেনিয়া	ಆರ್ಮೇನಿಯ಼ಾ
অ্যাঙ্গোলা	ಅ್ಯಾಙ್ಗೋಲಾ
অ্যান্টার্কটিকা	ಅ್ಯಾನ್ಟಾರ್ಕಟಿಕಾ
আর্জেন্টিনা	ಆರ್ಜೇನ್ಟಿನಾ
আমেরিকান সামোয়া	ಆಮೇರಿಕಾನ ಸಾಮೋಯ಼ಾ
অস্ট্রিয়া	ಅಸ್ಟ್ರಿಯ಼ಾ
অস্ট্রেলিয়া	ಅಸ್ಟ್ರೇಲಿಯ಼ಾ
আরুবা	ಆರುಬಾ
আলান্ড দ্বীপপুঞ্জ	ಆಲಾನ್ಡ ದ್ಬೀಪಪುಞ್ಜ
আজারবাইজান	ಆಜಾರಬಾಇಜಾನ
বসনিয়া ও হার্জেগোভিনা	ಬಸನಿಯ಼ಾ ಓ ಹಾರ್ಜೇಗೋಭಿನಾ
বারবাদোস	ಬಾರಬಾದೋಸ
বাংলাদেশ	ಬಾಂಲಾದೇಶ
বেলজিয়াম	ಬೇಲಜಿಯ಼ಾಮ
বুরকিনা ফাসো	ಬುರಕಿನಾ ಫಾಸೋ
বুলগেরিয়া	ಬುಲಗೇರಿಯ಼ಾ
বাহরাইন	ಬಾಹರಾಇನ
বুরুন্ডি	ಬುರುನ್ಡಿ
বেনিন	ಬೇನಿನ
সেন্ট বারথেলিমি	ಸೇನ್ಟ ಬಾರಥೇಲಿಮಿ
বারমুডা	ಬಾರಮುಡಾ
ব্রুনেই	ಬ್ರುನೇಇ
বোলিভিয়া	ಬೋಲಿಭಿಯ಼ಾ
ক্যারিবিয়ান নেদারল্যান্ডস	ಕ್ಯಾರಿಬಿಯ಼ಾನ ನೇದಾರಲ್ಯಾನ್ಡಸ
ব্রাজিল	ಬ್ರಾಜಿಲ
বাহামা দ্বীপপুঞ্জ	ಬಾಹಾಮಾ ದ್ಬೀಪಪುಞ್ಜ
ভুটান	ಭುಟಾನ
বোভেট দ্বীপ	ಬೋಭೇಟ ದ್ಬೀಪ
বতসোয়ানা	ಬತಸೋಯ಼ಾನಾ
বেলোরুশিয়া	ಬೇಲೋರುಶಿಯ಼ಾ
বেলিজ	ಬೇಲಿಜ
কানাডা	ಕಾನಾಡಾ
কোকোস (কিলিং)দ্বীপপুঞ্জ	ಕೋಕೋಸ (ಕಿಲಿಂ)ದ್ಬೀಪಪುಞ್ಜ
কঙ্গো-কিনশাসা	ಕಙ್ಗೋ-ಕಿನಶಾಸಾ
কঙ্গো(DRC)	ಕಙ್ಗೋ(DRC)
মধ্য আফ্রিকার প্রজাতন্ত্র	ಮಧ್ಯ ಆಫ್ರಿಕಾರ ಪ್ರಜಾತನ್ತ್ರ
কঙ্গো - ব্রাজাভিল	ಕಙ್ಗೋ - ಬ್ರಾಜಾಭಿಲ
কঙ্গো (প্রজাতন্ত্র)	ಕಙ್ಗೋ (ಪ್ರಜಾತನ್ತ್ರ)
সুইজারল্যান্ড	ಸುಇಜಾರಲ್ಯಾನ್ಡ
আইভরি কোস্ট	ಆಇಭರಿ ಕೋಸ್ಟ
কুক দ্বীপপুঞ্জ	ಕುಕ ದ್ಬೀಪಪುಞ್ಜ
চিলি	ಚಿಲಿ
ক্যামেরুন	ಕ್ಯಾಮೇರುನ
চীন	ಚೀನ
কোলোম্বিয়া	ಕೋಲೋಮ್ಬಿಯ಼ಾ
ক্লিপারটন আইল্যান্ড	ಕ್ಲಿಪಾರಟನ ಆಇಲ್ಯಾನ್ಡ
কোস্টারিকা	ಕೋಸ್ಟಾರಿಕಾ
কিউবা	ಕಿಉಬಾ
কেপভার্দে	ಕೇಪಭಾರ್ದೇ
কিউরাসাও	ಕಿಉರಾಸಾಓ
ক্রিসমাস দ্বীপ	ಕ್ರಿಸಮಾಸ ದ್ಬೀಪ
সাইপ্রাস	ಸಾಇಪ್ರಾಸ
চেক প্রজাতন্ত্র	ಚೇಕ ಪ್ರಜಾತನ್ತ್ರ
জার্মানি	ಜಾರ್ಮಾನಿ
দিয়েগো গার্সিয়া	ದಿಯ಼ೇಗೋ ಗಾರ್ಸಿಯ಼ಾ
জিবুতি	ಜಿಬುತಿ
ডেনমার্ক	ಡೇನಮಾರ್ಕ
ডোমিনিকা	ಡೋಮಿನಿಕಾ
ডোমেনিকান প্রজাতন্ত্র	ಡೋಮೇನಿಕಾನ ಪ್ರಜಾತನ್ತ್ರ
আলজেরিয়া	ಆಲಜೇರಿಯ಼ಾ
কুউটা এবং মেলিলা	ಕುಉಟಾ ಏಬಂ ಮೇಲಿಲಾ
ইকুয়েডর	ಇಕುಯ಼ೇಡರ
এস্তোনিয়া	ಏಸ್ತೋನಿಯ಼ಾ
মিশর	ಮಿಶರ
পশ্চিম সাহারা	ಪಶ್ಚಿಮ ಸಾಹಾರಾ
ইরিত্রিয়া	ಇರಿತ್ರಿಯ಼ಾ
স্পেন	ಸ್ಪೇನ
ইফিওপিয়া	ಇಫಿಓಪಿಯ಼ಾ
ইউরোপীয় ইউনিয়ন	ಇಉರೋಪೀಯ಼ ಇಉನಿಯ಼ನ
ফিনল্যান্ড	ಫಿನಲ್ಯಾನ್ಡ
ফিজি	ಫಿಜಿ
ফকল্যান্ড দ্বীপপুঞ্জ	ಫಕಲ್ಯಾನ್ಡ ದ್ಬೀಪಪುಞ್ಜ
ফকল্যান্ড আইল্যান্ড ( ইসল্যাস মাসভেনিস)	ಫಕಲ್ಯಾನ್ಡ ಆಇಲ್ಯಾನ್ಡ ( ಇಸಲ್ಯಾಸ ಮಾಸಭೇನಿಸ)
মাইক্রোনেশিয়া	ಮಾಇಕ್ರೋನೇಶಿಯ಼ಾ
ফ্যারও দ্বীপপুঞ্জ	ಫ್ಯಾರಓ ದ್ಬೀಪಪುಞ್ಜ
ফ্রান্স	ಫ್ರಾನ್ಸ
গ্যাবন	ಗ್ಯಾಬನ
যুক্তরাজ্য	ಯುಕ್ತರಾಜ್ಯ
গ্রেনেডা	ಗ್ರೇನೇಡಾ
জর্জিয়া	ಜರ್ಜಿಯ಼ಾ
ফরাসী গায়ানা	ಫರಾಸೀ ಗಾಯ಼ಾನಾ
গ্রাঞ্জি	ಗ್ರಾಞ್ಜಿ
ঘানা	ಘಾನಾ
জিব্রাল্টার	ಜಿಬ್ರಾಲ್ಟಾರ
গ্রীনল্যান্ড	ಗ್ರೀನಲ್ಯಾನ್ಡ
গাম্বিয়া	ಗಾಮ್ಬಿಯ಼ಾ
গিনি	ಗಿನಿ
গুয়াদেলৌপ	ಗುಯ಼ಾದೇಲೌಪ
নিরক্ষীয় গিনি	ನಿರಕ್ಷೀಯ಼ ಗಿನಿ
গ্রীস	ಗ್ರೀಸ
দক্ষিণ জর্জিয়া ও দক্ষিণ স্যান্ডউইচ দ্বীপপুঞ্জ	ದಕ್ಷಿಣ ಜರ್ಜಿಯ಼ಾ ಓ ದಕ್ಷಿಣ ಸ್ಯಾನ್ಡಉಇಚ ದ್ಬೀಪಪುಞ್ಜ
গোয়াতেমালা	ಗೋಯ಼ಾತೇಮಾಲಾ
গুয়াম	ಗುಯ಼ಾಮ
গিনি-বিসাউ	ಗಿನಿ-ಬಿಸಾಉ
গিয়ানা	ಗಿಯ಼ಾನಾ
হংকং এসএআর চীনা	ಹಂಕಂ ಏಸಏಆರ ಚೀನಾ
হংকং	ಹಂಕಂ
হার্ড দ্বীপ এবং ম্যাকডোনাল্ড দ্বীপপুঞ্জ	ಹಾರ್ಡ ದ್ಬೀಪ ಏಬಂ ಮ್ಯಾಕಡೋನಾಲ್ಡ ದ್ಬೀಪಪುಞ್ಜ
হণ্ডুরাস	ಹಣ್ಡುರಾಸ
ক্রোয়েশিয়া	ಕ್ರೋಯ಼ೇಶಿಯ಼ಾ
হাইতি	ಹಾಇತಿ
হাঙ্গেরি	ಹಾಙ್ಗೇರಿ
ক্যানারি দ্বীপপুঞ্জ	ಕ್ಯಾನಾರಿ ದ್ಬೀಪಪುಞ್ಜ
ইন্দোনেশিয়া	ಇನ್ದೋನೇಶಿಯ಼ಾ
আয়ারল্যান্ড	ಆಯ಼ಾರಲ್ಯಾನ್ಡ
ইজরায়েল	ಇಜರಾಯ಼ೇಲ
আইল অফ ম্যান	ಆಇಲ ಅಫ ಮ್ಯಾನ
ভারত	ಭಾರತ
ব্রিটিশ ভারত মহাসাগরীয় অঞ্চল	ಬ್ರಿಟಿಶ ಭಾರತ ಮಹಾಸಾಗರೀಯ಼ ಅಞ್ಚಲ
ইরাক	ಇರಾಕ
ইরান	ಇರಾನ
আইসল্যান্ড	ಆಇಸಲ್ಯಾನ್ಡ
ইতালী	ಇತಾಲೀ
জার্সি	ಜಾರ್ಸಿ
জামাইকা	ಜಾಮಾಇಕಾ
জর্ডন	ಜರ್ಡನ
জাপান	ಜಾಪಾನ
কেনিয়া	ಕೇನಿಯ಼ಾ
কির্গিজিয়া	ಕಿರ್ಗಿಜಿಯ಼ಾ
কম্বোডিয়া	ಕಮ್ಬೋಡಿಯ಼ಾ
কিরিবাতি	ಕಿರಿಬಾತಿ
কমোরোস	ಕಮೋರೋಸ
সেন্ট কিটস ও নেভিস	ಸೇನ್ಟ ಕಿಟಸ ಓ ನೇಭಿಸ
উত্তর কোরিয়া	ಉತ್ತರ ಕೋರಿಯ಼ಾ
দক্ষিণ কোরিয়া	ದಕ್ಷಿಣ ಕೋರಿಯ಼ಾ
কুয়েত	ಕುಯ಼ೇತ
কেম্যান দ্বীপপুঞ্জ	ಕೇಮ್ಯಾನ ದ್ಬೀಪಪುಞ್ಜ
কাজাখস্তান	ಕಾಜಾಖಸ್ತಾನ
লাওস	ಲಾಓಸ
লেবানন	ಲೇಬಾನನ
সেন্ট লুসিয়া	ಸೇನ್ಟ ಲುಸಿಯ಼ಾ
লিচেনস্টেইন	ಲಿಚೇನಸ್ಟೇಇನ
শ্রীলঙ্কা	ಶ್ರೀಲಙ್ಕಾ
লাইবেরিয়া	ಲಾಇಬೇರಿಯ಼ಾ
লেসোথো	ಲೇಸೋಥೋ
লিথুয়ানিয়া	ಲಿಥುಯ಼ಾನಿಯ಼ಾ
লাক্সেমবার্গ	ಲಾಕ್ಸೇಮಬಾರ್ಗ
লাত্ভিয়া	ಲಾತ್ಭಿಯ಼ಾ
লিবিয়া	ಲಿಬಿಯ಼ಾ
মোরক্কো	ಮೋರಕ್ಕೋ
মোনাকো	ಮೋನಾಕೋ
মোল্দাভিয়া	ಮೋಲ್ದಾಭಿಯ಼ಾ
মন্টিনিগ্রো	ಮನ್ಟಿನಿಗ್ರೋ
সেন্ট মার্টিন	ಸೇನ್ಟ ಮಾರ್ಟಿನ
মাদাগাস্কার	ಮಾದಾಗಾಸ್ಕಾರ
মার্শাল দ্বীপপুঞ্জ	ಮಾರ್ಶಾಲ ದ್ಬೀಪಪುಞ್ಜ
ম্যাসাডোনিয়া	ಮ್ಯಾಸಾಡೋನಿಯ಼ಾ
মেসিডোনিয়া(FYROM)	ಮೇಸಿಡೋನಿಯ಼ಾ(FYROM)
মালি	ಮಾಲಿ
মায়ানমার (বার্মা)	ಮಾಯ಼ಾನಮಾರ (ಬಾರ್ಮಾ)
মঙ্গোলিয়া	ಮಙ್ಗೋಲಿಯ಼ಾ
ম্যাকাও এস এ আর চায়না	ಮ್ಯಾಕಾಓ ಏಸ ಏ ಆರ ಚಾಯ಼ನಾ
ম্যাকাও	ಮ್ಯಾಕಾಓ
উত্তরাঞ্চলীয় মারিয়ানা দ্বীপপুঞ্জ	ಉತ್ತರಾಞ್ಚಲೀಯ಼ ಮಾರಿಯ಼ಾನಾ ದ್ಬೀಪಪುಞ್ಜ
মার্টিনিক	ಮಾರ್ಟಿನಿಕ
মরিতানিয়া	ಮರಿತಾನಿಯ಼ಾ
মন্টসেরাট	ಮನ್ಟಸೇರಾಟ
মাল্টা	ಮಾಲ್ಟಾ
মরিশাস	ಮರಿಶಾಸ
মালদ্বীপ	ಮಾಲದ್ಬೀಪ
মালাউই	ಮಾಲಾಉಇ
মেক্সিকো	ಮೇಕ್ಸಿಕೋ
মালয়েশিয়া	ಮಾಲಯ಼ೇಶಿಯ಼ಾ
মোজাম্বিক	ಮೋಜಾಮ್ಬಿಕ
নামিবিয়া	ನಾಮಿಬಿಯ಼ಾ
নিউ ক্যালেডোনিয়া	ನಿಉ ಕ್ಯಾಲೇಡೋನಿಯ಼ಾ
নাইজার	ನಾಇಜಾರ
নিরফোক দ্বীপ	ನಿರಫೋಕ ದ್ಬೀಪ
নাইজেরিয়া	ನಾಇಜೇರಿಯ಼ಾ
নিকারাগুয়া	ನಿಕಾರಾಗುಯ಼ಾ
নেদারল্যান্ডস	ನೇದಾರಲ್ಯಾನ್ಡಸ
নরওয়ে	ನರಓಯ಼ೇ
নেপাল	ನೇಪಾಲ
নাউরু	ನಾಉರು
নিউয়ে	ನಿಉಯ಼ೇ
নিউজিল্যান্ড	ನಿಉಜಿಲ್ಯಾನ್ಡ
ওমান	ಓಮಾನ
পানামা	ಪಾನಾಮಾ
পিরু	ಪಿರು
ফরাসী পলিনেশিয়া	ಫರಾಸೀ ಪಲಿನೇಶಿಯ಼ಾ
পাপুয়া নিউ গিনি	ಪಾಪುಯ಼ಾ ನಿಉ ಗಿನಿ
ফিলিপাইন	ಫಿಲಿಪಾಇನ
পাকিস্তান	ಪಾಕಿಸ್ತಾನ
পোল্যান্ড	ಪೋಲ್ಯಾನ್ಡ
সেন্ট পিয়ের ও মিকুয়েলন	ಸೇನ್ಟ ಪಿಯ಼ೇರ ಓ ಮಿಕುಯ಼ೇಲನ
পিটকেয়ার্ন দ্বীপপুঞ্জ	ಪಿಟಕೇಯ಼ಾರ್ನ ದ್ಬೀಪಪುಞ್ಜ
পুয়ের্তো রিকো	ಪುಯ಼ೇರ್ತೋ ರಿಕೋ
ফিলিস্তিন অঞ্চলসমূহ	ಫಿಲಿಸ್ತಿನ ಅಞ್ಚಲಸಮೂಹ
ফিলিস্তিন	ಫಿಲಿಸ್ತಿನ
পর্তুগাল	ಪರ್ತುಗಾಲ
পালাউ	ಪಾಲಾಉ
প্যারাগুয়ে	ಪ್ಯಾರಾಗುಯ಼ೇ
কাতার	ಕಾತಾರ
আউটলাইনিং ওসানিয়া	ಆಉಟಲಾಇನಿಂ ಓಸಾನಿಯ಼ಾ
রিইউনিয়ন	ರಿಇಉನಿಯ಼ನ
রুমানিয়া	ರುಮಾನಿಯ಼ಾ
সার্বিয়া	ಸಾರ್ಬಿಯ಼ಾ
রাশিয়া	ರಾಶಿಯ಼ಾ
রুয়ান্ডা	ರುಯ಼ಾನ್ಡಾ
সৌদি আরব	ಸೌದಿ ಆರಬ
সলোমন দ্বীপপুঞ্জ	ಸಲೋಮನ ದ್ಬೀಪಪುಞ್ಜ
সিসিলি	ಸಿಸಿಲಿ
সুদান	ಸುದಾನ
সুইডেন	ಸುಇಡೇನ
সিঙ্গাপুর	ಸಿಙ್ಗಾಪುರ
সেন্ট হেলেনা	ಸೇನ್ಟ ಹೇಲೇನಾ
স্লোভানিয়া	ಸ್ಲೋಭಾನಿಯ಼ಾ
স্বালবার্ড ও জান মেয়েন	ಸ್ಬಾಲಬಾರ್ಡ ಓ ಜಾನ ಮೇಯ಼ೇನ
শ্লোভাকিয়া	ಶ್ಲೋಭಾಕಿಯ಼ಾ
সিয়েরালিওন	ಸಿಯ಼ೇರಾಲಿಓನ
সান মারিনো	ಸಾನ ಮಾರಿನೋ
সেনেগাল	ಸೇನೇಗಾಲ
সোমালিয়া	ಸೋಮಾಲಿಯ಼ಾ
সুরিনাম	ಸುರಿನಾಮ
দক্ষিন সুদান	ದಕ್ಷಿನ ಸುದಾನ
সাওটোমা ও প্রিন্সিপি	ಸಾಓಟೋಮಾ ಓ ಪ್ರಿನ್ಸಿಪಿ
এল সালভেদর	ಏಲ ಸಾಲಭೇದರ
সিন্ট মার্টেন	ಸಿನ್ಟ ಮಾರ್ಟೇನ
সিরিয়া	ಸಿರಿಯ಼ಾ
সোয়াজিল্যান্ড	ಸೋಯ಼ಾಜಿಲ್ಯಾನ್ಡ
ট্রিস্টান ডা কুনহা	ಟ್ರಿಸ್ಟಾನ ಡಾ ಕುನಹಾ
তুর্কস ও কাইকোস দ্বীপপুঞ্জ	ತುರ್ಕಸ ಓ ಕಾಇಕೋಸ ದ್ಬೀಪಪುಞ್ಜ
চাদ	ಚಾದ
ফরাসী দক্ষিণাঞ্চল	ಫರಾಸೀ ದಕ್ಷಿಣಾಞ್ಚಲ
টোগো	ಟೋಗೋ
থাইল্যান্ড	ಥಾಇಲ್ಯಾನ್ಡ
তাজিকস্থান	ತಾಜಿಕಸ್ಥಾನ
টোকেলাউ	ಟೋಕೇಲಾಉ
তিমুর-লেস্তে	ತಿಮುರ-ಲೇಸ್ತೇ
পূর্ব তিমুর	ಪೂರ್ಬ ತಿಮುರ
তুর্কমেনিস্তান	ತುರ್ಕಮೇನಿಸ್ತಾನ
তিউনিশিয়া	ತಿಉನಿಶಿಯ಼ಾ
টোঙ্গা	ಟೋಙ್ಗಾ
তুরস্ক	ತುರಸ್ಕ
ত্রিনিনাদ ও টোব্যাগো	ತ್ರಿನಿನಾದ ಓ ಟೋಬ್ಯಾಗೋ
টুভালু	ಟುಭಾಲು
তাইওয়ান	ತಾಇಓಯ಼ಾನ
তাঞ্জানিয়া	ತಾಞ್ಜಾನಿಯ಼ಾ
ইউক্রেইন	ಇಉಕ್ರೇಇನ
উগান্ডা	ಉಗಾನ್ಡಾ
যুক্তরাষ্ট্রের পার্শ্ববর্তী দ্বীপপুঞ্জ	ಯುಕ್ತರಾಷ್ಟ್ರೇರ ಪಾರ್ಶ್ಬಬರ್ತೀ ದ್ಬೀಪಪುಞ್ಜ
মার্কিন যুক্তরাষ্ট্র	ಮಾರ್ಕಿನ ಯುಕ್ತರಾಷ್ಟ್ರ
ইউ এস	ಇಉ ಏಸ
উরুগুয়ে	ಉರುಗುಯ಼ೇ
উজবেকিস্তান	ಉಜಬೇಕಿಸ್ತಾನ
ভ্যাটিকান সিটি	ಭ್ಯಾಟಿಕಾನ ಸಿಟಿ
সেন্ট ভিনসেন্ট ও দ্যা গ্রেনাডিনস	ಸೇನ್ಟ ಭಿನಸೇನ್ಟ ಓ ದ್ಯಾ ಗ್ರೇನಾಡಿನಸ
ভেনেজুয়েলা	ಭೇನೇಜುಯ಼ೇಲಾ
ব্রিটিশ ভার্জিন দ্বীপপুঞ্জ	ಬ್ರಿಟಿಶ ಭಾರ್ಜಿನ ದ್ಬೀಪಪುಞ್ಜ
মার্কিন ভার্জিন দ্বীপপুঞ্জ	ಮಾರ್ಕಿನ ಭಾರ್ಜಿನ ದ್ಬೀಪಪುಞ್ಜ
ভিয়েতনাম	ಭಿಯ಼ೇತನಾಮ
ভানুয়াটু	ಭಾನುಯ಼ಾಟು
ওয়ালিস ও ফুটুনা	ಓಯ಼ಾಲಿಸ ಓ ಫುಟುನಾ
সামোয়া	ಸಾಮೋಯ಼ಾ
কসোভো	ಕಸೋಭೋ
ইয়েমেন	ಇಯ಼ೇಮೇನ
মায়োত্তে	ಮಾಯ಼ೋತ್ತೇ
দক্ষিণ আফ্রিকা	ದಕ್ಷಿಣ ಆಫ್ರಿಕಾ
জাম্বিয়া	ಜಾಮ್ಬಿಯ಼ಾ
জিম্বাবোয়ে	ಜಿಮ್ಬಾಬೋಯ಼ೇ
অজানা স্থান	ಅಜಾನಾ ಸ್ಥಾನ
