aβaβux	阿瓦武赫
aβaðes	阿瓦德斯
aβaðja	阿瓦迪亚
aβaðjano	阿瓦迪亚诺
aβaðin	阿瓦丁
aβanaðes	阿瓦纳德斯
aβaniʎa	阿瓦尼利亚
aβaɾan	阿瓦兰
aβeɣondo	阿韦贡多
aβexaɾ	阿韦哈尔
aβexwela	阿韦胡埃拉
aβenxiβɾa	阿文希夫拉
aβenoxaɾ	阿韦诺哈尔
aβjeɣo	阿维耶戈
aβla	阿夫拉
aβlitas	阿夫利塔斯
aβɾeɾa	阿夫雷拉
aβɾuθena	阿夫鲁塞纳
aθeβo	阿塞沃
aθeðeɾa	阿塞德拉
aθe.uʧe	阿塞乌切
aθeu̯ʧal	阿塞乌查尔
akɾixos	阿克里霍斯
aða.weska	阿达韦斯卡
aðamuθ	阿达穆斯
aðaneɾo	阿达内罗
aðai̯	阿代
aðexe	阿德赫
aðemuθ	阿德穆斯
aðoɾ	阿多尔
aðɾa	阿德拉
aðɾaðas	阿德拉达斯
aðɾaðos	阿德拉多斯
aðθaneta	阿德萨内塔
aɣaete	阿加埃特
axeɾ	阿赫尔
aɣonθiʎo	阿贡西略
aɣost	阿戈斯特
aɣɾamon	阿格拉蒙
aɣɾamunt	阿格拉蒙特
aɣɾeða	阿格雷达
aɣɾes	阿格雷斯
aɣɾon	阿格龙
aɣwaðulθe	阿瓜杜尔塞
aɣwamansa	阿瓜曼萨
aɣwaɾon	阿瓜龙
aɣwas	阿瓜斯
aɣwaβiβa	阿瓜维瓦
aɣuðo	阿古多
aɣweɾa	阿圭拉
aɣweɾo	阿圭罗
aɣila	阿吉拉
aɣilafwente	阿吉拉丰特
aɣilas	阿吉拉斯
aɣwimes	阿圭梅斯
aɣuʎana	阿古利亚纳
aɣulo	阿古洛
a.iɣal	阿伊加尔
a.iʎones	阿伊略内斯
aʝanis	阿亚尼斯
ai̯βaɾ	艾瓦尔
ai̯ɣwamuɾθja	艾瓜穆尔西亚
ai̯nsa	艾恩萨
ai̯θpun	艾斯蓬
axamil	阿哈米尔
alaexos	阿莱霍斯
alaɣon	阿拉贡
alaxaɾ	阿拉哈尔
alaxeɾo	阿拉赫罗
alameða	阿拉梅达
alameðiʎa	阿拉梅迪利亚
alamiʎo	阿拉米略
alaminos	阿拉米诺斯
alanxe	阿兰赫
alaɾkon	阿拉尔孔
alaɾiʎa	阿拉里利亚
alaɾo	阿拉罗
alatoθ	阿拉托斯
alaʝoɾ	阿拉约尔
alβa	阿尔瓦
alβaθete	阿尔瓦塞特
alβaxes	阿尔瓦赫斯
alβalaðexo	阿尔瓦拉德霍
alβalatiʎo	阿尔瓦拉蒂略
alβana	阿尔瓦纳
alβanʧeθ	阿尔万切斯
alβaɾes	阿尔瓦雷斯
alβaraθin	阿尔瓦拉辛
alβatana	阿尔瓦塔纳
alβateɾa	阿尔瓦特拉
alβendea	阿尔文德阿
alβendin	阿尔文丁
alβentosa	阿尔文托萨
alβeɾike	阿尔韦里克
alβeɾite	阿尔韦里特
alβesa	阿尔韦萨
alβinana	阿尔维纳纳
alβokaθeɾ	阿尔沃卡塞尔
alβoloðui	阿尔沃洛杜伊
alβolote	阿尔沃洛特
alβondon	阿尔翁东
alβoɾaʝa	阿尔沃拉亚
alβoɾea	阿尔沃雷阿
alβoks	阿尔沃克斯
alβuðei̯te	阿尔武代特
alβuxon	阿尔武洪
alβuɲol	阿尔武尼奥尔
alβuɲwelas	阿尔武纽埃拉斯
alkaðoθo	阿尔卡多索
alkai̯ne	阿尔凯内
alkampel	阿尔坎佩尔
alkanaðɾe	阿尔卡纳德雷
alkanaɾ	阿尔卡纳尔
alkaniθes	阿尔卡尼塞斯
alkaniθ	阿尔卡尼斯
alkantaɾa	阿尔坎塔拉
alkantaɾiʎa	阿尔坎塔里利亚
alkantuð	阿尔坎图
alkaɾaθexos	阿尔卡拉塞霍斯
alkaɾaθ	阿尔卡拉斯
alkaras	阿尔卡拉斯
alkau̯θin	阿尔考辛
alkau̯ðete	阿尔考德特
alkaθaɾen	阿尔卡萨伦
alθeða	阿尔塞达
alθiɾa	阿尔西拉
alkoβa	阿尔科瓦
alkoβendas	阿尔科文达斯
alkoθeβɾe	阿尔科塞夫雷
alkoθeɾ	阿尔科塞尔
alko.uxate	阿尔科乌哈特
alkolea	阿尔科莱阿
alkoʎaɾin	阿尔科利亚林
alkonʧel	阿尔孔切尔
alkoneɾa	阿尔科内拉
alkontaɾ	阿尔孔塔尔
alkoɾa	阿尔科拉
alkoɾisa	阿尔科里萨
alkoɾoʧes	阿尔科罗切斯
alkoβeɾ	阿尔科韦尔
alkoi̯	阿尔科伊
alkuβjere	阿尔库维耶雷
alkuβiʎas	阿尔库维利亚斯
alkuβlas	阿尔库夫拉斯
alkuðja	阿尔库迪亚
alkweskaɾ	阿尔库埃斯卡尔
alkuneθa	阿尔库内萨
aldaʝa	阿尔达亚
aldea	阿尔德阿
aldeaθenteneɾa	阿尔德阿森特内拉
aldealpoθo	阿尔德阿尔波索
aldeakemaða	阿尔德阿克马达
aldearoðɾiɣo	阿尔德阿罗德里戈
aldeaβjexa	阿尔德阿维耶哈
alde.wela	阿尔德韦拉
aldei̯ɾe	阿尔代雷
aldoβeɾ	阿尔多韦尔
aleðo	阿莱多
aleɣɾja	阿莱格里亚
alere	阿莱雷
aleson	阿莱松
alfakaɾ	阿尔法卡尔
alfai̯θ	阿尔法伊斯
alfaxaɾin	阿尔法哈林
alfambɾa	阿尔凡布拉
alfamen	阿尔法门
alfaɾa	阿尔法拉
alfaɾaθ	阿尔法拉斯
alfaɾo	阿尔法罗
alfaras	阿尔法拉斯
alfoθ	阿尔福斯
alɣai̯ða	阿尔盖达
alɣamitas	阿尔加米塔斯
alɣaɾinexo	阿尔加里内霍
alɣara	阿尔加拉
alɣaroβo	阿尔加罗沃
alɣatoθin	阿尔加托辛
alxeθiɾas	阿尔赫西拉斯
alxemesi	阿尔赫梅西
alxete	阿尔赫特
alxinet	阿尔希内特
alɣoðonales	阿尔戈多纳莱斯
alɣoɾa	阿尔戈拉
alɣɾja	阿尔格里亚
alɣwai̯ɾe	阿尔瓜伊雷
alɣwaθas	阿尔瓜萨斯
alɣeɲa	阿尔格尼亚
alja	阿利亚
aljaɣa	阿利亚加
alikante	阿利坎特
aliseða	阿利塞达
alxaɾake	阿尔哈拉克
alxiβe	阿尔希韦
alxora	阿尔霍拉
alxuθen	阿尔胡森
aʎaɾiθ	阿利亚里斯
aʎepuθ	阿列普斯
aʎeɾ	阿列尔
aʎes	阿列斯
aʎo	阿略
aʎoθa	阿略萨
almaθeʎas	阿尔马塞利亚斯
almaʧaɾ	阿尔马查尔
almaθiles	阿尔马西莱斯
almaðen	阿尔马登
almaðenexos	阿尔马德内霍斯
almaðɾones	阿尔马德罗内斯
almaɣɾo	阿尔马格罗
almaxano	阿尔马哈诺
almalweθ	阿尔马卢埃斯
almansa	阿尔曼萨
almanθa	阿尔曼萨
almaɾaθ	阿尔马拉斯
almatɾet	阿尔马特雷特
almaθan	阿尔马桑
almaθoɾa	阿尔马索拉
almaθul	阿尔马苏尔
almeðina	阿尔梅迪纳
almeðiniʎa	阿尔梅迪尼利亚
almexixaɾ	阿尔梅希哈尔
almei̯ða	阿尔梅达
almenaɾ	阿尔梅纳尔
almenaɾa	阿尔梅纳拉
almendɾa	阿尔门德拉
almendɾal	阿尔门德拉尔
almendɾalexo	阿尔门德拉莱霍
almendɾikos	阿尔门德里科斯
almendɾos	阿尔门德罗斯
almeɾja	阿尔梅里亚
almoxja	阿尔莫希亚
almoɣeɾa	阿尔莫格拉
almo.axa	阿尔莫阿哈
almo.aɾin	阿尔莫阿林
almonte	阿尔蒙特
almoɾaði	阿尔莫拉迪
almoɾoks	阿尔莫罗克斯
almuðeβaɾ	阿尔穆德瓦尔
almuɲekaɾ	阿尔穆涅卡尔
almunjente	阿尔穆年特
almuɾaðjel	阿尔穆拉迭尔
almusafes	阿尔穆萨费斯
aloβɾas	阿洛夫拉斯
aloθen	阿洛森
aloɾa	阿洛拉
alos	阿洛斯
alosno	阿洛斯诺
aloβeɾa	阿洛韦拉
aloθai̯na	阿洛赛纳
alp	阿尔普
alpandei̯ɾe	阿尔潘代雷
alpanseke	阿尔潘塞克
alpeðɾoʧes	阿尔佩德罗切斯
alpeɲes	阿尔佩涅斯
alpens	阿尔彭斯
alpeɾa	阿尔佩拉
alpeɾiθ	阿尔佩里斯
alpwente	阿尔蓬特
alkeθaɾ	阿尔克萨尔
alsaswa	阿尔萨苏阿
altaβle	阿尔塔夫莱
altamiɾa	阿尔塔米拉
altaɾexos	阿尔塔雷霍斯
altea	阿尔特阿
altorikon	阿尔托里孔
altotei̯ɾo	阿尔托泰罗
altuɾa	阿尔图拉
alustante	阿卢斯坦特
alβiɾes	阿尔维雷斯
alθola	阿尔索拉
amaʝa	阿马亚
ameɾ	阿梅尔
ames	阿梅斯
ameʝuɣo	阿梅尤戈
ameθaɣa	阿梅萨加
amjeβa	阿米耶瓦
amoei̯ɾo	阿莫埃罗
amoɾeβjeta	阿莫雷维耶塔
amposta	安波斯塔
ampuðja	安普迪亚
ampweɾo	安普埃罗
ampuɾjas	安普里亚斯
amurjo	阿穆里奥
amusko	阿穆斯科
aɲa	阿尼亚
anʧuɾas	安丘拉斯
anθin	安辛
andaluθja	安达卢西亚
andaβjas	安达维亚斯
andiʎa	安迪利亚
andoai̯n	安多艾恩
andora	安多拉
andosiʎa	安多西利亚
andɾai̯ʧ	安德赖奇
anduxaɾ	安杜哈尔
aŋgles	安格莱斯
aŋglesola	安格莱索拉
aŋgwes	安圭斯
aŋgjano	安吉亚诺
aŋgiks	安吉克斯
aniɲon	阿尼尼翁
anleo	安莱奥
aɲon	阿尼翁
aɲoɾa	阿尼奥拉
anso	安索
antas	安塔斯
antekeɾa	安特克拉
antiɣweðað	安蒂圭达
antonaɲa	安托纳尼亚
anθaniɣo	安萨尼戈
anθwola	安索拉
anθuɾ	安苏尔
apatamonasteɾjo	阿帕塔莫纳斯特里奥
apeʎaniθ	阿佩利亚尼斯
akilwe	阿基卢埃
aɾaθena	阿拉塞纳
aɾafo	阿拉福
aɾaɣon	阿拉贡
aɾaɣonθiʎo	阿拉贡西略
aɾanaɾaʧe	阿拉纳拉切
aɾanaθ	阿拉纳斯
aɾandiʎo	阿兰迪略
aɾanxweθ	阿兰胡埃斯
aɾano	阿拉诺
aɾanθaθu	阿兰萨苏
aɾanθweɣe	阿兰苏埃格
aɾapiles	阿拉皮莱斯
aɾas	阿拉斯
aɾaβaka	阿拉瓦卡
aɾaʝa	阿拉亚
aɾβeka	阿尔韦卡
aɾβo	阿尔沃
aɾβos	阿尔沃斯
aɾθenjeɣa	阿尔塞涅加
aɾʧena	阿尔切纳
aɾʧiʎa	阿尔奇利亚
aɾkos	阿尔科斯
aɾkusa	阿尔库萨
aɾðisa	阿尔迪萨
aɾen	阿伦
aɾenas	阿雷纳斯
aɾeo	阿雷奥
aɾes	阿雷斯
aɾeta	阿雷塔
aɾeβaliʎo	阿雷瓦利略
aɾeβalo	阿雷瓦洛
aɾɣanda	阿尔甘达
aɾɣanθa	阿尔甘萨
aɾɣeðas	阿尔格达斯
aɾɣeʎite	阿尔格利特
aɾɣineɣin	阿尔吉内金
aɾɣis	阿尔吉斯
aɾixa	阿里哈
aɾinaɣa	阿里纳加
aɾiɲeθ	阿里涅斯
aɾiɲo	阿里尼奥
aɾiβe	阿里韦
aɾiθa	阿里萨
aɾiθala	阿里萨拉
aɾxona	阿尔霍纳
aɾxoniʎa	阿尔霍尼利亚
aɾlanθon	阿尔兰松
aɾmuna	阿尔穆纳
aɾneðiʎo	阿尔内迪略
aɾneðo	阿尔内多
aɾnes	阿尔内斯
aɾnoʝa	阿尔诺亚
aɾnweɾo	阿尔努埃罗
aɾoʧe	阿罗切
aɾoi̯θu	阿罗伊苏
aɾona	阿罗纳
aɾkiʎos	阿尔基略斯
araβalde	阿拉瓦尔德
araŋkaθepas	阿兰卡塞帕斯
araθola	阿拉索拉
areθife	阿雷西费
areðondo	阿雷东多
arjate	阿里亚特
arjeta	阿列塔
ariɣorjaɣa	阿里戈里亚加
arjondas	阿里翁达斯
aroβa	阿罗瓦
aroniθ	阿罗尼斯
aroʝal	阿罗亚尔
aroʝos	阿罗约斯
aɾta	阿尔塔
aɾtaxona	阿尔塔霍纳
aɾtana	阿尔塔纳
aɾtaθu	阿尔塔苏
aɾtei̯xo	阿尔泰霍
aɾtenaɾa	阿尔特纳拉
aɾtes	阿尔特斯
aɾtjeða	阿尔铁达
aɾtjes	阿尔铁斯
aɾukas	阿鲁卡斯
aɾuɾe	阿鲁雷
aɾθua	阿尔苏阿
asko	阿斯科
asin	阿辛
asomaðiʎa	阿索马迪利亚
ason	阿松
aspaɾjeɣos	阿斯帕列戈斯
aspe	阿斯佩
astiʎeɾo	阿斯蒂列罗
astuðiʎo	阿斯图迪略
astuɾjanos	阿斯图里亚诺斯
astuɾjas	阿斯图里亚斯
atalaʝa	阿塔拉亚
atalaʝasa	阿塔拉亚萨
atakines	阿塔基内斯
ataɾfe	阿塔尔费
atau̯ta	阿陶塔
atea	阿特阿
ateka	阿特卡
atjenθa	阿蒂恩萨
atoʧa	阿托查
au̯ɲon	奥尼翁
au̯sexo	奥塞霍
au̯tol	奥托尔
au̯toɾja	奥托里亚
aβei̯nte	阿文特
aβeʎanes	阿韦利亚内斯
aβila	阿维拉
aβiles	阿维莱斯
aβinʝo	阿温约
aβinʝonet	阿温约内特
aβjon	阿维翁
aʝamonte	阿亚蒙特
aʝeðo	阿耶多
ai̯ʎon	艾利翁
ai̯na	艾纳
aʝoɾa	阿约拉
ai̯tona	艾托纳
aθaɣɾa	阿萨格拉
aθai̯la	阿赛拉
aθaɲon	阿萨尼翁
aθanui	阿萨努伊
aθkoi̯tja	阿斯科伊蒂亚
aθnalkaθaɾ	阿斯纳尔卡萨尔
aθnalkoʎaɾ	阿斯纳尔科利亚尔
aθpei̯tja	阿斯佩蒂亚
aθwaɣa	阿苏阿加
aθwaɾa	阿苏阿拉
aθwelo	阿苏埃洛
baβilafwente	巴维拉丰特
bakaɾes	巴卡雷斯
baðaxoθ	巴达霍斯
baðalona	巴达洛纳
baðaɾan	巴达兰
baðenas	巴德纳斯
baðolatosa	巴多拉托萨
baðules	巴杜莱斯
baena	巴埃纳
baeθa	巴埃萨
baɣa	巴加
baɣena	巴格纳
baɣuɾ	巴古尔
ba.iʎo	巴伊略
bai̯len	拜伦
bai̯ʎo	拜略
baxamaɾ	巴哈马尔
balaɣeɾ	巴拉格尔
balaθote	巴拉索特
balθes	巴尔塞斯
balkonete	巴尔科内特
balei̯ɾa	巴莱拉
baleɾma	巴莱尔马
balimbɾa	巴林布拉
baliɾa	巴利拉
baʎeɾjas	巴列里亚斯
baʎestaɾ	巴列斯塔尔
baʎesteɾos	巴列斯特罗斯
baʎoβaɾ	巴略瓦尔
balsaɾeni	巴尔萨雷尼
balsikas	巴尔西卡斯
baltanas	巴尔塔纳斯
baltaɾ	巴尔塔尔
baɲaɾes	巴尼亚雷斯
bande	班德
baɲeɾas	巴涅拉斯
baɲoβaɾeθ	巴尼奥瓦雷斯
baɲolas	巴尼奥拉斯
baɲon	巴尼翁
banʝoles	班约莱斯
banʝos	班约斯
baɾakaldo	巴拉卡尔多
baɾa.ona	巴拉奥纳
baɾaxas	巴拉哈斯
baɾaʎa	巴拉利亚
baɾambjo	巴兰比奥
baɾasoai̯n	巴拉索艾恩
baɾβaðanes	巴尔瓦达内斯
baɾβaðiʎo	巴尔瓦迪略
baɾβalimpja	巴尔瓦林皮亚
baɾβastɾo	巴尔瓦斯特罗
baɾka	巴尔卡
baɾkarota	巴尔卡罗塔
baɾθena	巴尔塞纳
baɾʧeta	巴尔切塔
baɾθjenθe	巴尔先塞
baɾkones	巴尔科内斯
baɾeʝo	巴雷约
baɾɣas	巴尔加斯
baɾxos	巴尔霍斯
baɾkeɾos	巴尔克罗斯
barakas	巴拉卡斯
baraʧina	巴拉奇纳
barako	巴拉科
baraks	巴拉克斯
barei̯ɾos	巴雷罗斯
barjomaɾtin	巴里奥马丁
baro	巴罗
barwekopaɾðo	巴鲁埃科帕尔多
baɾθana	巴尔萨纳
basau̯ɾi	巴绍里
baskaɾa	巴斯卡拉
baseʎa	巴塞利亚
batea	巴特阿
bateɾno	巴特尔诺
baʝo	巴约
baʝona	巴约纳
baθa	巴萨
beaðe	贝阿德
beaɾiθ	贝阿里斯
beas	贝阿斯
bekarea	贝卡雷阿
beθei̯te	贝塞特
beʧi	贝奇
beðaɾ	贝达尔
beðmaɾ	贝德马尔
bexixaɾ	贝希哈尔
beɣonte	贝贡特
bei̯ɾe	贝雷
bei̯ɾes	贝雷斯
bexaɾ	贝哈尔
bexis	贝希斯
belʧite	贝尔奇特
beljanes	贝利亚内斯
belinʧon	贝林琼
beʎo	贝略
beʎtaʎ	贝尔塔尔
beʎβeɾ	贝尔韦尔
beʎβei̯	贝尔韦
beʎβis	贝尔维斯
belmeθ	贝尔梅斯
belmonte	贝尔蒙特
belmontexo	贝尔蒙特霍
beloɾaðo	贝洛拉多
belβeɾ	贝尔韦尔
bembiβɾe	本比夫雷
benaβare	贝纳瓦雷
benakaθon	贝纳卡松
benafiɣos	贝纳菲戈斯
benaɣalβon	贝纳加尔翁
benaɣwaθil	贝纳瓜西尔
bena.aðuks	贝纳阿杜克斯
bena.aβis	贝纳阿维斯
benaxaɾafa	贝纳哈拉法
benalau̯ɾja	贝纳劳里亚
benamau̯ɾel	贝纳毛雷尔
benamexi	贝纳梅希
benamokara	贝纳莫卡拉
benaokaθ	贝瑙卡斯
benaoxan	贝瑙汉
benaraβa	贝纳拉瓦
benasal	贝纳萨尔
benaske	贝纳斯克
benatae	贝纳塔埃
benaβente	贝纳文特
benaβiðes	贝纳维德斯
benaβites	贝纳维特斯
benexiles	贝内希莱斯
benexama	贝内哈马
benexuθaɾ	贝内胡萨尔
benferi	本费里
benjaɾða	贝尼亚尔达
benjares	贝尼亚雷斯
benikasim	贝尼卡西姆
beniʧembla	贝尼琴布拉
benifaʎet	贝尼法列特
benifaʎim	贝尼法利姆
benifaʝo	贝尼法约
beniɣanim	贝尼加尼姆
beniʎoβa	贝尼略瓦
benimasot	贝尼马索特
beninaɾ	贝尼纳尔
benjopa	贝尼奥帕
benisa	贝尼萨
benisanet	贝尼萨内特
beniseno	贝尼塞诺
benitaʧeʎ	贝尼塔切尔
beniθalon	贝尼萨隆
benuθa	贝努萨
benθu	本苏
beɾaŋga	贝兰加
beɾanteβiʎa	贝兰特维利亚
beɾθeðo	贝尔塞多
beɾθeɾo	贝尔塞罗
beɾðuθeðo	贝尔杜塞多
beɾðun	贝尔敦
beɾɣa	贝尔加
beɾɣasa	贝尔加萨
beɾɣondo	贝尔贡多
beɾɣwenda	贝尔古恩达
beɾxa	贝尔哈
beɾlaŋga	贝尔兰加
beɾmeo	贝尔梅奥
beriθ	贝里斯
berokal	贝罗卡尔
beɾθokana	贝尔索卡纳
besalu	贝萨卢
besaʝa	贝萨亚
beskane	贝斯卡内
betaŋkuɾja	贝坦库里亚
betanθos	贝坦索斯
betelu	贝特卢
beteɾa	贝特拉
beteta	贝特塔
beθes	贝塞斯
bjaɾ	比亚尔
biβei̯	比韦
bjel	别尔
bjelsa	别尔萨
bjenbeniða	比恩贝尼达
bjeskas	别斯卡斯
biɣastɾo	比加斯特罗
biɣeθal	比格萨尔
bimeða	比梅达
bimenes	比梅内斯
binaθeð	比纳塞
binefaɾ	比内法尔
binjes	比涅斯
binisalem	比尼萨莱姆
binwe	比努埃
bjoska	比奥斯卡
bjota	比奥塔
biskarwes	比斯卡鲁埃斯
bjurun	比乌伦
biθβeri	比斯韦里
blaŋka	布兰卡
blaŋkas	布兰卡斯
blaŋkos	布兰科斯
blanes	布拉内斯
blaŋkiʎa	布兰基利亚
blaθkes	布拉斯克斯
blekwa	布莱夸
blesa	布莱萨
boaða	博阿达
boaðiʎa	博阿迪利亚
boal	博阿尔
boβaðiʎa	博瓦迪利亚
boβoɾas	博沃拉斯
bokai̯ɾente	博凯伦特
boθeɣiʎas	博塞吉利亚斯
boθiɣas	博西加斯
boeθiʎo	博埃西略
boɣara	博加拉
boɣare	博加雷
bo.oʝo	博奥约
boi̯moɾto	博伊莫尔托
boxaɾ	博哈尔
bolaɲos	博拉尼奥斯
bolea	博莱阿
boltaɲa	博尔塔尼亚
bonanθa	博南萨
boɲaɾ	博尼亚尔
bonaɾes	博纳雷斯
boniʧes	博尼切斯
boniʎa	博尼利亚
bokei̯xon	博凯洪
boɾðon	博尔东
boɾines	博里内斯
boɾxa	博尔哈
boɾnoβa	博尔诺瓦
boɾnos	博尔诺斯
boɾoβja	博罗维亚
boɾoks	博罗克斯
bores	博雷斯
borjol	博里奥尔
bosost	博索斯特
bot	博特
botorita	博托里塔
boβeða	博韦达
bɾaβatas	布拉瓦塔斯
bɾaɲoseɾa	布拉尼奥塞拉
bɾaoxos	布劳霍斯
bɾea	布雷阿
bɾeða	布雷达
bɾenes	布雷内斯
bɾetun	布雷通
bɾi.weɣa	布里韦加
bɾiɲas	布里尼亚斯
bɾjon	布里翁
bɾjones	布里奥内斯
bɾiβjeska	布里维耶斯卡
bɾonʧales	布龙查莱斯
bɾoto	布罗托
bɾoθas	布罗萨斯
bɾunete	布鲁内特
bɾunola	布鲁诺拉
buθjeɣas	布谢加斯
buðja	布迪亚
bwena	布埃纳
bwenaβista	布埃纳维斯塔
bwendja	布恩迪亚
bweu̯	布埃乌
bufali	布法利
buɣara	布加拉
buxeɾ	布赫尔
bwitɾe	布伊特雷
buxalanθe	布哈兰塞
buxan	布汉
buxaɾaloθ	布哈拉洛斯
buʎas	布利亚斯
buɲeɾo	布涅罗
bunjel	布涅尔
buɲol	布尼奥尔
buɲola	布尼奥拉
buɲwel	布纽埃尔
buɾβaɣena	布尔瓦格纳
buɾes	布雷斯
buɾɣo	布尔戈
buɾɣo.ondo	布尔戈翁多
buɾɣos	布尔戈斯
buɾɣete	布尔格特
buɾɣi	布尔吉
buɾɣiʎos	布尔吉略斯
buɾon	布龙
burjana	布里亚纳
buɾuxon	布鲁洪
busot	布索特
buskistaɾ	布斯基斯塔尔
kaβana	卡瓦纳
kaβaɲakinta	卡瓦尼亚金塔
kaβaɲas	卡瓦尼亚斯
kaβanes	卡瓦内斯
kaβaniʎas	卡瓦尼利亚斯
kaβe	卡韦
kaβeθamesaða	卡韦萨梅萨达
kaβeθaɾaðos	卡韦萨拉多斯
kaβeθo	卡韦索
kaβolafwente	卡沃拉丰特
kaβɾa	卡夫拉
kaβɾales	卡夫拉莱斯
kaβɾanes	卡夫拉内斯
kaβɾei̯ɾos	卡夫雷罗斯
kaβɾiʎanes	卡夫里利亚内斯
kaβɾiʎas	卡夫里利亚斯
kakaβelos	卡卡韦洛斯
kaθeɾes	卡塞雷斯
kaʧiʎa	卡奇利亚
kaʧoriʎa	卡乔里利亚
kaθin	卡辛
kaðaɣwa	卡达瓜
kaðakes	卡达克斯
kaðaβeðo	卡达韦多
kaði	卡迪
kaðjaɾ	卡迪亚尔
kaðɾei̯ta	卡德雷塔
kaðɾete	卡德雷特
kala	卡拉
kalaθei̯te	卡拉塞特
kalaf	卡拉夫
kalafeʎ	卡拉费尔
kala.ora	卡拉奥拉
kalamoʧa	卡拉莫查
kalamonte	卡拉蒙特
kalaɲas	卡拉尼亚斯
kalanda	卡兰达
kalaspara	卡拉斯帕拉
kalatanaθoɾ	卡拉塔纳索尔
kalataʝuð	卡拉塔尤
kalatoɾao	卡拉托劳
kalaβeɾwela	卡拉韦鲁埃拉
kaldas	卡尔达斯
kaldeɾina	卡尔德里纳
kaleɾweɣa	卡莱鲁埃加
kaleta	卡莱塔
kalikasas	卡利卡萨斯
kaliɣ	卡利格
kaʎexas	卡列哈斯
kalonxe	卡隆赫
kalpe	卡尔佩
kaltoxaɾ	卡尔托哈尔
kalβja	卡尔维亚
kalθaðiʎa	卡尔萨迪利亚
kamaleno	卡马莱诺
kamaʎeɾa	卡马列拉
kamaɾao	卡马劳
kamaɾasa	卡马拉萨
kamaɾena	卡马雷纳
kamaɾiʎas	卡马里利亚斯
kamaɾiɲas	卡马里尼亚斯
kamas	卡马斯
kambaðos	坎巴多斯
kambil	坎比尔
kambɾe	坎布雷
kambɾils	坎布里尔斯
kaminomoɾisko	卡米诺莫里斯科
kaminreal	卡明雷阿尔
kampanaɾjo	坎帕纳里奥
kampanet	坎帕内特
kampaniʎas	坎帕尼利亚斯
kampano	坎帕诺
kampaspeɾo	坎帕斯佩罗
kampðeβanol	坎普德瓦诺尔
kampeʎo	坎佩略
kampiʎo	坎皮略
kampiʎos	坎皮略斯
kampisaβalos	坎皮萨瓦洛斯
kampomanes	坎波马内斯
kamporeðondo	坎波雷东多
kamporeʎs	坎波雷尔斯
kamporoβles	坎波罗夫莱斯
kampos	坎波斯
kampotexaɾ	坎波特哈尔
kampɾoðoɾ	坎普罗多尔
kampɾoβin	坎普罗温
kamunas	卡穆纳斯
kaɲaða	卡尼亚达
kaɲaðaxuŋkosa	卡尼亚达洪科萨
kanales	卡纳莱斯
kanals	卡纳尔斯
kaɲamaɾes	卡尼亚马雷斯
kaɲameɾo	卡尼亚梅罗
kaɲaɾ	卡尼亚尔
kaɲaβeɾal	卡尼亚韦拉尔
kaɲaβeɾas	卡尼亚韦拉斯
kaŋkaɾiks	坎卡里克斯
kanθjenes	坎谢内斯
kandas	坎达斯
kandasnos	坎达斯诺斯
kandelaɾja	坎德拉里亚
kandelaɾjo	坎德拉里奥
kandeleða	坎德莱达
kandiliʧeɾa	坎迪利切拉
kandin	坎丁
kaneðo	卡内多
kanena	卡内纳
kaneɾo	卡内罗
kanfɾaŋk	坎弗兰克
kaŋgas	坎加斯
kaniles	卡尼莱斯
kaniʎas	卡尼利亚斯
kaniθal	卡尼萨尔
kaniθaɾes	卡尼萨雷斯
kaniθo	卡尼索
kanxaʝaɾ	坎哈亚尔
kantalapjeðɾa	坎塔拉彼德拉
kantalexo	坎塔莱霍
kantaloxas	坎塔洛哈斯
kantalpino	坎塔尔皮诺
kantaɾeɾos	坎塔雷罗斯
kantaβjexa	坎塔维耶哈
kanteɾas	坎特拉斯
kantiʎana	坎蒂利亚纳
kantoɾal	坎托拉尔
kantoɾja	坎托里亚
kanʝeʎas	坎耶利亚斯
kaparoso	卡帕罗索
kapðeʎa	卡普德利亚
kapðepeɾa	卡普德佩拉
kapeʎaðes	卡佩利亚德斯
kapildui	卡皮尔杜伊
kapiʎa	卡皮利亚
kaɾaβaɲa	卡拉瓦尼亚
kaɾaβanʧel	卡拉万切尔
kaɾakwel	卡拉库埃尔
kaɾalps	卡拉尔普斯
kaɾaβaka	卡拉瓦卡
kaɾβaxo	卡尔瓦霍
kaɾβja	卡尔维亚
kaɾkaβoso	卡尔卡沃索
kaɾkaβwei̯	卡尔卡武埃
kaɾkaxente	卡尔卡亨特
kaɾkaɾ	卡尔卡尔
kaɾkastiʎo	卡尔卡斯蒂略
kaɾθelen	卡尔塞伦
kaɾʧel	卡尔切尔
kaɾʧelexo	卡尔切莱霍
kaɾðexon	卡尔德洪
kaɾðona	卡尔多纳
kaɾenas	卡雷纳斯
kaɾiɲena	卡里涅纳
kaɾiɲo	卡里尼奥
kaɾlet	卡尔莱特
kaɾmena	卡尔梅纳
karaθeðelo	卡拉塞德洛
karal	卡拉尔
karaŋke	卡兰克
karanθa	卡兰萨
karaskalexo	卡拉斯卡莱霍
karaskosa	卡拉斯科萨
karatɾaka	卡拉特拉卡
kareɲa	卡雷尼亚
karil	卡里尔
kariθal	卡里萨尔
kariθo	卡里索
kariθosa	卡里索萨
karoθeɾa	卡罗塞拉
karoo	卡罗
kaɾtama	卡尔塔马
kaɾtaʝa	卡尔塔亚
kaɾteʎe	卡尔特列
kaɾuθeðo	卡鲁塞多
kasalarei̯na	卡萨拉雷纳
kasaɾ	卡萨尔
kasaɾaβonela	卡萨拉沃内拉
kasaɾexos	卡萨雷霍斯
kasaɾes	卡萨雷斯
kasaɾiʧe	卡萨里切
kasasimaro	卡萨西马罗
kasatexaða	卡萨特哈达
kasaβjexa	卡萨维耶哈
kaskante	卡斯坎特
kaseða	卡塞达
kaseɾas	卡塞拉斯
kaseras	卡塞拉斯
kasinos	卡西诺斯
kaso	卡索
kaspe	卡斯佩
kastala	卡斯塔拉
kastaʎa	卡斯塔利亚
kastanesa	卡斯塔内萨
kastaɲo	卡斯塔尼奥
kastaɾas	卡斯塔拉斯
kastexon	卡斯特洪
kastelfloɾite	卡斯特尔弗洛里特
kasteʎanos	卡斯特利亚诺斯
kasteʎdans	卡斯特尔丹斯
kasteʎdefels	卡斯特尔德费尔斯
kasteʎote	卡斯特略特
kasteʎs	卡斯特尔斯
kasteʎtaʎat	卡斯特尔塔利亚特
kasteʎβeʎ	卡斯特尔韦尔
kastelseɾas	卡斯特尔塞拉斯
kastelβispal	卡斯特尔维斯帕尔
kastjelfaβiβ	卡斯铁尔法维夫
kastildelɣaðo	卡斯蒂尔德尔加多
kastiliskaɾ	卡斯蒂利斯卡尔
kastiʎa	卡斯蒂利亚
kastiʎexaɾ	卡斯蒂列哈尔
kastilmimbɾe	卡斯蒂尔明布雷
kastilnweβo	卡斯蒂尔努埃沃
kastɾalβo	卡斯特拉尔沃
kastɾil	卡斯特里尔
kastɾiʎon	卡斯特里利翁
kastɾokaljon	卡斯特罗卡利翁
kastɾokontɾiɣo	卡斯特罗孔特里戈
kastɾoðeθa	卡斯特罗德萨
kastɾoxeɾiθ	卡斯特罗赫里斯
kastɾoɣonθalo	卡斯特罗贡萨洛
kastɾomoʧo	卡斯特罗莫乔
kastɾomonte	卡斯特罗蒙特
kastɾomuðara	卡斯特罗穆达拉
kastɾonweβo	卡斯特罗努埃沃
kastɾonuɲo	卡斯特罗努尼奥
kastɾopoðame	卡斯特罗波达梅
kastɾopol	卡斯特罗波尔
kastweɾa	卡斯图埃拉
kataðau̯	卡塔道
kataroxa	卡塔罗哈
kati	卡蒂
katʎal	卡特利亚尔
katoi̯ɾa	卡托伊拉
katou̯te	卡托特
katɾal	卡特拉尔
kau̯ðe	考德
kau̯ðete	考德特
kau̯ðjel	考迭尔
kau̯ɾel	考雷尔
kaβeθon	卡韦松
kaʝon	卡永
kaθaleɣas	卡萨莱加斯
θea	塞阿
θeaðea	塞阿德阿
θeanuɾi	塞阿努里
θeβaniko	塞瓦尼科
θeβoʎa	塞沃利亚
θeβoʎaɾ	塞沃利亚尔
θeβoʎeɾa	塞沃列拉
θeβɾeɾos	塞夫雷罗斯
θeβɾon	塞夫龙
θeklaβin	塞克拉温
θekos	塞科斯
θeðei̯ɾa	塞代拉
θeðiʎo	塞迪略
θeðɾiʎas	塞德里利亚斯
θee	塞埃
θe.exin	塞埃欣
θei̯nos	塞诺斯
θexo	塞霍
θelaðas	塞拉达斯
θelanoβa	塞拉诺瓦
θeʎa	塞利亚
θeltiβeɾja	塞尔蒂韦里亚
θenja	塞尼亚
θeniθeɾo	塞尼塞罗
θeniθjentos	塞尼先托斯
θeniθate	塞尼萨特
θenʎe	森列
θenteʎas	森特利亚斯
θenteniʎo	森特尼略
θentɾo	森特罗
θepeða	塞佩达
θeɾθeða	塞尔塞达
θeɾθeðiʎa	塞尔塞迪利亚
θeɾða	塞尔达
θeɾðeðo	塞尔德多
θeɾðiðo	塞尔迪多
θeɾeθo	塞雷索
θeɾneɣula	塞尔内古拉
θeɾoʎeɾa	塞罗列拉
θeralβo	塞拉尔沃
θeɾβeɾa	塞尔韦拉
θespeðosa	塞斯佩多萨
θestona	塞斯托纳
θesuɾas	塞苏拉斯
θetina	塞蒂纳
θeu̯ti	塞乌蒂
ʧamaɾtin	查马丁
ʧambeɾi	钱贝里
ʧantaða	钱塔达
ʧapineɾja	查皮内里亚
ʧaɾʧes	查尔切斯
ʧau̯ʧina	乔奇纳
ʧaβaleɾ	查瓦莱尔
ʧeka	切卡
ʧeles	切莱斯
ʧeʎa	切利亚
ʧelβa	切尔瓦
ʧeɾa	切拉
ʧeɾkos	切尔科斯
ʧeɾt	切尔特
ʧeɾta	切尔塔
ʧeste	切斯特
ʧiklana	奇克拉纳
ʧilʧes	奇尔切斯
ʧiliθarjas	奇利萨里亚斯
ʧiʎon	奇利翁
ʧiloeʧes	奇洛埃切斯
ʧimeraes	奇梅拉埃斯
ʧinʧon	钦琼
ʧio	奇奥
ʧipjona	奇皮奥纳
ʧipɾana	奇普拉纳
ʧiɾiβel	奇里韦尔
ʧiβa	奇瓦
ʧoðos	乔多斯
ʧoβaɾ	乔瓦尔
ʧweka	丘埃卡
ʧuliʎa	丘利利亚
ʧuʎo	丘略
θjaðonʧa	锡亚东查
θiβea	锡韦阿
θiðað	锡达
θiðones	锡多内斯
θjempoθwelos	先波苏埃洛斯
θjeθa	谢萨
θifwentes	锡丰特斯
θiɣales	锡加莱斯
θiɣwenθa	锡古恩萨
θiʎamaʝoɾ	锡利亚马约尔
θiʎas	锡利亚斯
θiʎeɾos	锡列罗斯
θimbaʎa	辛巴利亚
θiŋktores	辛克托雷斯
θintɾweniɣo	辛特鲁埃尼戈
θjonal	锡奥纳尔
θjoɾðja	锡奥尔迪亚
θipeɾeθ	锡佩雷斯
θiɾat	锡拉特
θiɾau̯ki	锡劳基
θiɾja	锡里亚
θiɾiθa	锡里萨
θiɾwelos	锡鲁埃洛斯
θiɾuxeða	锡鲁赫达
θisla	锡斯拉
θisneɾos	锡斯内罗斯
θistjeɾna	锡斯铁尔纳
θjuðaðela	休达德拉
θjutaðiʎa	休塔迪利亚
klaɾjana	克拉里亚纳
koaɲa	科阿尼亚
koβatiʎas	科瓦蒂利亚斯
koβðaɾ	科夫达尔
koβeta	科韦塔
koβɾeɾos	科夫雷罗斯
koka	科卡
koθentai̯na	科森泰纳
koðeseða	科德塞达
koðos	科多斯
kofete	科费特
koɣoʎos	科戈略斯
koɣoʎuðo	科戈柳多
koin	科因
koi̯ɾos	科伊罗斯
koles	科莱斯
kolɣaðiθos	科尔加迪索斯
kolindɾes	科林德雷斯
koʎaðos	科利亚多斯
koʎanθo	科良索
koʎiɣa	科利加
kolmenaɾ	科尔梅纳尔
kolmenaɾexo	科尔梅纳雷霍
kolomeɾa	科洛梅拉
koluŋga	科伦加
komaɾes	科马雷斯
kombaros	孔巴罗斯
komiʎas	科米利亚斯
kompeta	孔佩塔
kompostela	孔波斯特拉
koŋkuð	孔库
konil	科尼尔
konxo	孔霍
koŋkes	孔克斯
koŋkista	孔基斯塔
konsweɣɾa	孔苏埃格拉
kontes	孔特斯
kopons	科蓬斯
koɾβaton	科尔瓦通
koɾβeʎe	科尔韦列
koɾβeɾa	科尔韦拉
koɾʧwela	科尔丘埃拉
koɾkonte	科尔孔特
koɾkuβjon	科尔库维翁
koɾðoβa	科尔多瓦
koɾðoβa	科尔多瓦
koɾðoβin	科尔多温
koɾeʎa	科雷利亚
koɾeses	科雷塞斯
koɾɣo	科尔戈
koɾja	科里亚
koɾipe	科里佩
koɾistaŋko	科里斯坦科
koɾme	科尔梅
koɾnaɣo	科尔纳戈
koɾpa	科尔帕
koralexo	科拉莱霍
korales	科拉莱斯
koreðoi̯ɾas	科雷多伊拉斯
koruβeðo	科鲁韦多
koɾteɣaða	科尔特加达
koɾteɣana	科尔特加纳
koɾtelaθoɾ	科尔特拉索尔
koɾtes	科尔特斯
koɾuʎon	科鲁利翁
koɾβeɾa	科尔韦拉
kosa	科萨
koskuɾita	科斯库里塔
koslaða	科斯拉达
kospei̯to	科斯佩托
kostiʧ	科斯蒂奇
kosβenda	科斯文达
kotjeʎa	科铁利亚
kotiʎas	科蒂利亚斯
kotiʎo	科蒂略
kotoβað	科托瓦
kou̯sa	科萨
koβaðoŋga	科瓦东加
koβaruβjas	科瓦鲁维亚斯
koβas	科瓦斯
koβelo	科韦洛
koks	科克斯
koθaɾ	科萨尔
kɾeθjente	克雷先特
kɾemenes	克雷梅内斯
kɾespos	克雷斯波斯
kɾetas	克雷塔斯
kɾeβiʎente	克雷维连特
kɾipan	克里潘
kɾistoβal	克里斯托瓦尔
kɾuθe	克鲁塞
kwaðɾos	夸德罗斯
kwaleðɾo	夸莱德罗
kwatɾetonda	夸特雷通达
kuβeʎs	库韦尔斯
kuβla	库夫拉
kukutas	库库塔斯
kuðiʎeɾo	库迪列罗
kweʎaɾ	库埃利亚尔
kweŋka	昆卡
kuʎa	库利亚
kuʎeɾa	库列拉
kuʎeɾeðo	库列雷多
kuntis	昆蒂斯
kuɾweɲa	库鲁埃尼亚
dai̯mjel	代米耶尔
daljas	达利亚斯
danʧaɾinea	丹查里内阿
daɾnjus	达尔纽斯
daɾoka	达罗卡
darikal	达里卡尔
daro	达罗
deɣaɲa	德加尼亚
dei̯fontes	代丰特斯
delei̯tosa	德莱托萨
deliθjas	德利西亚斯
denja	德尼亚
destɾjana	德斯特里亚纳
deu̯sto	德乌斯托
deβa	德瓦
deʝa	德亚
deθa	德萨
dikastiʎo	迪卡斯蒂略
djeθma	迭斯马
dilaɾ	迪拉尔
dima	迪马
djustes	迪乌斯特斯
doβɾo	多夫罗
doðɾo	多德罗
dolaɾ	多拉尔
doloɾes	多洛雷斯
domeno	多梅诺
domiŋgo	多明戈
donaðo	多纳多
dosβarjos	多斯瓦里奥斯
doθon	多松
dɾjeβes	德列韦斯
dweɲas	杜埃尼亚斯
dumbɾja	敦布里亚
duɾaŋgo	杜兰戈
duɾaton	杜拉通
duɾkal	杜尔卡尔
ea	埃阿
eʧalaɾ	埃查拉尔
eʧaleku	埃查莱库
eʧano	埃查诺
eʧari	埃查里
eθixa	埃西哈
eɣes	埃格斯
ei̯βaɾ	埃瓦尔
exulβe	埃胡尔韦
elanʧoβe	埃兰乔韦
elʧe	埃尔切
elda	埃尔达
elɣoi̯βaɾ	埃尔戈伊瓦尔
eliθondo	埃利松多
elxas	埃尔哈斯
elorjo	埃洛里奥
embið	恩比
embun	恩本
empanaðas	恩帕纳达斯
enθinas	恩西纳斯
enθinasola	恩西纳索拉
enθineðo	恩西内多
enθiniʎas	恩西尼利亚斯
enθiso	恩西索
endɾinal	恩德里纳尔
enfesta	恩费斯塔
eŋgeɾa	恩格拉
eŋgiðanos	恩吉达诺斯
eniks	埃尼克斯
entɾena	恩特雷纳
entɾimo	恩特里莫
enbei̯xa	恩贝哈
epila	埃皮拉
eɾiθe	埃里塞
eɾiʎas	埃里利亚斯
eɾiste	埃里斯特
eɾla	埃尔拉
eɾmwa	埃尔穆阿
eraθu	埃拉苏
ero	埃罗
eɾustes	埃鲁斯特斯
eskai̯ɾon	埃斯凯龙
eskalaða	埃斯卡拉达
eskalante	埃斯卡兰特
eskalo	埃斯卡洛
eskalona	埃斯卡洛纳
eskaloniʎa	埃斯卡洛尼利亚
eskamiʎa	埃斯卡米利亚
eskanwela	埃斯卡努埃拉
eskaroθ	埃斯卡罗斯
eskatɾon	埃斯卡特龙
esklaβituð	埃斯克拉维图
eskombɾeas	埃斯孔布雷阿斯
eskoɾka	埃斯科尔卡
eskoɾjaθa	埃斯科里亚萨
eskoɾi.wela	埃斯科里韦拉
eskɾiʧe	埃斯克里切
eskuʧa	埃斯库查
eskuʎaɾ	埃斯库利亚尔
eskuɾjal	埃斯库里亚尔
eskusa	埃斯库萨
eskuθaɾ	埃斯库萨尔
esfiljana	埃斯菲利亚纳
esɣos	埃斯戈斯
espaðan	埃斯帕丹
espaðaɲa	埃斯帕达尼亚
espaðaɲeðo	埃斯帕达涅多
espaðiʎa	埃斯帕迪利亚
esparaɣalexo	埃斯帕拉加莱霍
esparaɣeɾa	埃斯帕拉格拉
espasante	埃斯帕桑特
espexa	埃斯佩哈
espexo	埃斯佩霍
espelui	埃斯佩卢伊
espeɾa	埃斯佩拉
espes	埃斯佩斯
espjel	埃斯彼尔
espiɣwete	埃斯皮圭特
espin	埃斯平
espina	埃斯皮纳
espinama	埃斯皮纳马
espiniʎa	埃斯皮尼利亚
espiɾðo	埃斯皮尔多
espleɣaɾes	埃斯普莱加雷斯
espluɣas	埃斯普卢加斯
esplus	埃斯普卢斯
espoʎa	埃斯波利亚
espot	埃斯波特
eskiβjas	埃斯基维亚斯
estaβliments	埃斯塔夫利门茨
estaðiʎa	埃斯塔迪利亚
estaʎo	埃斯塔略
estanʝol	埃斯坦约尔
esteβan	埃斯特万
esteʎa	埃斯特利亚
estena	埃斯特纳
estepa	埃斯特帕
estepaɾ	埃斯特帕尔
estepona	埃斯特波纳
estiβeʎa	埃斯蒂韦利亚
estopiɲan	埃斯托皮尼扬
estɾemeɾa	埃斯特雷梅拉
etɾeɾos	埃特雷罗斯
eu̯late	欧拉特
estɾemaðuɾa	埃斯特雷马杜拉
eθkaɾai̯	埃斯卡赖
eθkura	埃斯库拉
faβaɾa	法瓦拉
faβeɾo	法韦罗
faθinas	法西纳斯
falθes	法尔塞斯
falkoneɾa	法尔科内拉
falset	法尔塞特
famoɾka	法莫尔卡
faɲanas	法尼亚纳斯
fanlo	凡洛
faɾaxan	法拉汉
faɾasðwes	法拉斯杜埃斯
faɾena	法雷纳
faɾiθa	法里萨
fataɾeʎa	法塔雷利亚
fau̯ɾa	福拉
faβaɾeta	法瓦雷塔
faʝon	法永
feβɾo	费夫罗
felaniʧ	费拉尼奇
feleʧosa	费莱乔萨
feliks	费利克斯
fene	费内
feɾja	费里亚
feɾmoseʎe	费尔莫塞列
feɾnaŋkaβaʎeɾo	费尔南卡瓦列罗
ferei̯ɾa	费雷拉
fereɾjas	费雷里亚斯
fereɾwela	费雷鲁埃拉
fiɣols	菲戈尔斯
fiɣeɾas	菲格拉斯
fiɣeɾoles	菲格罗莱斯
fiɣeɾosa	菲格罗萨
finana	菲纳纳
finestɾat	菲内斯特拉特
finistere	菲尼斯特雷
fiskal	菲斯卡尔
fiteɾo	菲特罗
flasa	弗拉萨
fliks	弗利克斯
fondon	丰东
fonelas	福内拉斯
fonfɾja	丰弗里亚
fonoʎosa	福诺略萨
fonsaɣɾaða	丰萨格拉达
fontanaɾ	丰塔纳尔
fontanaɾexo	丰塔纳雷霍
fontanosas	丰塔诺萨斯
fontao	丰陶
fonteʎas	丰特利亚斯
fontjoso	丰蒂奥索
fontiβeɾos	丰蒂韦罗斯
fontʎoŋga	丰特利翁加
fonθ	丰斯
foɾkaɾei̯	福尔卡雷
foɾonda	福龙达
foɾwa	福鲁阿
foθ	福斯
fɾaðes	弗拉德斯
fɾaɣa	弗拉加
fɾai̯les	弗赖莱斯
fɾaŋkos	弗兰科斯
fɾeʧiʎa	弗雷奇利亚
fɾeðes	弗雷德斯
fɾexinals	弗雷希纳尔斯
fɾei̯la	弗雷拉
fɾesneðiʎa	弗雷斯内迪利亚
fɾesneðo	弗雷斯内多
fɾjas	弗里亚斯
fɾixiljana	弗里希利亚纳
fɾjol	弗里奥尔
fɾomista	弗罗米斯塔
fɾumales	弗鲁马莱斯
fweŋkaljente	丰卡连特
fweŋkaral	丰卡拉尔
fwenθemiʎan	丰塞米良
fwendexalon	丰德哈隆
fwendetoðos	丰德托多斯
fwenferaða	丰费拉达
fwenxiɾola	丰希罗拉
fwenlaβɾaða	丰拉夫拉达
fwenʎana	丰利亚纳
fwenmaʝoɾ	丰马约尔
fwensaliða	丰萨利达
fwensanta	丰桑塔
fwentealβiʎa	丰特阿尔维利亚
fwenteβoa	丰特沃阿
fwenteθen	丰特森
fwenteɣinaldo	丰特吉纳尔多
fwente.eɾiðos	丰特埃里多斯
fwentelapeɲa	丰特拉佩尼亚
fwentelθespeð	丰特尔塞斯佩
fwentelmonxe	丰特尔蒙赫
fwentelsaθ	丰特尔萨斯
fwentemilanos	丰特米拉诺斯
fwentenoβiʎa	丰特诺维利亚
fwentepelaʝo	丰特佩拉约
fwentepiniʎa	丰特皮尼利亚
fwenteraβja	丰特拉维亚
fwentereβoʎo	丰特雷沃略
fwenteroβles	丰特罗夫莱斯
fwentes	丰特斯
fwentesauko	丰特萨乌科
fwenteskusa	丰特斯库萨
fwentesekas	丰特塞卡斯
fwentespalda	丰特斯帕尔达
fwentespina	丰特斯皮纳
fwentiðweɲa	丰蒂杜埃尼亚
funes	富内斯
fuɾnas	富尔纳斯
fustiɲana	富斯蒂尼亚纳
gaβaldon	加瓦尔东
gaβaret	加瓦雷特
gaβasa	加瓦萨
gaðoɾ	加多尔
gaxanexos	加哈内霍斯
gaxates	加哈特斯
galapaɣaɾ	加拉帕加尔
galapaɣos	加拉帕戈斯
galaɾ	加拉尔
galaɾoθa	加拉罗萨
galβara	加尔瓦拉
galdakano	加尔达卡诺
galdames	加尔达梅斯
galende	加伦德
galeɾa	加莱拉
galiθja	加利西亚
galinduste	加林杜斯特
galisteo	加利斯特奥
gaʎeɣos	加列戈斯
gaʎinal	加利纳尔
gaʎuɾ	加柳尔
galβeθ	加尔韦斯
gamonal	加莫纳尔
ganame	加纳梅
gandesa	甘德萨
gandja	甘迪亚
ganwelas	加努埃拉斯
gaɾaβaʎa	加拉瓦利亚
gaɾaʝoa	加拉约阿
gaɾθiʎan	加尔西良
gaɾɣaliɣas	加尔加利加斯
gaɾɣaʎo	加尔加略
gaɾɣweɾa	加尔圭拉
gaɾinoai̯n	加里诺艾恩
gaɾoʝeθ	加罗耶斯
garaf	加拉夫
garalda	加拉尔达
garai̯	加赖
gariɣas	加里加斯
garoβiʎas	加罗维利亚斯
garuʧa	加鲁查
gaskweɲa	加斯库埃尼亚
gata	加塔
gatoβa	加托瓦
gau̯θin	高辛
gau̯na	高纳
gaβa	加瓦
gaβanes	加瓦内斯
xeliða	赫利达
xelsa	赫尔萨
xelβes	赫尔韦斯
xenalɣwaθil	赫纳尔瓜西尔
xenaβe	赫纳韦
xeneβiʎa	赫内维利亚
xeɾena	赫雷纳
xeɾmaðe	赫尔马德
xeɾona	赫罗纳
xeri	赫里
xeseɾa	赫塞拉
xeβe	赫韦
xiβaroʝo	希瓦罗约
xixon	希洪
xilena	希莱纳
ximeneʎs	希梅内尔斯
xiɾoneʎa	希罗内利亚
goðaʎ	戈达尔
goðeʎeta	戈德列塔
goi̯ɾiθ	戈伊里斯
goi̯θweta	戈伊苏埃塔
golaða	戈拉达
golpexas	戈尔佩哈斯
gomaɾa	戈马拉
gomeθeʎo	戈梅塞略
gomesende	戈梅森德
gondomaɾ	贡多马尔
goɾ	戈尔
goɾafe	戈拉费
goɾmaθ	戈尔马斯
gotarenduɾa	戈塔伦杜拉
goθon	戈松
gɾaðefes	格拉德费斯
gɾaðo	格拉多
gɾaxeɾa	格拉赫拉
gɾanaða	格拉纳达
gɾanaðeʎa	格拉纳德利亚
gɾanaðiʎa	格拉纳迪利亚
gɾanatula	格拉纳图拉
gɾandes	格兰德斯
gɾaɲen	格拉年
gɾanoʎeɾs	格拉诺列尔斯
gɾau̯s	格劳斯
gɾaβalos	格拉瓦洛斯
gɾaθalema	格拉萨莱马
gɾjeɣos	格列戈斯
gɾiɲon	格里尼翁
gɾisen	格里森
gɾoβe	格罗韦
gwaða.oɾtuna	瓜达奥尔图纳
gwaðaxoθ	瓜达霍斯
gwaðalaxaɾa	瓜达拉哈拉
gwaðalaβjaɾ	瓜达拉维亚尔
gwaðalkanal	瓜达尔卡纳尔
gwaðalkaθaɾ	瓜达尔卡萨尔
gwaðalupe	瓜达卢佩
gwaðamuɾ	瓜达穆尔
gwaðarama	瓜达拉马
gwaðaraŋke	瓜达兰克
gwaðaswaɾ	瓜达苏阿尔
gwaðiks	瓜迪克斯
gwalʧos	瓜尔乔斯
gwalta	瓜尔塔
gwaɾðjola	瓜尔迪奥拉
gwaɾðo	瓜尔多
gwaɾeɲa	瓜雷尼亚
gwaɾo	瓜罗
gwaroman	瓜罗曼
guðaɾ	古达尔
geʧo	格乔
gweɲes	圭涅斯
gwesa	圭萨
getaɾja	格塔里亚
gjana	吉亚纳
gixo	吉霍
gixwelo	吉胡埃洛
giʎaɾei̯	吉利亚雷
giʎena	吉列纳
giʎeɾjas	吉列里亚斯
gimaɾai̯	吉马赖
gimeɾa	吉梅拉
gisona	吉索纳
gitiɾiθ	吉蒂里斯
gulina	古利纳
guntin	贡廷
guɾjeθo	古列索
guɾp	古尔普
.aθinas	阿西纳斯
.aɾo	阿罗
.eʧo	埃乔
.eleʧal	埃莱查尔
.eleʧosa	埃莱乔萨
.eʎin	埃林
.enaɾexos	埃纳雷霍斯
.enʧe	恩切
.eɾβes	埃尔韦斯
.eɾenθja	埃伦西亚
.eɾnani	埃尔纳尼
.eɾnansanʧo	埃尔南桑乔
.erameʎuɾi	埃拉梅柳里
.ereɾa	埃雷拉
.ereɾja	埃雷里亚
.ereɾjas	埃雷里亚斯
.ereɾos	埃雷罗斯
.ereɾwela	埃雷鲁埃拉
.eɾβas	埃尔瓦斯
.iɣa	伊加
.iɣeɾa	伊格拉
.iɣeɾwela	伊格鲁埃拉
.iɣeɾwelas	伊格鲁埃拉斯
.ixaɾ	伊哈尔
.inoðexo	伊诺德霍
.inoxal	伊诺哈尔
.inoxales	伊诺哈莱斯
.inoxaɾes	伊诺哈雷斯
.inoxos	伊诺霍斯
.inoxosa	伊诺霍萨
.inoxosas	伊诺霍萨斯
.olɣeɾa	奥尔格拉
.ombɾaðos	翁布拉多斯
.onruβja	翁鲁维亚
.ontalβiʎa	翁塔尔维利亚
.ontanaɾes	翁塔纳雷斯
.ontanaʝa	翁塔纳亚
.onteθiʎos	翁特西略斯
.ontoβa	翁托瓦
.oɾʧe	奥尔切
.oɾnos	奥尔诺斯
.ospitalet	奥斯皮塔莱特
.oʝos	奥约斯
.oʝwelos	奥尤埃洛斯
.waɾte	瓦尔特
.welaɣo	韦拉戈
.welamo	韦拉莫
.welma	韦尔马
.welβa	韦尔瓦
.welβes	韦尔韦斯
.wenexa	韦内哈
.weɾmeθes	韦尔梅塞斯
.werjos	韦里奥斯
.weɾta.eɾnando	韦尔塔埃尔南多
.weɾteles	韦尔特莱斯
.weɾto	韦尔托
.wesa	韦萨
.weska	韦斯卡
.weskaɾ	韦斯卡尔
.wete	韦特
.umanes	乌马内斯
.umiʎaðeɾo	乌米利亚德罗
.usiʎos	乌西略斯
iβa.eɾnando	伊瓦埃尔南多
iβðes	伊夫德斯
iβi	伊维
iβora	伊沃拉
iβɾos	伊夫罗斯
iðoθin	伊多辛
iɣlesjas	伊格莱西亚斯
iɣwalaða	伊瓜拉达
iɣwalexa	伊瓜莱哈
iɣweɲa	伊圭尼亚
ilʧe	伊尔切
ileɾða	伊莱尔达
ilipa	伊利帕
iʎana	伊利亚纳
iʎano	伊利亚诺
iʎas	伊利亚斯
iʎeskas	伊列斯卡斯
iʎoɾa	伊略拉
iʎweka	伊柳埃卡
imon	伊蒙
inθiniʎas	因西尼利亚斯
inθjo	因西奥
infantes	因凡特斯
infjesto	因菲耶斯托
injesta	伊涅斯塔
instinθjon	因斯廷西翁
iɾixo	伊里霍
iɾixoa	伊里霍阿
iɾweste	伊鲁埃斯特
iɾun	伊伦
iɾuɾa	伊鲁拉
iɾuɾita	伊鲁里塔
iɾuɾoθki	伊鲁罗斯基
isaβa	伊萨瓦
iskaɾ	伊斯卡尔
isil	伊西尔
isona	伊索纳
iso	伊索
istan	伊斯坦
iswere	伊苏埃雷
itɾaβo	伊特拉沃
itweɾo	伊图埃罗
iθalθu	伊萨尔苏
iθara	伊萨拉
iθnaxaɾ	伊斯纳哈尔
iθnaʎoθ	伊斯纳略斯
iθnatoɾaf	伊斯纳托拉夫
xaβaɣa	哈瓦加
xaβaleɾa	哈瓦莱拉
xaβaloʝas	哈瓦洛亚斯
xaβalkinto	哈瓦尔金托
xaβarjeɣa	哈瓦列加
xaβuɣo	哈武戈
xaka	哈卡
xaðɾake	哈德拉克
xaen	哈恩
xalanθe	哈兰塞
xalon	哈隆
xaɾaβa	哈拉瓦
xaɾako	哈拉科
xaɾafwel	哈拉富埃尔
xaɾai̯θexo	哈赖塞霍
xaɾandiʎa	哈兰迪利亚
xaɾai̯	哈赖
xaɾke	哈尔克
xataɾ	哈塔尔
xatjel	哈铁尔
xatiβa	哈蒂瓦
xau̯lin	豪林
xau̯rjeta	豪列塔
xaβea	哈韦阿
xaʝena	哈耶纳
xemenuɲo	赫梅努尼奥
xeɾesa	赫雷萨
xeɾika	赫里卡
xeɾte	赫尔特
ximena	希梅纳
xiɾweke	希鲁埃克
xoðaɾ	霍达尔
xoɾai̯ɾataɾ	霍赖拉塔尔
xoɾkas	霍尔卡斯
xoɾkeɾa	霍尔克拉
xoβe	霍韦
xuβeɾa	胡韦拉
xuβɾike	胡夫里克
xuðes	胡德斯
xuðjo	胡迪奥
xumiʎa	胡米利亚
xuŋkaxo	洪卡霍
xuŋkosa	洪科萨
xuneða	胡内达
laβakoʎa	拉瓦科利亚
laβaxos	拉瓦霍斯
laβoɾθiʎas	拉沃尔西利亚斯
lakala.ora	拉卡拉奥拉
laʧaɾ	拉查尔
lakumbɾe	拉昆布雷
laxe	拉赫
laɣwares	拉瓜雷斯
laɣwaɾta	拉瓜尔塔
laɣunaseka	拉古纳塞卡
laɣuniʎa	拉古尼利亚
lalin	拉林
lama	拉马
lanaxa	拉纳哈
laŋkaɾa	兰卡拉
lanθjeɣo	兰谢戈
landete	兰德特
lanestosa	拉内斯托萨
laŋgɾeo	兰格雷奥
laŋgiʎa	兰吉利亚
lanxaɾon	兰哈龙
lantaðiʎa	兰塔迪利亚
lantei̯ɾa	兰泰拉
lanθ	兰斯
lanθa	兰萨
lapeθa	拉佩萨
laɾðeɾo	拉尔德罗
laɾeðo	拉雷多
laɾoko	拉罗科
laɾoles	拉罗莱斯
larai̯nθaɾ	拉赖恩萨尔
laraona	拉劳纳
larjon	拉里翁
lasaɾte	拉萨尔特
latina	拉蒂纳
latɾe	拉特雷
laβaðoɾes	拉瓦多雷斯
laβapjes	拉瓦彼斯
laʝana	拉亚纳
lai̯na	莱纳
laʝos	拉约斯
laθa	拉萨
leaʧe	莱阿切
leβɾixa	莱夫里哈
leθeɾa	莱塞拉
leθiɲena	莱西涅纳
lekumberi	莱昆贝里
leðaɲa	莱达尼亚
leðaŋka	莱丹卡
leðesma	莱德斯马
leɣanes	莱加内斯
leɣanjel	莱加涅尔
lei̯ɾo	莱罗
lei̯taɾjeɣos	莱塔列戈斯
lei̯θa	莱萨
lemona	莱莫纳
lenθes	伦塞斯
lepe	莱佩
lekei̯tjo	莱凯蒂奥
leɾɣa	莱尔加
leɾiða	莱里达
leɾin	莱林
leɾma	莱尔马
les	莱斯
lesaka	莱萨卡
letuɾ	莱图尔
letuks	莱图克斯
leθa	莱萨
leθama	莱萨马
leθuθa	莱苏萨
liβɾiʎa	利夫里利亚
liβɾos	利夫罗斯
liðon	利东
ljeðena	列德纳
ljetoɾ	列托尔
lixaɾ	利哈尔
liʎol	利略尔
limpjas	林皮亚斯
linaɾes	利纳雷斯
liɲola	利尼奥拉
liɾja	利里亚
liθaraɣa	利萨拉加
ʎaðo	利亚多
ʎafɾaŋk	利亚弗兰克
ʎaɣosteɾa	利亚戈斯特拉
ʎanes	利亚内斯
ʎansa	良萨
ʎau̯ɾi	廖里
ʎeɾa	列拉
ʎeɾena	列雷纳
ʎeɾs	列尔斯
ʎes	列斯
ʎiβja	利维亚
ʎoβɾeɣales	略夫雷加莱斯
ʎoðjo	略迪奥
ʎombai̯	利翁拜
ʎoseta	略塞塔
ʎoβeɾa	略韦拉
ʎuβi	柳维
ʎuʧmaʝoɾ	柳奇马约尔
loare	洛阿雷
loβatexo	洛瓦特霍
loβeɾa	洛韦拉
loβon	洛翁
loðosa	洛多萨
loeʧes	洛埃切斯
loɣɾoɲo	洛格罗尼奥
loɣɾosan	洛格罗桑
loxa	洛哈
lombɾana	隆布拉纳
loŋgaɾes	隆加雷斯
lopeɾa	洛佩拉
loɾka	洛尔卡
loɾʧa	洛尔查
loɾenθana	洛伦萨纳
loɾes	洛雷斯
loɾki	洛尔基
losaθino	洛萨西诺
lou̯same	洛萨梅
loβjos	洛维奥斯
loθoʝa	洛索亚
loθoʝwela	洛索尤埃拉
lwaŋko	卢安科
lwaɾka	卢阿尔卡
luβjan	卢维安
luβɾin	卢夫林
lukaɾ	卢卡尔
luθena	卢塞纳
luθeni	卢塞尼
luθiʎo	卢西略
luðjente	卢迪恩特
lwelmo	卢埃尔莫
lwesja	卢埃西亚
lweθas	卢埃萨斯
luɣan	卢甘
luɣo	卢戈
luɣones	卢戈内斯
luɣɾos	卢格罗斯
luxaɾ	卢哈尔
lumbjeɾ	伦别尔
lumbɾales	伦布拉莱斯
lumbɾeɾas	伦布雷拉斯
lumpjake	伦皮亚克
luna	卢纳
luke	卢克
luʝeɣo	卢耶戈
luθaɣa	卢萨加
luθon	卢松
makael	马卡埃尔
maθeða	马塞达
maʧeɾo	马切罗
makoteɾa	马科特拉
maðeɾwelo	马德鲁埃洛
maðɾiðexos	马德里德霍斯
maðɾiɣalexo	马德里加莱霍
maðɾiɣeɾa	马德里格拉
maðɾiɣeɾas	马德里格拉斯
maðɾona	马德罗纳
maðɾoneɾa	马德罗内拉
maðɾoɲo	马德罗尼奥
maeʎa	马埃利亚
maeʎo	马埃略
maestɾe	马埃斯特雷
maestu	马埃斯图
maɣaθela	马加塞拉
maɣaʎon	马加利翁
maɣaɲa	马加尼亚
maɣaθ	马加斯
maxina	马希纳
maɣiʎa	马吉利亚
ma.iðe	马伊德
ma.on	马翁
ma.oɾa	马奥拉
mai̯naɾ	迈纳尔
maxaðas	马哈达斯
maxaelraʝo	马哈埃尔拉约
mala	马拉
malaɣon	马拉贡
malaɣiʎa	马拉吉利亚
malaŋkiʎa	马兰基利亚
malkoθinaðo	马尔科西纳多
malɣɾat	马尔格拉特
maʎen	马连
malon	马隆
malpika	马尔皮卡
malwenda	马伦达
mampoðɾe	曼波德雷
manakoɾ	马纳科尔
manʧita	曼奇塔
mandaʝona	曼达约纳
maɲeɾu	马涅鲁
manilβa	马尼尔瓦
manises	马尼塞斯
manʎeu̯	曼列乌
manresa	曼雷萨
manresana	曼雷萨纳
mansiʎa	曼西利亚
mantaɲes	曼塔涅斯
mantjel	曼铁尔
manθanaɾes	曼萨纳雷斯
manθaneða	曼萨内达
manθaneðo	曼萨内多
manθaneke	曼萨内克
manθaneɾa	曼萨内拉
makeða	马克达
maɾaθena	马拉塞纳
maɾanʧon	马兰琼
maɾaθolexa	马拉索莱哈
maɾβeʎa	马尔韦利亚
maɾθiʎa	马尔西利亚
maɾɣaneʎ	马尔加内尔
maɾjana	马里亚纳
maɾin	马林
maɾinaleða	马里纳莱达
maɾines	马里内斯
maɾmolexo	马尔莫莱霍
maron	马龙
maruβe	马鲁韦
marupe	马鲁佩
maɾtoɾeʎ	马尔托雷尔
maɾtos	马尔托斯
maɾuɣan	马鲁甘
masa	马萨
masalaβes	马萨拉韦斯
masamaɣɾeʎ	马萨马格雷尔
masanasa	马萨纳萨
maskaɾake	马斯卡拉克
maseɣoso	马塞戈索
masiðe	马西德
maskefa	马斯克法
masanas	马萨纳斯
mataβwena	马塔武埃纳
mataɣaʎs	马塔加尔斯
mataleβɾeɾas	马塔莱夫雷拉斯
mataʎana	马塔利亚纳
matamoɾosa	马塔莫罗萨
matanθa	马坦萨
matapoθwelos	马塔波苏埃洛斯
mataɾo	马塔罗
mataruβja	马塔鲁维亚
mateðeon	马特德翁
matjenθo	马蒂恩索
matute	马图特
mau̯soleo	毛索莱奥
maʝalde	马亚尔德
maʝals	马亚尔斯
maʝoɾɣa	马约尔加
maθaɾete	马萨雷特
maθaɾikos	马萨里科斯
maθaron	马萨龙
maθaɾuʎeke	马萨鲁列克
maθateɾon	马萨特龙
maθwekos	马苏埃科斯
meano	梅阿诺
meko	梅科
meðjana	梅迪亚纳
meðina	梅迪纳
meðiɲa	梅迪尼亚
meðinaθeli	梅迪纳塞利
meðjoðja	梅迪奥迪亚
meðjona	梅迪奥纳
mei̯xaβoi̯	梅哈沃伊
mei̯ɾa	梅拉
mei̯s	梅斯
mexoɾaða	梅霍拉达
meljana	梅利亚纳
meliða	梅利达
meʎið	梅利
melon	梅隆
membɾiʎa	门布里利亚
membɾiʎaɾ	门布里利亚尔
membɾiʎeɾa	门布里列拉
membɾjo	门布里奥
menasalβas	梅纳萨尔瓦斯
meŋkal	门卡尔
mendaβja	门达维亚
mendiɣorja	门迪戈里亚
meneses	梅内塞斯
meŋgaβɾil	门加夫里尔
menxiβaɾ	门希瓦尔
mentɾiða	门特里达
mekinenθa	梅基嫩萨
meɾa	梅拉
meɾiða	梅里达
mesja	梅西亚
mesones	梅索内斯
mestanθa	梅斯坦萨
mjaxaðas	米亚哈达斯
mjeðes	米耶德斯
mjeɾas	米耶拉斯
mjeɾes	米耶雷斯
mjeθa	米耶萨
miɣeltura	米格尔图拉
mixaɾes	米哈雷斯
mixas	米哈斯
milaɣɾo	米拉格罗
miʎana	米利亚纳
miʎaɾes	米利亚雷斯
miʎena	米列纳
minana	米纳纳
minateða	米纳特达
minaʝa	米纳亚
miŋglaniʎa	明格拉尼利亚
miŋgorja	明戈里亚
miɲo	米尼奥
miɾa	米拉
miɾaβel	米拉韦尔
miɾambel	米兰贝尔
miɾandiʎa	米兰迪利亚
miɾaβaʎes	米拉瓦列斯
miɾaβet	米拉韦特
miɾaβete	米拉韦特
moaɲa	莫阿尼亚
moθexon	莫塞洪
moʧales	莫查莱斯
moklin	莫克林
moeʧe	莫埃切
mofɾeʧo	莫弗雷乔
moxente	莫亨特
moɣon	莫贡
moɣeɾ	莫格尔
mo.eðas	莫埃达斯
mo.oɾte	莫奥尔特
moxakaɾ	莫哈卡尔
moxaðos	莫哈多斯
moxina	莫希纳
mola	莫拉
molaton	莫拉通
molinaseka	莫利纳塞卡
molinikos	莫利尼科斯
molinos	莫利诺斯
moʎeðo	莫列多
moʎeɾusa	莫列鲁萨
moʎet	莫列特
moʎina	莫利纳
moʎo	莫略
molweŋgo	莫伦戈
molβiθaɾ	莫尔维萨尔
mombeltɾan	蒙贝尔特兰
mombwei̯	蒙布埃
monaʧil	莫纳奇尔
monbeltɾan	蒙贝尔特兰
moŋkaða	蒙卡达
moŋkalβo	蒙卡尔沃
moŋkaʝo	蒙卡约
moŋkloa	蒙克洛阿
moŋkofaɾ	蒙科法尔
monda	蒙达
mondaɾiθ	蒙达里斯
mondexaɾ	蒙德哈尔
mondoɲeðo	蒙多涅多
mondɾaɣon	蒙德拉贡
monduβeɾ	蒙杜韦尔
moneɣɾiʎo	莫内格里略
monesteɾjo	莫内斯特里奥
moneβa	莫内瓦
monfeɾo	蒙费罗
monfloɾite	蒙弗洛里特
moŋgo	蒙戈
monistɾol	莫尼斯特罗尔
monleɾas	蒙莱拉斯
monoβaɾ	莫诺瓦尔
monreal	蒙雷阿尔
monroi̯	蒙罗伊
monroʝo	蒙罗约
monsaɣɾo	蒙萨格罗
monserat	蒙塞拉特
montalβan	蒙塔尔万
montalβanexo	蒙塔尔瓦内霍
montalβo	蒙塔尔沃
montalβos	蒙塔尔沃斯
montalβos	蒙塔尔沃斯
montan	蒙坦
montanʧeθ	蒙坦切斯
montanʝola	蒙坦约拉
montaɾto	蒙塔尔托
monteaɣuðo	蒙特阿古多
monteaɾaɣon	蒙特阿拉贡
monteðeramo	蒙特德拉莫
montefɾjo	蒙特弗里奥
montexake	蒙特哈克
montexikaɾ	蒙特希卡尔
monteʎano	蒙特利亚诺
montemolin	蒙特莫林
monterei̯	蒙特雷
monteroso	蒙特罗索
monteruβjo	蒙特鲁维奥
montesa	蒙特萨
montesklaɾos	蒙特斯克拉罗斯
montjel	蒙铁尔
montixo	蒙蒂霍
montiʎa	蒙蒂利亚
montiʎana	蒙蒂利亚纳
montiθon	蒙蒂松
montmelo	蒙特梅洛
monton	蒙通
montoɾo	蒙托罗
montɾas	蒙特拉斯
montɾoi̯	蒙特罗伊
montweŋga	蒙通加
montwiɾi	蒙图伊里
montuɾke	蒙图尔克
monθon	蒙松
moɾa	莫拉
moɾal	莫拉尔
moɾalexa	莫拉莱哈
moɾales	莫拉莱斯
moɾalina	莫拉利纳
moɾaɲa	莫拉尼亚
moɾante	莫兰特
moɾataʎa	莫拉塔利亚
moɾθiʎo	莫尔西略
moɾeða	莫雷达
moɾeʎ	莫雷尔
moɾeʎa	莫雷利亚
moɾentin	莫伦廷
moɾes	莫雷斯
moɾei̯	莫雷
moɾiles	莫里莱斯
moɾiʎexo	莫里列霍
moɾla	莫尔拉
moɾos	莫罗斯
mos	莫斯
moskeɾwela	莫斯克鲁埃拉
mostoles	莫斯托莱斯
motiʎa	莫蒂利亚
motiʎexa	莫蒂列哈
motos	莫托斯
motɾil	莫特里尔
moʝa	莫亚
moʝwela	莫尤埃拉
moθonθiʎo	莫松西略
muʧamjel	穆查米耶尔
muθjentes	穆先特斯
mwel	穆埃尔
muɣai̯ɾe	穆盖雷
muɣaɾðos	穆加尔多斯
muxja	穆希亚
muxika	穆希卡
mwiɲos	穆伊尼奥斯
mula	穆拉
muɲana	穆尼亚纳
muneβɾeɣa	穆内夫雷加
muneɾa	穆内拉
munxja	蒙希亚
muniko	穆尼科
munjesa	穆涅萨
muniʎa	穆尼利亚
muɲoɣalindo	穆尼奥加林多
muɲoɣɾande	穆尼奥格兰德
muntaðas	蒙塔达斯
muɾas	穆拉斯
muɾʧante	穆尔钱特
muɾθja	穆尔西亚
muɾɣja	穆尔吉亚
muɾjel	穆列尔
muɾo	穆罗
muɾos	穆罗斯
muɾtas	穆尔塔斯
muɾweta	穆鲁埃塔
naθimjento	纳西缅托
naɣoɾe	纳戈雷
na.aros	纳阿罗斯
naxeɾa	纳赫拉
nambɾoka	楠布罗卡
nakeɾa	纳克拉
naɾβoneta	纳尔沃内塔
naɾon	纳龙
naβa	纳瓦
naβaθeraða	纳瓦塞拉达
naβaʧika	纳瓦奇卡
naβakonθexo	纳瓦孔塞霍
naβafɾja	纳瓦弗里亚
naβa.eɾmosa	纳瓦埃尔莫萨
naβa.ondiʎa	纳瓦翁迪利亚
naβaxas	纳瓦哈斯
naβal	纳瓦尔
naβalakɾuθ	纳瓦拉克鲁斯
naβalaɣameʎa	纳瓦拉加梅利亚
naβalkaβaʎo	纳瓦尔卡瓦略
naβalkan	纳瓦尔坎
naβaleno	纳瓦莱诺
naβalɣixo	纳瓦尔吉霍
naβaliʎa	纳瓦利利亚
naβalmanθano	纳瓦尔曼萨诺
naβalmoɾal	纳瓦尔莫拉尔
naβalmoɾalexo	纳瓦尔莫拉莱霍
naβaloŋgiʎa	纳瓦隆吉利亚
naβalosa	纳瓦洛萨
naβalpino	纳瓦尔皮诺
naβalsau̯θ	纳瓦尔绍斯
naβalweŋga	纳瓦伦加
naβaɾðun	纳瓦尔敦
naβares	纳瓦雷斯
naβarete	纳瓦雷特
naβas	纳瓦斯
naβasa	纳瓦萨
naβaskwes	纳瓦斯库埃斯
naβasfɾjas	纳瓦斯弗里亚斯
naβata	纳瓦塔
naβelɣas	纳韦尔加斯
naβes	纳韦斯
naβja	纳维亚
neβɾeða	内夫雷达
neða	内达
neɣɾeðo	内格雷多
neɣɾei̯ɾa	内格雷拉
nei̯la	内拉
neɾxa	内尔哈
neɾpjo	内尔皮奥
neɾβa	内尔瓦
nestaɾ	内斯塔尔
njeβla	涅夫拉
njeβes	涅韦斯
niɣɾan	尼格兰
niɣelas	尼格拉斯
nixaɾ	尼哈尔
noai̯n	诺艾恩
noalexo	诺阿莱霍
noβlexas	诺夫莱哈斯
noθeða	诺塞达
noeθ	诺埃斯
nofwentes	诺丰特斯
noɣales	诺加莱斯
noɣɾales	诺格拉莱斯
noɣeɾa	诺格拉
noɣeɾwelas	诺格鲁埃拉斯
noi̯s	诺伊斯
nolai̯	诺莱
nombela	农贝拉
nonaspe	诺纳斯佩
noɾeɲa	诺雷尼亚
noβales	诺瓦莱斯
noβaʎas	诺瓦利亚斯
noβelda	诺韦尔达
noβes	诺韦斯
noβiʎas	诺维利亚斯
noʝa	诺亚
nweno	努埃诺
nweβa	努埃瓦
nules	努莱斯
nuʎes	努列斯
numanθja	努曼西亚
nuɲomoɾal	努尼奥莫拉尔
oβon	奥翁
okaɲa	奥卡尼亚
oθexon	奥塞洪
oθentexo	奥森特霍
oʧaɣaβja	奥查加维亚
oʧandjano	奥钱迪亚诺
oðen	奥登
oðon	奥东
o.anes	奥阿内斯
oimbɾa	奥因布拉
oxen	奥亨
oxos	奥霍斯
olaʎa	奥拉利亚
olaβe	奥拉韦
olaθaɣutja	奥拉萨古蒂亚
olβa	奥尔瓦
olei̯ɾos	奥莱罗斯
oljana	奥利亚纳
oljas	奥利亚斯
oljete	奥列特
oljola	奥利奥拉
olite	奥利特
oliβa	奥利瓦
oliβaɾes	奥利瓦雷斯
oliβeʎa	奥利韦利亚
oliβenθa	奥利文萨
oʎeɾja	奥列里亚
oʎo	奥略
olmeðiʎas	奥尔梅迪利亚斯
olmeðo	奥尔梅多
olmiʎos	奥尔米略斯
olokau̯	奥洛考
olombɾaða	奥隆布拉达
olost	奥洛斯特
olot	奥洛特
olβan	奥尔万
olβeɣa	奥尔韦加
olβena	奥尔韦纳
olβeɾa	奥尔韦拉
olθa	奥尔萨
oɲa	奥尼亚
oɲate	奥尼亚特
oŋkala	翁卡拉
onda	翁达
ondaɾa	翁达拉
ondaroa	翁达罗阿
onis	奥尼斯
ontaneða	翁塔内达
ontenjente	翁特年特
ontuɾ	翁图尔
onθoniʎa	翁索尼利亚
okiʎas	奥基利亚斯
oɾβaɾa	奥尔瓦拉
oɾθe	奥尔塞
oɾθeɾa	奥尔塞拉
oɾʧeta	奥尔切塔
oɾðuɲa	奥尔杜尼亚
oɾea	奥雷阿
oɾexo	奥雷霍
oɾense	奥伦塞
oɾes	奥雷斯
oɾɣaɲa	奥尔加尼亚
oɾɣaθ	奥尔加斯
oɾxiβa	奥尔希瓦
oɾja	奥里亚
oɾi.wela	奥里韦拉
oɾjo	奥里奥
oɾis	奥里斯
oɾista	奥里斯塔
oɾle	奥尔莱
oɾol	奥罗尔
oɾopesa	奥罗佩萨
oɾoso	奥罗索
oɾoθko	奥罗斯科
orjos	奥里奥斯
orjus	奥留斯
oɾusko	奥鲁斯科
oseɾa	奥塞拉
osoɾ	奥索尔
osoɾno	奥索尔诺
ostiθ	奥斯蒂斯
osuna	奥苏纳
otei̯θa	奥泰萨
oteo	奥特奥
oteɾo	奥特罗
otiβaɾ	奥蒂瓦尔
otuɾa	奥图拉
ou̯ɾal	欧拉尔
ou̯tes	欧特斯
ou̯βjaɲo	欧维亚尼奥
oβexo	奥韦霍
oβjeðo	奥维耶多
oʝa	奥亚
oʝaɾθun	奥亚尔孙
oʝon	奥永
oθaeta	奥萨埃塔
paðɾon	帕德龙
paðul	帕杜尔
paɣeɾa	帕格拉
paxaɾes	帕哈雷斯
paxaɾon	帕哈龙
paxaɾonθiʎo	帕哈龙西略
palafɾuxeʎ	帕拉弗鲁赫尔
palamos	帕拉莫斯
palaŋkas	帕兰卡斯
palaŋkes	帕兰克斯
palaŋkinos	帕兰基诺斯
palenθja	帕伦西亚
palenθjana	帕伦西亚纳
palentino	帕伦蒂诺
palenθwela	帕伦苏埃拉
paʎaɾes	帕利亚雷斯
paʎaɾs	帕利亚尔斯
paʎexa	帕列哈
paʎeɾols	帕列罗尔斯
palma	帕尔马
palo	帕洛
palomas	帕洛马斯
palomeke	帕洛梅克
palomeɾa	帕洛梅拉
pals	帕尔斯
pampljeɣa	潘普列加
pamplona	潘普洛纳
paŋkoɾβo	潘科尔沃
paŋkɾuðo	潘克鲁多
panes	帕内斯
paniθa	帕尼萨
pantikosa	潘蒂科萨
pantoxa	潘托哈
panton	潘通
paones	保内斯
papeles	帕佩莱斯
paɾakweʎos	帕拉库埃略斯
paɾaðas	帕拉达斯
paɾaðaseka	帕拉达塞卡
paɾaðela	帕拉德拉
paɾamo	帕拉莫
paɾau̯ta	帕劳塔
paɾθent	帕尔森特
paɾðiʎa	帕尔迪利亚
paɾeðes	帕雷德斯
paɾexa	帕雷哈
paɾets	帕雷茨
paɾɣa	帕尔加
paɾla	帕尔拉
paɾlaβa	帕尔拉瓦
pares	帕雷斯
pariʎas	帕里利亚斯
paɾtaloa	帕尔塔洛阿
paɾθan	帕尔桑
pasaxes	帕萨赫斯
pasaɾon	帕萨龙
pastoɾiθa	帕斯托里萨
pastɾana	帕斯特拉纳
pau̯ls	保尔斯
paβjas	帕维亚斯
pai̯moɣo	派莫戈
peʧina	佩奇纳
peðɾalβa	佩德拉尔瓦
peðɾalβes	佩德拉尔韦斯
peðɾeɣeɾ	佩德雷格尔
peðɾeɾa	佩德雷拉
peðɾoʧe	佩德罗切
peðɾola	佩德罗拉
peðɾoso	佩德罗索
peðɾou̯θos	佩德罗索斯
peɣalaxaɾ	佩加拉哈尔
peɣo	佩戈
pela.ustan	佩拉乌斯坦
peleaɣonθalo	佩莱阿贡萨洛
peleɣɾina	佩莱格里纳
peloʧe	佩洛切
peɲaθeraða	佩尼亚塞拉达
peɲafjel	佩尼亚菲耶尔
peɲafloɾ	佩尼亚弗洛尔
peɲaɣolosa	佩尼亚戈洛萨
penaɣos	佩纳戈斯
peɲalβa	佩尼亚尔瓦
peɲalen	佩尼亚伦
peɲaruβja	佩尼亚鲁维亚
peɲaskosa	佩尼亚斯科萨
peɲau̯sende	佩尼奥森德
peniskola	佩尼斯科拉
pepino	佩皮诺
peɾaθense	佩拉森塞
peɾafita	佩拉菲塔
peɾal	佩拉尔
peɾalexos	佩拉莱霍斯
peɾalta	佩拉尔塔
peɾaltiʎa	佩拉尔蒂利亚
peɾalβeʧe	佩拉尔韦切
peɾamola	佩拉莫拉
peɾanθanes	佩兰萨内斯
peɾataʎaða	佩拉塔利亚达
peɾðiɣeɾa	佩尔迪格拉
peɾelaða	佩雷拉达
peɾeʎo	佩雷略
peɾeɲa	佩雷尼亚
peɾeɾwela	佩雷鲁埃拉
peɾjana	佩里亚纳
peɾoruβjo	佩罗鲁维奥
peɾtusa	佩尔图萨
peɾβes	佩尔韦斯
pesaɣeɾo	佩萨格罗
peskweθa	佩斯库埃萨
peskeɾa	佩斯克拉
peswes	佩苏埃斯
petin	佩廷
pjas	皮亚斯
pikaʧo	皮卡乔
pikasent	皮卡森特
pikon	皮孔
pikoro	皮科罗
pjeðɾaβwena	彼德拉武埃纳
pjeðɾafita	彼德拉菲塔
pjeðɾa.ita	彼德拉伊塔
pjeɾa	彼拉
pilas	皮拉斯
piloɲa	皮洛尼亚
pina	皮纳
pinaɾ	皮纳尔
pinaɾexo	皮纳雷霍
pinaɾexos	皮纳雷霍斯
pineða	皮内达
pinet	皮内特
piniʎos	皮尼略斯
pinofɾaŋkeaðo	皮诺弗兰克阿多
piɲoɾ	皮尼奥尔
pinos	皮诺斯
pinoso	皮诺索
pintano	平塔诺
pipaon	皮帕翁
pikeɾas	皮克拉斯
piɾa	皮拉
pitiʎas	皮蒂利亚斯
piθara	皮萨拉
piθaral	皮萨拉尔
plan	普兰
planes	普拉内斯
plasenθja	普拉森西亚
plasenθwela	普拉森苏埃拉
plenθja	普伦西亚
pljeɣo	普列戈
plou̯	普洛
poβes	波韦斯
poβlete	波夫莱特
poβoleða	波沃莱达
pol	波尔
polaŋko	波兰科
polenino	波莱尼诺
polentinos	波伦蒂诺斯
poljentes	波连特斯
poʎensa	波连萨
poʎos	波略斯
polopos	波洛波斯
pomaɾ	波马尔
pomeɾ	波梅尔
ponferaða	蓬费拉达
poŋga	蓬加
pons	蓬斯
ponteβeðɾa	蓬特韦德拉
pontones	蓬托内斯
pontons	蓬通斯
ponθano	蓬萨诺
poɾkuna	波尔库纳
poɾkeɾa	波尔克拉
poreɾa	波雷拉
poreɾas	波雷拉斯
poriɲo	波里尼奥
poron	波龙
poɾtaxe	波尔塔赫
poɾto	波尔托
poɾθuna	波尔苏纳
posaða	波萨达
posaðas	波萨达斯
posaðiʎa	波萨迪利亚
potes	波特斯
poβeðiʎa	波韦迪利亚
poʝales	波亚莱斯
poʝatos	波亚托斯
poʝo	波约
poʝos	波约斯
poθaldeθ	波萨尔德斯
poθoantiɣwo	波索安蒂果
poθo.ondo	波索翁多
poθondon	波松东
poθoruβjo	波索鲁维奥
poθoseko	波索塞科
poθwelo	波苏埃洛
pɾaðai̯ɾo	普拉代罗
pɾaðales	普拉达莱斯
pɾaðexon	普拉德洪
pɾaðena	普拉德纳
pɾaðes	普拉德斯
pɾaðiʎo	普拉迪略
pɾaðo	普拉多
pɾaðolweŋgo	普拉多伦戈
pɾatðip	普拉特迪普
pɾaβja	普拉维亚
pɾei̯ksens	普雷克森斯
pɾexano	普雷哈诺
pɾjeɣo	普列戈
pɾjoɾo	普里奥罗
pɾoaθa	普罗阿萨
pɾoɣalo	普罗加洛
pɾuna	普鲁纳
pwenteaɾeas	蓬特阿雷阿斯
pwenteðeu̯me	蓬特德乌梅
pwentenansa	蓬特南萨
pwenteβjesɣo	蓬特维耶斯戈
pweʝo	普埃约
puxera	普赫拉
pulɣaɾ	普尔加尔
pulpi	普尔皮
punxin	蓬欣
puɾʧena	普尔切纳
puɾuxosa	普鲁霍萨
puɾuʎena	普鲁列纳
puθol	普索尔
kwaɾt	夸尔特
kel	克尔
kemaða	克马达
keɾo	克罗
kesa	克萨
kesaða	克萨达
kintanapaʎa	金塔纳帕利亚
kintanaβiðes	金塔纳维德斯
kintaniʎa	金塔尼利亚
kintela	金特拉
kinto	金托
kiɾoɣa	基罗加
kiɾos	基罗斯
kisiθeðo	基西塞多
kismondo	基斯蒙多
raβaðe	拉瓦德
raβanales	拉瓦纳莱斯
raβasa	拉瓦萨
raβo	拉沃
raðona	拉多纳
rafales	拉法莱斯
raɣama	拉加马
raɣol	拉戈尔
raxaðeʎ	拉哈德尔
ramakastaɲas	拉马卡斯塔尼亚斯
ramaʎosa	拉马略萨
raskafɾja	拉斯卡弗里亚
rasines	拉西内斯
raso	拉索
raskeɾa	拉斯克拉
rasweɾos	拉苏埃罗斯
reales	雷阿莱斯
reβalsaðoɾes	雷瓦尔萨多雷斯
reβoʎeɾa	雷沃列拉
reβoʎo	雷沃略
rekas	雷卡斯
reðona	雷多纳
reðondela	雷东德拉
rexenxo	雷亨霍
rei̯ʎo	雷略
rei̯na	雷纳
rei̯nosa	雷诺萨
reʎeu̯	雷列乌
reʎinas	雷利纳斯
rena	雷纳
renales	雷纳莱斯
reneðo	雷内多
reneɾa	雷内拉
reŋgos	伦戈斯
renteɾja	伦特里亚
reoθin	雷奥辛
rekexo	雷克霍
rekena	雷克纳
resoβa	雷索瓦
respaldiθa	雷斯帕尔迪萨
restjeʎo	雷斯铁略
retamal	雷塔马尔
retamosa	雷塔莫萨
retjendas	雷蒂恩达斯
reu̯s	雷乌斯
reβiʎaruθ	雷维利亚鲁斯
reβolkaðoɾes	雷沃尔卡多雷斯
rja.welas	里亚韦拉斯
rjalp	里亚尔普
rjanxo	里安霍
rjaɲo	里亚尼奥
rjaθa	里亚萨
riβaðaβja	里瓦达维亚
riβaðeo	里瓦德奥
riβaðeseʎa	里瓦德塞利亚
riβaðumja	里瓦杜米亚
riβafoɾaða	里瓦福拉达
riβafɾeʧa	里瓦弗雷查
riβareðonda	里瓦雷东达
riβataxaða	里瓦塔哈达
riβesalβes	里韦萨尔韦斯
riβota	里沃塔
rikla	里克拉
rikoβaʝo	里科瓦约
rikote	里科特
rjeʎo	列略
rjelβes	列尔韦斯
riɣlos	里格洛斯
riɣoi̯tja	里戈伊蒂亚
riʎa	里利亚
rineɾ	里内尔
rjo	里奥
rjoβaɾβa	里奥瓦尔瓦
rjokaβaðo	里奥卡瓦多
rjokaldo	里奥卡尔多
rjoðeβa	里奥德瓦
rjofɾjo	里奥弗里奥
rjoɣoɾðo	里奥戈尔多
rjoxa	里奥哈
rjoloβos	里奥洛沃斯
rjopaɾ	里奥帕尔
rjos	里奥斯
rjosa	里奥萨
rjotoɾto	里奥托尔托
ripoʎ	里波尔
ripoʎet	里波列特
risko	里斯科
rjuðaɾenas	留达雷纳斯
rjuðau̯ɾa	留道拉
rjuðekanas	留德卡纳斯
rjuðekols	留德科尔斯
rjuðoms	留多姆斯
riβei̯ɾa	里韦拉
riβeɾo	里韦罗
roa	罗阿
roales	罗阿莱斯
roβleða	罗夫莱达
roβleðo	罗夫莱多
roβleðoʎano	罗夫莱多利亚诺
roβɾes	罗夫雷斯
rokaʎau̯ɾa	罗卡廖拉
roθjana	罗西亚纳
roðana	罗达纳
roðei̯ɾo	罗代罗
roðeʎaɾ	罗德利亚尔
roðenas	罗德纳斯
roðjeθmo	罗迭斯莫
roðoɲa	罗多尼亚
roðos	罗多斯
roi̯s	罗伊斯
roxales	罗哈莱斯
roʎan	罗良
romanones	罗马诺内斯
roŋkal	龙卡尔
ronθesβaʎes	龙塞斯瓦列斯
ronda	龙达
roketas	罗克塔斯
rosal	罗萨尔
rosas	罗萨斯
roseʎ	罗塞尔
rota	罗塔
rotoβa	罗托瓦
roʝwela	罗尤埃拉
rwanes	鲁阿内斯
ruβena	鲁韦纳
ruβi	鲁维
ruβjales	鲁维亚莱斯
ruβjan	鲁维安
ruβjana	鲁维亚纳
ruβjo	鲁维奥
ruβite	鲁维特
ruðiʎa	鲁迪利亚
rweða	鲁埃达
rwesta	鲁埃斯塔
ruɣiʎa	鲁吉利亚
rwiðeɾa	鲁伊德拉
rupja	鲁皮亚
rus	鲁斯
rute	鲁特
saβaðeʎ	萨瓦德尔
saβeɾo	萨韦罗
saβiɲaniɣo	萨维尼亚尼戈
saβjote	萨维奥特
sakaɲet	萨卡涅特
saθeðon	萨塞东
saθeðonθiʎo	萨塞东西略
saθeɾwela	萨塞鲁埃拉
sakɾamenja	萨克拉梅尼亚
saða	萨达
saðaβa	萨达瓦
saeliθes	萨埃利塞斯
saɣaɾo	萨加罗
saxiðes	萨希德斯
saɣɾa	萨格拉
saɣunto	萨贡托
sa.aɣun	萨阿贡
salaða	萨拉达
salamaŋka	萨拉曼卡
salamon	萨拉蒙
salaɾ	萨拉尔
salaɾðu	萨拉尔杜
salas	萨拉斯
salθe	萨尔塞
salθeðo	萨尔塞多
saldaɲa	萨尔达尼亚
saldon	萨尔东
saldweɾo	萨尔杜埃罗
salinas	萨利纳斯
salinas	萨利纳斯
saʎent	萨连特
salmeɾon	萨尔梅龙
salmoɾal	萨尔莫拉尔
saloβɾal	萨洛夫拉尔
saloβɾe	萨洛夫雷
saloβɾena	萨洛夫雷纳
salomo	萨洛莫
saloɾino	萨洛里诺
salou̯	萨洛
salsaðeʎa	萨尔萨德利亚
salt	萨尔特
salβakaɲete	萨尔瓦卡涅特
salβatjera	萨尔瓦铁拉
samboal	桑博阿尔
samos	萨莫斯
sampeðoɾ	桑佩多尔
sampeɾ	桑佩尔
sanaβɾja	萨纳夫里亚
sana.uxa	萨纳乌哈
sanθeðo	桑塞多
sanʧiðɾjan	桑奇德里安
sanʧonuɲo	桑乔努尼奥
sandjanes	桑迪亚内斯
sando	桑多
sanxenxo	桑亨霍
saŋgwesa	桑圭萨
sansol	桑索尔
santakaɾa	桑塔卡拉
santaeʎa	桑塔埃利亚
santani	桑塔尼
santiβaɲeθ	桑蒂瓦涅斯
santiʎana	桑蒂利亚纳
santiso	桑蒂索
santjuste	桑蒂乌斯特
santiθ	桑蒂斯
santolea	桑托莱阿
santomeɾa	桑托梅拉
santoɲa	桑托尼亚
santoβenja	桑托韦尼亚
santukɾi	桑图克里
santuɾθe	桑图尔塞
santuɾðe	桑图尔德
sanθoles	桑索莱斯
sapei̯ɾa	萨佩拉
saɾaɣosa	萨拉戈萨
saɾjeɣo	萨列戈
saɾiɲena	萨里涅纳
sarateʎa	萨拉特利亚
sareal	萨雷阿尔
sareau̯s	萨雷奥斯
sarja	萨里亚
sarjon	萨里翁
saroka	萨罗卡
saɾβise	萨尔维塞
sasamon	萨萨蒙
sasðoniɣas	萨斯多尼加斯
sastaɣo	萨斯塔戈
sau̯ka	绍卡
sau̯θeðiʎa	绍塞迪利亚
sau̯θeʎe	绍塞列
saβiɲan	萨维尼扬
saβiɲao	萨维尼奥
saks	萨克斯
saʝaton	萨亚通
seβulkoɾ	塞武尔科尔
sekoɾun	塞科伦
seðano	塞达诺
seðeʎa	塞德利亚
seɣoɾβe	塞戈尔韦
seɣuɾiʎa	塞古里利亚
selaʝa	塞拉亚
selɣwa	塞尔瓜
seʎa	塞利亚
seʎano	塞利亚诺
selβa	塞尔瓦
semiʎas	塞米利亚斯
sena	塞纳
senes	塞内斯
senmanat	森马纳特
senra	森拉
senteɾaða	森特拉达
sepulβeða	塞普尔韦达
sekeɾos	塞克罗斯
seɾantes	塞兰特斯
seɾiɲa	塞里尼亚
seɾon	塞龙
seɾos	塞罗斯
sera	塞拉
seraða	塞拉达
seraðeɾo	塞拉德罗
seraðiʎa	塞拉迪利亚
seraniʎos	塞拉尼略斯
seratei̯ks	塞拉泰克斯
serexon	塞雷洪
sesa	塞萨
seseɲa	塞塞尼亚
sesma	塞斯马
sestao	塞斯陶
sestɾika	塞斯特里卡
setkases	塞特卡塞斯
setenil	塞特尼尔
setiles	塞蒂莱斯
seβa	塞瓦
seβiʎa	塞维利亚
seβiʎe	塞维列
sjero	谢罗
sjetamo	谢塔莫
siɣwenθa	锡古恩萨
siɣwes	锡圭斯
siles	锡莱斯
siʎa	锡利亚
siʎeða	锡列达
sils	锡尔斯
simaŋkas	锡曼卡斯
sineu̯	锡内乌
sinlaβaxos	辛拉瓦霍斯
sipan	锡潘
siɾwela	锡鲁埃拉
sisamon	锡萨蒙
sisante	锡桑特
soβeɾ	索韦尔
soβɾaðiʎo	索夫拉迪略
soβɾaðo	索夫拉多
soβɾelapeɲa	索夫雷拉佩尼亚
soβɾeskoβjo	索夫雷斯科维奥
sokoβos	索科沃斯
sokweʎamos	索库埃利亚莫斯
soðupe	索杜佩
solaɾes	索拉雷斯
soleɾa	索莱拉
soliβeʎa	索利韦利亚
soʎana	索利亚纳
soʎeɾ	索列尔
solosanʧo	索洛桑乔
solsona	索尔索纳
somjo	索米奥
somolinos	索莫利诺斯
somontano	索蒙塔诺
somontin	索蒙廷
somosjera	索莫谢拉
somoθas	索莫萨斯
sonθiʎo	松西略
sondika	松迪卡
sonexa	索内哈
sopei̯ɾa	索佩拉
soɾβas	索尔瓦斯
soɾja	索里亚
soɾi.wela	索里韦拉
soɾlaða	索尔拉达
soɾpe	索尔佩
soriβes	索里韦斯
soɾt	索尔特
soɾθano	索尔萨诺
soses	索塞斯
sotes	索特斯
sotjeʎo	索铁略
sotoðosos	索托多索斯
sotomaʝoɾ	索托马约尔
sotopalaθjos	索托帕拉西奥斯
sotos	索托斯
sotoserano	索托塞拉诺
sotɾesɣuðo	索特雷斯古多
sotwelamos	索图埃拉莫斯
swanθes	苏安塞斯
suβixana	苏维哈纳
suβiɾana	苏维拉纳
suθina	苏西纳
suðaneʎ	苏达内尔
sweka	苏埃卡
sumbiʎa	孙比利亚
suɾja	苏里亚
taβaɾa	塔瓦拉
taβeɾno	塔韦尔诺
taβoaða	塔沃阿达
taβoaðela	塔沃阿德拉
taβweŋka	塔文卡
tafaʎa	塔法利亚
ta.al	塔阿尔
ta.us	塔乌斯
tal	塔尔
talamantes	塔拉曼特斯
talaruβjas	塔拉鲁维亚斯
talaβan	塔拉万
talaʝon	塔拉永
talaʝwela	塔拉尤埃拉
talaʝwelas	塔拉尤埃拉斯
talaʝwelo	塔拉尤埃洛
taliɣa	塔利加
taʎaðeʎ	塔利亚德尔
taʎante	塔良特
tamaxon	塔马洪
tamame	塔马梅
tamames	塔马梅斯
tamaɾju	塔马留
tambɾe	坦布雷
tamuɾexo	塔穆雷霍
tapjoles	塔皮奥莱斯
taɾaθena	塔拉塞纳
taɾaðeʎ	塔拉德尔
taɾamundi	塔拉蒙迪
taɾaŋkon	塔兰孔
taɾaβiʎa	塔拉维利亚
taɾaθona	塔拉索纳
taɾβena	塔尔韦纳
taɾðaxos	塔尔达霍斯
taɾðelkwende	塔尔德尔昆德
taɾðjenta	塔尔迪恩塔
taɾifa	塔里法
taɾixa	塔里哈
taɾna	塔尔纳
taraɣona	塔拉戈纳
tarasa	塔拉萨
tareɣa	塔雷加
tarjo	塔里奥
taroxa	塔罗哈
taros	塔罗斯
tau̯ste	陶斯特
taβaɾwela	塔瓦鲁埃拉
taθones	塔索内斯
teβa	特瓦
teβaɾ	特瓦尔
texaðiʎos	特哈迪略斯
texaɾes	特哈雷斯
texei̯ɾo	特黑罗
texeɾa	特赫拉
tembleke	滕布莱克
tempul	滕普尔
tendiʎa	滕迪利亚
teneβɾon	特内夫龙
teo	特奥
teɾmens	特尔门斯
teɾmino	特尔米诺
teɾminon	特尔米农
teraðas	特拉达斯
terjente	特连特
terinʧes	特林切斯
teroβa	特罗瓦
teɾwel	特鲁埃尔
teu̯laða	特乌拉达
teβeɾɣa	特韦尔加
tjana	蒂亚纳
tiβi	蒂维
tiβiðaβo	蒂维达沃
tjeβas	铁瓦斯
tjeðɾa	铁德拉
tjelβe	铁尔韦
tjeɾɣa	铁尔加
tjeɾmas	铁尔马斯
tjeɾθo	铁尔索
tjesa	铁萨
tixola	蒂霍拉
tinaxas	蒂纳哈斯
tineo	蒂内奥
tiɲosiʎos	蒂尼奥西略斯
tiɾɣo	蒂尔戈
tiɾiɣ	蒂里格
tiɾteafweɾa	蒂尔特阿富埃拉
titaɣwas	蒂塔瓜斯
tjuɾana	蒂乌拉纳
tiβenis	蒂韦尼斯
tiβisa	蒂维萨
toβara	托瓦拉
toβja	托维亚
toθina	托西纳
toðeʎeɣo	托德列戈
toðoleʎa	托多莱利亚
toleðo	托莱多
toloθiɾjo	托洛西里奥
tolosa	托洛萨
toloks	托洛克斯
tolβa	托尔瓦
tomeʎoso	托梅略索
tomiɲo	托米尼奥
tona	托纳
topaɾes	托帕雷斯
tokes	托克斯
toɾ	托尔
toɾa	托拉
toɾas	托拉斯
toɾðe.umos	托尔德乌莫斯
toɾðeɾa	托尔德拉
toɾðomaɾ	托尔多马尔
toɾðoʝa	托尔多亚
toɾeʎo	托雷略
toɾeno	托雷诺
toɾixa	托里哈
toɾil	托里尔
toɾla	托尔拉
toɾmon	托尔蒙
toɾnaβakas	托尔纳瓦卡斯
toɾo	托罗
toɾkemaða	托尔克马达
toralβa	托拉尔瓦
toreaðɾaða	托雷阿德拉达
toreβeleɲa	托雷韦莱尼亚
toreβeses	托雷韦塞斯
torekaβaʎeɾos	托雷卡瓦列罗斯
torekampo	托雷坎波
toreθiʎa	托雷西利亚
toreðembara	托雷登巴拉
toreðonximeno	托雷东希梅诺
torefareɾa	托雷法雷拉
toreɣɾosa	托雷格罗萨
torei̯ɣlesjas	托雷格莱西亚斯
torexonθiʎo	托雷洪西略
torelaɣuna	托雷拉古纳
torelapaxa	托雷拉帕哈
torelaβeɣa	托雷拉韦加
toreʎano	托雷利亚诺
toreʎas	托雷利亚斯
toreloβaton	托雷洛瓦通
toreloðones	托雷洛多内斯
toremanθanas	托雷曼萨纳斯
toremaʝoɾ	托雷马约尔
toremexja	托雷梅希亚
toremoʧa	托雷莫查
toremolinos	托雷莫利诺斯
toremontalβo	托雷蒙塔尔沃
torente	托伦特
torenweβa	托雷努埃瓦
toreoɾɣaθ	托雷奥尔加斯
torepeɾoxil	托雷佩罗希尔
torekeβɾaðiʎa	托雷克夫拉迪利亚
torekemaða	托雷克马达
tores	托雷斯
toresandino	托雷桑迪诺
toresmenuðas	托雷斯梅努达斯
toreβeliʎa	托雷韦利利亚
toreβjexa	托雷维耶哈
torixas	托里哈斯
torixo	托里霍
torixos	托里霍斯
toronteɾas	托龙特拉斯
toroks	托罗克斯
toɾtaxaða	托尔塔哈达
toɾteʎa	托尔特利亚
toɾtola	托尔托拉
toɾtonda	托尔通达
toɾtweɾa	托尔图埃拉
toɾtweɾo	托尔图埃罗
toɾβiskon	托尔维斯孔
toɾβiskoso	托尔维斯科索
tosas	托萨斯
totana	托塔纳
totanes	托塔内斯
tou̯ɾo	托罗
tou̯s	托斯
tɾaβaða	特拉瓦达
tɾaβaðelo	特拉瓦德洛
tɾaβaŋka	特拉万卡
tɾaβaθos	特拉瓦索斯
tɾaɣaθete	特拉加塞特
tɾai̯ɣeɾa	特赖格拉
tɾamakastiʎa	特拉马卡斯蒂利亚
tɾasjera	特拉谢拉
tɾaslaβina	特拉斯拉维纳
tɾasmiɾas	特拉斯米拉斯
tɾasoβaɾes	特拉索瓦雷斯
tɾaspineðo	特拉斯皮内多
tɾaθo	特拉索
tɾeβuxena	特雷武赫纳
tɾeðos	特雷多斯
tɾemp	特伦普
tɾesxuŋkos	特雷斯洪科斯
tɾeto	特雷托
tɾeβeleθ	特雷韦莱斯
tɾeβjana	特雷维亚纳
tɾeβjas	特雷维亚斯
tɾeβiɲo	特雷维尼奥
tɾjakastela	特里亚卡斯特拉
tɾiɣeɾos	特里格罗斯
tɾiʎo	特里略
tɾjoʎo	特里奥略
tɾiste	特里斯特
tɾonθeðo	特龙塞多
tɾonʧon	特龙琼
tɾuβja	特鲁维亚
tɾuʧas	特鲁查斯
tɾuʧiʎas	特鲁奇利亚斯
tɾuxiʎanos	特鲁希利亚诺斯
tɾuxiʎo	特鲁希略
tɾuxiʎos	特鲁希略斯
tuðaŋka	图丹卡
tuðela	图德拉
twexaɾ	图埃哈尔
tuleβɾas	图莱夫拉斯
tuɾθja	图尔西亚
tuɾeɣano	图雷加诺
tuɾis	图里斯
tuɾleke	图尔莱克
tuɾon	图龙
ture	图雷
turiʎas	图里利亚斯
turuŋkun	图伦昆
tui	图伊
uβeða	乌韦达
uβiðea	乌维德阿
uβɾike	乌夫里克
uθeða	乌塞达
uθeɾo	乌塞罗
uðjas	乌迪亚斯
uxixaɾ	乌希哈尔
uxo	乌霍
uxwe	乌胡埃
ulea	乌莱阿
uʎdekona	乌尔德科纳
uʎdemolins	乌尔德莫林斯
umbɾete	温布雷特
uɲa	乌尼亚
uŋkastiʎo	温卡斯蒂略
uŋkeɾa	温克拉
unθwe	温苏埃
uɾβjes	乌尔维耶斯
uɾða	乌尔达
urakal	乌拉卡尔
urjes	乌列斯
uroθ	乌罗斯
uɾweɲa	乌鲁埃尼亚
uɾweɲas	乌鲁埃尼亚斯
usaɣɾe	乌萨格雷
useð	乌塞
useɾas	乌塞拉斯
uteβo	乌特沃
utjel	乌铁尔
utɾeɾa	乌特雷拉
utɾiʎas	乌特里利亚斯
uθtaroθ	乌斯塔罗斯
baðokondes	巴多孔德斯
baðoʎano	巴多利亚诺
balakloʧe	巴拉克洛切
balkaβaðiʎo	巴尔卡瓦迪略
baldaɾaθete	巴尔达拉塞特
baldaɾaʧas	巴尔达拉查斯
baldeaxos	巴尔德阿霍斯
baldeaβeɾo	巴尔德阿韦罗
baldeaβeɾwelo	巴尔德阿韦鲁埃洛
baldekaβaʎeɾos	巴尔德卡瓦列罗斯
baldekaβɾas	巴尔德卡夫拉斯
baldekaros	巴尔德卡罗斯
baldeθeβoʎas	巴尔德塞沃利亚斯
baldeθeβɾo	巴尔德塞夫罗
baldekonʧa	巴尔德孔查
baldekonexos	巴尔德科内霍斯
baldekweŋka	巴尔德昆卡
baldeðjos	巴尔德迪奥斯
baldefɾesno	巴尔德弗雷斯诺
baldefwentes	巴尔德丰特斯
baldeɣamas	巴尔德加马斯
baldeɣaŋga	巴尔德甘加
baldeɣoβja	巴尔德戈维亚
balde.ixaðeɾos	巴尔德伊哈德罗斯
baldelaɣwa	巴尔德拉瓜
baldelaɣuna	巴尔德拉古纳
baldelkuβo	巴尔德尔库沃
baldelinaɾes	巴尔德利纳雷斯
baldelosa	巴尔德洛萨
baldeluɣeɾos	巴尔德卢格罗斯
baldemaluke	巴尔德马卢克
baldemoɾiʎo	巴尔德莫里略
baldemoɾo	巴尔德莫罗
baldenoθeða	巴尔德诺塞达
baldenoʧes	巴尔德诺切斯
baldeoβispo	巴尔德奥维斯波
baldeoliβas	巴尔德奥利瓦斯
baldeoras	巴尔德奥拉斯
baldepeɲas	巴尔德佩尼亚斯
baldepjelaɣo	巴尔德彼拉戈
baldepolo	巴尔德波洛
baldepɾaðos	巴尔德普拉多斯
baldeɾas	巴尔德拉斯
balderei̯	巴尔德雷
balderoβɾes	巴尔德罗夫雷斯
baldesamaɾjo	巴尔德萨马里奥
baldesaθ	巴尔德萨斯
baldespina	巴尔德斯皮纳
baldespino	巴尔德斯皮诺
baldestiʎas	巴尔德斯蒂利亚斯
baldetexa	巴尔德特哈
baldetores	巴尔德托雷斯
baldeβimbɾe	巴尔德温布雷
baldeθaɾθa	巴尔德萨尔萨
baldi.welo	巴尔迪韦洛
baldileʧa	巴尔迪莱查
baldoβiɲo	巴尔多维尼奥
balduŋkiʎo	巴尔敦基略
balenθja	巴伦西亚
balenθwela	巴伦苏埃拉
baleɾja	巴莱里亚
balɣa	巴尔加
balxuŋkeɾa	巴尔洪克拉
baʎaða	巴利亚达
baʎaðolises	巴利亚多利塞斯
baʎaŋka	巴良卡
baʎβona	巴尔沃纳
baʎdemosa	巴尔德莫萨
baʎe	巴列
baʎekas	巴列卡斯
baʎelaðo	巴列拉多
baʎfoɣona	巴尔福戈纳
baʎiβona	巴利沃纳
baʎiɾana	巴利拉纳
baʎmoʎ	巴尔莫尔
baʎɾomanas	巴尔罗马纳斯
baʎs	巴尔斯
balmala	巴尔马拉
balmaseða	巴尔马塞达
balmoxaðo	巴尔莫哈多
balneɾa	巴尔内拉
baloɾ	巴洛尔
balroŋkiʎo	巴尔龙基略
balseka	巴尔塞卡
balsekiʎo	巴尔塞基略
baltaxeɾos	巴尔塔赫罗斯
bandeʎos	班德略斯
baɲes	巴涅斯
baskoŋgaðas	巴斯孔加达斯
beθinos	贝西诺斯
beðɾa	贝德拉
beɣaðeo	贝加德奥
beɣamjan	贝加米安
beɣanθones	贝甘索内斯
beɣapaɣaɾ	贝加帕加尔
beɣakemaða	贝加克马达
beɣaɾjenθa	贝加连萨
belaða	贝拉达
belaskalβaɾo	贝拉斯卡尔瓦罗
belefike	贝莱菲克
beliʎa	贝利利亚
beʎiska	贝利斯卡
bendɾeʎ	本德雷尔
benjalβo	贝尼亚尔沃
bentas	本塔斯
bentiʎas	本蒂利亚斯
bentuɾaða	本图拉达
beɾa	贝拉
beɾðu	贝尔杜
beɾea	贝雷阿
beɾeðas	贝雷达斯
beɾɣaɾa	贝尔加拉
beɾxel	贝尔赫尔
beɾxes	贝尔赫斯
beɾin	贝林
beθðemaɾβan	贝斯德马尔万
bjakamp	比亚坎普
bjana	比亚纳
bjanos	比亚诺斯
bjaskon	比亚斯孔
bjatoɾ	比亚托尔
bikalβaɾo	比卡尔瓦罗
bikaɾ	比卡尔
biθjen	比先
bikoloθano	比科洛萨诺
biðaŋgoθ	比丹戈斯
biðjaɣo	比迪亚戈
biðɾeɾas	比德雷拉斯
bjeʎa	别利亚
biɣeɾa	比格拉
bilaβeʎa	比拉韦利亚
bilaβoa	比拉沃阿
bilaða	比拉达
bilaðemat	比拉德马特
bilaðemuls	比拉德穆尔斯
bilaðɾau̯	比拉德劳
bilaɣɾasa	比拉格拉萨
bilaʎeɾ	比拉列尔
bilanoβa	比拉诺瓦
bilaplana	比拉普拉纳
bilapou̯ka	比拉波卡
bilaroðona	比拉罗多纳
bilaseka	比拉塞卡
bilatan	比拉坦
bilʧes	比尔切斯
biʎaβona	比利亚沃纳
biʎakaɲas	比利亚卡尼亚斯
biʎakarjeðo	比利亚卡列多
biʎakariʎo	比利亚卡里略
biʎakastin	比利亚卡斯廷
biʎakonexos	比利亚科内霍斯
biʎaða	比利亚达
biʎaðekanes	比利亚德卡内斯
biʎaðepeɾa	比利亚德佩拉
biʎaðjeɣo	比利亚迭戈
biʎaeskusa	比利亚埃斯库萨
biʎafames	比利亚法梅斯
biʎafloɾes	比利亚弗洛雷斯
biʎafɾaŋka	比利亚弗兰卡
biʎafɾaŋkeθa	比利亚弗兰克萨
biʎafɾeʧos	比利亚弗雷乔斯
biʎafɾwela	比利亚弗鲁埃拉
biʎaɣaton	比利亚加通
biʎaxeɾ	比利亚赫尔
biʎaɣonθalo	比利亚贡萨洛
biʎa.eɾmosa	比利亚埃尔莫萨
biʎa.oθ	比利亚奥斯
biʎaxoʝosa	比利亚霍约萨
biʎalβa	比利亚尔瓦
biʎaleŋgwa	比利亚伦瓜
biʎalmanθo	比利亚尔曼索
biʎaloŋga	比利亚隆加
biʎalpando	比利亚尔潘多
biʎaluβe	比利亚卢韦
biʎalweŋga	比利亚伦加
biʎalumbɾoso	比利亚伦布罗索
biʎalβaɾo	比利亚尔瓦罗
biʎamalea	比利亚马莱阿
biʎamaluɾ	比利亚马卢尔
biʎamaɲan	比利亚马尼扬
biʎamandos	比利亚曼多斯
biʎamanrike	比利亚曼里克
biʎamanta	比利亚曼塔
biʎamantiʎa	比利亚曼蒂利亚
biʎamaɾin	比利亚马林
biʎamaɾtin	比利亚马丁
biʎamaʝoɾ	比利亚马约尔
biʎamea	比利亚梅阿
biʎameðjana	比利亚梅迪亚纳
biʎamexil	比利亚梅希尔
biʎamesjas	比利亚梅西亚斯
biʎamiθaɾ	比利亚米萨尔
biʎamol	比利亚莫尔
biʎamwelas	比利亚穆埃拉斯
biʎanua	比利亚努阿
biʎanuβla	比利亚努夫拉
biʎanweβa	比利亚努埃瓦
biʎaoβispo	比廖维斯波
biʎapalaθjos	比利亚帕拉西奥斯
biʎakexiða	比利亚克希达
biʎakilambɾe	比利亚基兰布雷
biʎaɾalβo	比利亚拉尔沃
biʎaɾalto	比利亚拉尔托
biʎaɾexo	比利亚雷霍
biʎaɾente	比利亚伦特
biʎaɾikos	比利亚里科斯
biʎaɾino	比利亚里诺
biʎaraβe	比利亚拉韦
biʎaramjel	比利亚拉米耶尔
biʎarasa	比利亚拉萨
biʎareal	比利亚雷阿尔
biʎaroβleðo	比利亚罗夫莱多
biʎaroðɾiɣo	比利亚罗德里戈
biʎaroʝa	比利亚罗亚
biʎaruβja	比利亚鲁维亚
biʎaruβjo	比利亚鲁维奥
biʎasaβaɾjeɣo	比利亚萨瓦列戈
biʎasandino	比利亚桑迪诺
biʎasante	比利亚桑特
biʎasaraθino	比利亚萨拉西诺
biʎasaʝas	比利亚萨亚斯
biʎaseka	比利亚塞卡
biʎaselan	比利亚塞兰
biʎasilos	比利亚西洛斯
biʎasruβjas	比利亚斯鲁维亚斯
biʎastaɾ	比利亚斯塔尔
biʎatoβas	比利亚托瓦斯
biʎatoɾo	比利亚托罗
biʎatoʝa	比利亚托亚
biʎatuɾjel	比利亚图列尔
biʎaβa	比利亚瓦
biʎaβakeɾin	比利亚瓦克林
biʎaβendimjo	比利亚文迪米奥
biʎaβiθjosa	比利亚维西奥萨
biʎaβjuðas	比利亚维乌达斯
biʎaʝon	比利亚永
biʎaθa	比利亚萨
biʎeɣas	比列加斯
biʎel	比列尔
biʎena	比列纳
biʎeɾjas	比列里亚斯
biʎoðɾiɣo	比略德里戈
biʎoldo	比略尔多
biʎoɾa	比略拉
biʎoɾes	比略雷斯
biʎoɾja	比略里亚
bilβestɾe	比尔韦斯特雷
bimjanθo	比米安索
binaθei̯te	比纳塞特
binaɾoθ	比纳罗斯
bindel	宾德尔
bineβɾe	比内夫雷
biɲwela	比纽埃拉
biɲwelas	比纽埃拉斯
binwesa	比努埃萨
biɾwela	比鲁埃拉
bisau̯ɾin	比绍林
bisjeðo	比谢多
bitiɣuðino	比蒂古迪诺
biβeɾ	比韦尔
biβeɾo	比韦罗
biβeɾos	比韦罗斯
biθkainos	比斯卡伊诺斯
biθmanos	比斯马诺斯
ʝaŋgwas	扬瓜斯
ʝatoβa	亚托瓦
ʝeβes	耶韦斯
ʝeβɾa	耶夫拉
ʝekla	耶克拉
ʝexen	耶亨
ʝela	耶拉
ʝepes	耶佩斯
ʝeɾɣa	耶尔加
ʝesa	耶萨
ʝeste	耶斯特
ʝuŋkleɾ	云克莱尔
ʝuŋkos	云科斯
ʝuŋkeɾa	云克拉
θafaraʝa	萨法拉亚
θaɣɾa	萨格拉
θa.aɾa	萨阿拉
θa.inos	萨伊诺斯
θai̯ðin	赛丁
θaʎa	萨利亚
θamaramala	萨马拉马拉
θamaʝon	萨马永
θambɾa	桑布拉
θambɾana	桑布拉纳
θamoɾa	萨莫拉
θaoɾexas	绍雷哈斯
θaɾaɣoθa	萨拉戈萨
θaɾatan	萨拉坦
θaɾau̯θ	萨劳斯
θara	萨拉
θaɾθalexo	萨尔萨莱霍
θas	萨斯
θiθuɾ	锡苏尔
θoɾita	索里塔
θuβja	苏维亚
θuβjeta	苏维耶塔
θuβiɾi	苏维里
θukai̯na	苏凯纳
θuðai̯ɾe	苏代雷
θweɾa	苏埃拉
θu.eɾos	苏埃罗斯
θuxaɾ	苏哈尔
θumaraɣa	苏马拉加
θumaʝa	苏马亚
θuniɣa	苏尼加
θuɾxena	苏尔赫纳
θuɾθaren	苏尔萨伦
